admit_date,flu,covid,malaria,others,chennai_total_count
1/1/1970,6,0,8,2,16
1/2/1970,12,0,8,11,31
1/3/1970,6,0,3,11,20
1/4/1970,11,0,8,1,20
1/5/1970,11,0,2,4,17
1/6/1970,5,0,7,2,14
1/7/1970,12,0,3,5,20
1/8/1970,10,0,4,1,15
1/9/1970,10,0,8,0,18
1/10/1970,8,0,6,1,15
1/11/1970,6,0,2,1,9
1/12/1970,11,0,5,10,26
1/13/1970,8,0,5,10,23
1/14/1970,10,0,3,3,16
1/15/1970,7,0,8,0,15
1/16/1970,12,0,6,9,27
1/17/1970,9,0,10,11,30
1/18/1970,9,0,8,4,21
1/19/1970,8,0,5,11,24
1/20/1970,9,0,3,9,21
1/21/1970,6,0,3,7,16
1/22/1970,7,0,6,5,18
1/23/1970,12,0,6,9,27
1/24/1970,9,0,8,8,25
1/25/1970,7,0,5,10,22
1/26/1970,6,0,9,0,15
1/27/1970,11,0,3,3,17
1/28/1970,5,0,10,9,24
1/29/1970,11,0,3,9,23
1/30/1970,8,0,8,6,22
1/31/1970,11,0,6,2,19
2/1/1970,10,0,6,6,22
2/2/1970,4,0,2,7,13
2/3/1970,5,0,5,0,10
2/4/1970,7,0,4,2,13
2/5/1970,5,0,4,5,14
2/6/1970,4,0,4,9,17
2/7/1970,10,0,7,4,21
2/8/1970,12,0,6,5,23
2/9/1970,12,0,3,8,23
2/10/1970,5,0,3,9,17
2/11/1970,12,0,6,1,19
2/12/1970,9,0,3,4,16
2/13/1970,10,0,6,7,23
2/14/1970,8,0,10,10,28
2/15/1970,10,0,7,2,19
2/16/1970,8,0,6,2,16
2/17/1970,8,0,6,2,16
2/18/1970,7,0,9,1,17
2/19/1970,5,0,10,8,23
2/20/1970,8,0,2,7,17
2/21/1970,5,0,5,9,19
2/22/1970,10,0,5,6,21
2/23/1970,12,0,8,5,25
2/24/1970,11,0,6,3,20
2/25/1970,6,0,4,4,14
2/26/1970,4,0,3,10,17
2/27/1970,12,0,6,2,20
2/28/1970,10,0,4,0,14
3/1/1970,8,0,6,9,23
3/2/1970,8,0,5,7,20
3/3/1970,4,0,4,9,17
3/4/1970,8,0,3,8,19
3/5/1970,10,0,4,2,16
3/6/1970,11,0,5,0,16
3/7/1970,7,0,8,3,18
3/8/1970,9,0,2,5,16
3/9/1970,12,0,3,8,23
3/10/1970,4,0,4,4,12
3/11/1970,7,0,3,10,20
3/12/1970,11,0,3,2,16
3/13/1970,7,0,5,1,13
3/14/1970,8,0,9,1,18
3/15/1970,10,0,9,2,21
3/16/1970,9,0,7,0,16
3/17/1970,6,0,3,3,12
3/18/1970,6,0,5,4,15
3/19/1970,6,0,7,11,24
3/20/1970,4,0,5,3,12
3/21/1970,5,0,9,8,22
3/22/1970,12,0,8,11,31
3/23/1970,10,0,7,7,24
3/24/1970,6,0,6,10,22
3/25/1970,7,0,5,9,21
3/26/1970,7,0,8,6,21
3/27/1970,12,0,8,11,31
3/28/1970,8,0,4,7,19
3/29/1970,8,0,6,0,14
3/30/1970,7,0,5,0,12
3/31/1970,11,0,6,8,25
4/1/1970,8,0,6,11,25
4/2/1970,8,0,2,2,12
4/3/1970,8,0,2,8,18
4/4/1970,10,0,3,8,21
4/5/1970,4,0,6,11,21
4/6/1970,6,0,3,1,10
4/7/1970,7,0,5,11,23
4/8/1970,6,0,2,8,16
4/9/1970,9,0,2,0,11
4/10/1970,11,0,10,6,27
4/11/1970,10,0,2,0,12
4/12/1970,5,0,8,2,15
4/13/1970,11,0,3,11,25
4/14/1970,9,0,4,2,15
4/15/1970,8,0,6,5,19
4/16/1970,9,0,8,8,25
4/17/1970,7,0,2,6,15
4/18/1970,5,0,10,4,19
4/19/1970,8,0,3,11,22
4/20/1970,8,0,2,10,20
4/21/1970,6,0,8,7,21
4/22/1970,6,0,3,11,20
4/23/1970,8,0,7,0,15
4/24/1970,7,0,3,10,20
4/25/1970,9,0,2,3,14
4/26/1970,6,0,6,11,23
4/27/1970,8,0,8,8,24
4/28/1970,5,0,10,9,24
4/29/1970,11,0,5,9,25
4/30/1970,9,0,8,7,24
5/1/1970,11,0,5,2,18
5/2/1970,9,0,4,9,22
5/3/1970,9,0,7,11,27
5/4/1970,9,0,3,4,16
5/5/1970,10,0,4,10,24
5/6/1970,7,0,4,7,18
5/7/1970,9,0,3,5,17
5/8/1970,9,0,10,8,27
5/9/1970,5,0,6,9,20
5/10/1970,10,0,8,1,19
5/11/1970,11,0,3,7,21
5/12/1970,10,0,9,11,30
5/13/1970,10,0,6,4,20
5/14/1970,11,0,6,4,21
5/15/1970,7,0,8,5,20
5/16/1970,11,0,4,4,19
5/17/1970,11,0,9,2,22
5/18/1970,12,0,2,7,21
5/19/1970,5,0,9,1,15
5/20/1970,9,0,3,3,15
5/21/1970,12,0,10,3,25
5/22/1970,6,0,3,4,13
5/23/1970,11,0,3,3,17
5/24/1970,7,0,6,11,24
5/25/1970,8,0,6,5,19
5/26/1970,11,0,7,0,18
5/27/1970,9,0,7,6,22
5/28/1970,11,0,10,7,28
5/29/1970,7,0,10,10,27
5/30/1970,7,0,7,4,18
5/31/1970,6,0,4,1,11
6/1/1970,9,0,9,1,19
6/2/1970,9,0,9,6,24
6/3/1970,12,0,2,9,23
6/4/1970,11,0,4,10,25
6/5/1970,12,0,9,0,21
6/6/1970,4,0,6,11,21
6/7/1970,10,0,4,4,18
6/8/1970,9,0,2,5,16
6/9/1970,9,0,8,0,17
6/10/1970,11,0,5,11,27
6/11/1970,9,0,7,6,22
6/12/1970,7,0,6,4,17
6/13/1970,5,0,6,3,14
6/14/1970,8,0,2,5,15
6/15/1970,6,0,7,7,20
6/16/1970,11,0,9,8,28
6/17/1970,12,0,7,4,23
6/18/1970,10,0,5,11,26
6/19/1970,4,0,5,4,13
6/20/1970,4,0,10,6,20
6/21/1970,10,0,4,10,24
6/22/1970,11,0,8,1,20
6/23/1970,8,0,4,1,13
6/24/1970,8,0,9,0,17
6/25/1970,9,0,2,8,19
6/26/1970,4,0,2,4,10
6/27/1970,5,0,3,11,19
6/28/1970,6,0,2,0,8
6/29/1970,10,0,9,0,19
6/30/1970,6,0,9,3,18
7/1/1970,8,0,7,5,20
7/2/1970,7,0,3,2,12
7/3/1970,9,0,10,9,28
7/4/1970,11,0,4,3,18
7/5/1970,10,0,3,7,20
7/6/1970,9,0,5,2,16
7/7/1970,9,0,9,4,22
7/8/1970,6,0,2,2,10
7/9/1970,9,0,4,6,19
7/10/1970,4,0,7,9,20
7/11/1970,12,0,9,1,22
7/12/1970,7,0,3,2,12
7/13/1970,10,0,3,1,14
7/14/1970,4,0,6,8,18
7/15/1970,12,0,7,8,27
7/16/1970,11,0,7,6,24
7/17/1970,5,0,3,8,16
7/18/1970,4,0,2,4,10
7/19/1970,4,0,8,0,12
7/20/1970,4,0,3,8,15
7/21/1970,7,0,8,11,26
7/22/1970,9,0,2,0,11
7/23/1970,10,0,3,0,13
7/24/1970,4,0,4,8,16
7/25/1970,11,0,9,3,23
7/26/1970,5,0,7,3,15
7/27/1970,12,0,9,4,25
7/28/1970,11,0,4,7,22
7/29/1970,5,0,8,9,22
7/30/1970,5,0,10,4,19
7/31/1970,11,0,4,5,20
8/1/1970,6,0,8,10,24
8/2/1970,7,0,6,5,18
8/3/1970,9,0,3,10,22
8/4/1970,7,0,3,6,16
8/5/1970,7,0,5,5,17
8/6/1970,6,0,3,2,11
8/7/1970,9,0,6,8,23
8/8/1970,7,0,7,5,19
8/9/1970,10,0,6,2,18
8/10/1970,8,0,3,6,17
8/11/1970,9,0,8,5,22
8/12/1970,12,0,2,11,25
8/13/1970,4,0,3,4,11
8/14/1970,11,0,4,7,22
8/15/1970,9,0,8,1,18
8/16/1970,4,0,4,4,12
8/17/1970,6,0,3,11,20
8/18/1970,4,0,3,5,12
8/19/1970,9,0,6,3,18
8/20/1970,4,0,4,3,11
8/21/1970,11,0,4,11,26
8/22/1970,10,0,4,6,20
8/23/1970,5,0,4,5,14
8/24/1970,5,0,8,11,24
8/25/1970,11,0,6,10,27
8/26/1970,7,0,9,10,26
8/27/1970,8,0,6,7,21
8/28/1970,11,0,7,3,21
8/29/1970,8,0,6,2,16
8/30/1970,11,0,6,8,25
8/31/1970,6,0,3,0,9
9/1/1970,5,0,3,2,10
9/2/1970,12,0,6,10,28
9/3/1970,11,0,2,0,13
9/4/1970,8,0,6,1,15
9/5/1970,11,0,5,9,25
9/6/1970,6,0,9,1,16
9/7/1970,12,0,9,7,28
9/8/1970,7,0,9,5,21
9/9/1970,7,0,4,5,16
9/10/1970,8,0,2,4,14
9/11/1970,4,0,10,10,24
9/12/1970,9,0,5,0,14
9/13/1970,10,0,5,1,16
9/14/1970,9,0,2,3,14
9/15/1970,10,0,7,8,25
9/16/1970,5,0,8,9,22
9/17/1970,6,0,8,7,21
9/18/1970,10,0,4,6,20
9/19/1970,7,0,5,1,13
9/20/1970,5,0,10,11,26
9/21/1970,9,0,7,10,26
9/22/1970,10,0,3,1,14
9/23/1970,4,0,4,9,17
9/24/1970,8,0,8,0,16
9/25/1970,4,0,5,8,17
9/26/1970,12,0,3,4,19
9/27/1970,6,0,5,2,13
9/28/1970,6,0,10,8,24
9/29/1970,5,0,9,1,15
9/30/1970,5,0,6,6,17
10/1/1970,9,0,6,1,16
10/2/1970,10,0,2,9,21
10/3/1970,11,0,10,3,24
10/4/1970,12,0,2,0,14
10/5/1970,5,0,8,4,17
10/6/1970,12,0,4,6,22
10/7/1970,12,0,7,8,27
10/8/1970,10,0,6,9,25
10/9/1970,11,0,3,10,24
10/10/1970,8,0,10,0,18
10/11/1970,9,0,9,7,25
10/12/1970,8,0,4,11,23
10/13/1970,5,0,3,8,16
10/14/1970,12,0,9,10,31
10/15/1970,9,0,9,11,29
10/16/1970,7,0,5,4,16
10/17/1970,6,0,9,9,24
10/18/1970,6,0,10,8,24
10/19/1970,12,0,10,6,28
10/20/1970,10,0,4,0,14
10/21/1970,6,0,6,0,12
10/22/1970,4,0,6,4,14
10/23/1970,10,0,3,10,23
10/24/1970,7,0,9,9,25
10/25/1970,7,0,4,7,18
10/26/1970,4,0,9,9,22
10/27/1970,11,0,4,2,17
10/28/1970,9,0,3,7,19
10/29/1970,5,0,6,6,17
10/30/1970,9,0,4,1,14
10/31/1970,7,0,8,1,16
11/1/1970,8,0,6,6,20
11/2/1970,10,0,5,1,16
11/3/1970,11,0,6,0,17
11/4/1970,12,0,4,5,21
11/5/1970,12,0,2,11,25
11/6/1970,6,0,4,10,20
11/7/1970,5,0,9,10,24
11/8/1970,5,0,4,3,12
11/9/1970,6,0,10,0,16
11/10/1970,5,0,9,6,20
11/11/1970,6,0,4,11,21
11/12/1970,6,0,8,0,14
11/13/1970,5,0,7,0,12
11/14/1970,6,0,6,4,16
11/15/1970,4,0,10,6,20
11/16/1970,8,0,10,11,29
11/17/1970,11,0,5,3,19
11/18/1970,12,0,8,8,28
11/19/1970,10,0,3,9,22
11/20/1970,6,0,3,10,19
11/21/1970,9,0,6,2,17
11/22/1970,11,0,4,1,16
11/23/1970,8,0,7,11,26
11/24/1970,12,0,5,8,25
11/25/1970,4,0,7,7,18
11/26/1970,12,0,8,11,31
11/27/1970,8,0,10,0,18
11/28/1970,11,0,7,2,20
11/29/1970,12,0,2,5,19
11/30/1970,6,0,3,1,10
12/1/1970,8,0,3,2,13
12/2/1970,9,0,10,5,24
12/3/1970,6,0,5,7,18
12/4/1970,10,0,2,7,19
12/5/1970,6,0,8,6,20
12/6/1970,11,0,2,3,16
12/7/1970,4,0,5,3,12
12/8/1970,4,0,4,0,8
12/9/1970,6,0,4,7,17
12/10/1970,7,0,5,0,12
12/11/1970,11,0,10,2,23
12/12/1970,6,0,2,5,13
12/13/1970,4,0,3,7,14
12/14/1970,6,0,5,7,18
12/15/1970,11,0,6,1,18
12/16/1970,8,0,4,2,14
12/17/1970,5,0,5,4,14
12/18/1970,4,0,7,11,22
12/19/1970,10,0,10,8,28
12/20/1970,6,0,2,11,19
12/21/1970,4,0,10,2,16
12/22/1970,8,0,6,5,19
12/23/1970,4,0,3,11,18
12/24/1970,9,0,9,9,27
12/25/1970,11,0,2,1,14
12/26/1970,8,0,2,6,16
12/27/1970,9,0,7,5,21
12/28/1970,5,0,9,0,14
12/29/1970,9,0,8,10,27
12/30/1970,7,0,2,8,17
12/31/1970,9,0,7,5,21
1/1/1971,12,0,4,0,16
1/2/1971,9,0,9,4,22
1/3/1971,6,0,6,6,18
1/4/1971,8,0,3,5,16
1/5/1971,8,0,5,9,22
1/6/1971,10,0,3,6,19
1/7/1971,10,0,4,6,20
1/8/1971,4,0,5,0,9
1/9/1971,6,0,6,7,19
1/10/1971,5,0,9,4,18
1/11/1971,11,0,3,10,24
1/12/1971,8,0,2,0,10
1/13/1971,9,0,6,5,20
1/14/1971,11,0,3,11,25
1/15/1971,8,0,9,0,17
1/16/1971,12,0,10,4,26
1/17/1971,6,0,3,11,20
1/18/1971,10,0,8,6,24
1/19/1971,5,0,6,0,11
1/20/1971,6,0,4,8,18
1/21/1971,5,0,9,0,14
1/22/1971,10,0,10,11,31
1/23/1971,6,0,6,2,14
1/24/1971,10,0,3,0,13
1/25/1971,12,0,4,2,18
1/26/1971,5,0,9,4,18
1/27/1971,9,0,3,2,14
1/28/1971,7,0,6,1,14
1/29/1971,6,0,6,9,21
1/30/1971,6,0,2,8,16
1/31/1971,8,0,8,10,26
2/1/1971,12,0,4,2,18
2/2/1971,12,0,5,8,25
2/3/1971,12,0,3,0,15
2/4/1971,9,0,9,1,19
2/5/1971,8,0,7,1,16
2/6/1971,11,0,9,2,22
2/7/1971,11,0,7,8,26
2/8/1971,7,0,3,5,15
2/9/1971,9,0,6,9,24
2/10/1971,5,0,7,2,14
2/11/1971,10,0,2,11,23
2/12/1971,12,0,9,1,22
2/13/1971,12,0,9,1,22
2/14/1971,4,0,6,11,21
2/15/1971,5,0,5,9,19
2/16/1971,11,0,2,8,21
2/17/1971,9,0,9,6,24
2/18/1971,11,0,10,9,30
2/19/1971,7,0,5,5,17
2/20/1971,12,0,5,2,19
2/21/1971,11,0,3,6,20
2/22/1971,7,0,7,10,24
2/23/1971,5,0,6,11,22
2/24/1971,6,0,6,10,22
2/25/1971,5,0,2,3,10
2/26/1971,5,0,6,6,17
2/27/1971,9,0,4,7,20
2/28/1971,5,0,7,10,22
3/1/1971,9,0,9,2,20
3/2/1971,7,0,6,5,18
3/3/1971,8,0,3,5,16
3/4/1971,11,0,4,6,21
3/5/1971,5,0,8,4,17
3/6/1971,12,0,6,11,29
3/7/1971,9,0,5,11,25
3/8/1971,7,0,5,8,20
3/9/1971,4,0,4,5,13
3/10/1971,8,0,9,1,18
3/11/1971,5,0,7,9,21
3/12/1971,7,0,5,7,19
3/13/1971,10,0,4,8,22
3/14/1971,4,0,3,2,9
3/15/1971,10,0,2,4,16
3/16/1971,9,0,4,9,22
3/17/1971,4,0,2,6,12
3/18/1971,6,0,7,0,13
3/19/1971,7,0,3,1,11
3/20/1971,4,0,7,6,17
3/21/1971,12,0,8,6,26
3/22/1971,8,0,3,8,19
3/23/1971,11,0,6,9,26
3/24/1971,9,0,8,4,21
3/25/1971,5,0,4,10,19
3/26/1971,7,0,10,6,23
3/27/1971,5,0,10,5,20
3/28/1971,10,0,5,5,20
3/29/1971,10,0,4,4,18
3/30/1971,10,0,2,9,21
3/31/1971,6,0,3,4,13
4/1/1971,4,0,3,0,7
4/2/1971,12,0,7,7,26
4/3/1971,12,0,3,4,19
4/4/1971,10,0,7,10,27
4/5/1971,4,0,8,4,16
4/6/1971,5,0,2,11,18
4/7/1971,7,0,3,1,11
4/8/1971,9,0,3,8,20
4/9/1971,8,0,3,8,19
4/10/1971,11,0,2,3,16
4/11/1971,8,0,7,6,21
4/12/1971,12,0,5,2,19
4/13/1971,11,0,10,10,31
4/14/1971,11,0,7,7,25
4/15/1971,9,0,3,11,23
4/16/1971,12,0,5,11,28
4/17/1971,11,0,3,10,24
4/18/1971,7,0,2,6,15
4/19/1971,10,0,3,11,24
4/20/1971,9,0,9,7,25
4/21/1971,12,0,3,0,15
4/22/1971,11,0,9,11,31
4/23/1971,12,0,3,10,25
4/24/1971,12,0,2,3,17
4/25/1971,6,0,7,5,18
4/26/1971,9,0,9,7,25
4/27/1971,7,0,7,10,24
4/28/1971,4,0,4,3,11
4/29/1971,8,0,10,3,21
4/30/1971,6,0,4,1,11
5/1/1971,11,0,7,10,28
5/2/1971,8,0,4,8,20
5/3/1971,9,0,3,7,19
5/4/1971,4,0,5,1,10
5/5/1971,11,0,7,11,29
5/6/1971,8,0,4,3,15
5/7/1971,8,0,4,2,14
5/8/1971,11,0,8,5,24
5/9/1971,7,0,9,11,27
5/10/1971,12,0,9,3,24
5/11/1971,6,0,9,11,26
5/12/1971,12,0,8,10,30
5/13/1971,8,0,10,4,22
5/14/1971,10,0,10,6,26
5/15/1971,9,0,10,2,21
5/16/1971,12,0,7,9,28
5/17/1971,11,0,3,1,15
5/18/1971,4,0,2,9,15
5/19/1971,6,0,6,10,22
5/20/1971,4,0,5,1,10
5/21/1971,10,0,7,9,26
5/22/1971,9,0,3,1,13
5/23/1971,6,0,10,3,19
5/24/1971,4,0,4,5,13
5/25/1971,8,0,5,4,17
5/26/1971,10,0,3,7,20
5/27/1971,6,0,8,10,24
5/28/1971,5,0,10,11,26
5/29/1971,12,0,4,11,27
5/30/1971,10,0,3,6,19
5/31/1971,12,0,10,4,26
6/1/1971,7,0,2,11,20
6/2/1971,4,0,8,4,16
6/3/1971,12,0,3,4,19
6/4/1971,5,0,9,8,22
6/5/1971,12,0,10,3,25
6/6/1971,11,0,3,5,19
6/7/1971,8,0,7,1,16
6/8/1971,5,0,7,3,15
6/9/1971,6,0,6,1,13
6/10/1971,4,0,8,1,13
6/11/1971,4,0,3,9,16
6/12/1971,5,0,9,2,16
6/13/1971,11,0,10,8,29
6/14/1971,4,0,10,10,24
6/15/1971,7,0,10,1,18
6/16/1971,12,0,2,0,14
6/17/1971,11,0,2,9,22
6/18/1971,5,0,4,7,16
6/19/1971,12,0,7,0,19
6/20/1971,7,0,4,3,14
6/21/1971,5,0,3,3,11
6/22/1971,5,0,9,10,24
6/23/1971,11,0,4,7,22
6/24/1971,6,0,4,6,16
6/25/1971,8,0,7,7,22
6/26/1971,6,0,2,9,17
6/27/1971,9,0,5,6,20
6/28/1971,9,0,6,8,23
6/29/1971,9,0,3,6,18
6/30/1971,4,0,4,10,18
7/1/1971,5,0,8,8,21
7/2/1971,8,0,4,1,13
7/3/1971,10,0,6,1,17
7/4/1971,5,0,6,7,18
7/5/1971,7,0,8,5,20
7/6/1971,6,0,5,11,22
7/7/1971,10,0,8,2,20
7/8/1971,11,0,9,10,30
7/9/1971,8,0,9,1,18
7/10/1971,9,0,3,2,14
7/11/1971,10,0,7,10,27
7/12/1971,11,0,10,10,31
7/13/1971,5,0,3,9,17
7/14/1971,7,0,4,3,14
7/15/1971,11,0,10,6,27
7/16/1971,10,0,9,7,26
7/17/1971,6,0,3,4,13
7/18/1971,9,0,10,7,26
7/19/1971,4,0,9,2,15
7/20/1971,11,0,2,1,14
7/21/1971,9,0,10,3,22
7/22/1971,12,0,10,1,23
7/23/1971,8,0,10,11,29
7/24/1971,9,0,3,4,16
7/25/1971,5,0,10,10,25
7/26/1971,12,0,6,1,19
7/27/1971,5,0,7,0,12
7/28/1971,9,0,4,9,22
7/29/1971,7,0,7,11,25
7/30/1971,8,0,5,9,22
7/31/1971,11,0,9,9,29
8/1/1971,5,0,7,6,18
8/2/1971,11,0,6,0,17
8/3/1971,4,0,6,10,20
8/4/1971,8,0,5,1,14
8/5/1971,7,0,5,5,17
8/6/1971,11,0,2,10,23
8/7/1971,8,0,3,0,11
8/8/1971,9,0,6,8,23
8/9/1971,8,0,7,9,24
8/10/1971,8,0,5,0,13
8/11/1971,6,0,8,0,14
8/12/1971,10,0,6,8,24
8/13/1971,10,0,8,7,25
8/14/1971,9,0,7,5,21
8/15/1971,10,0,9,2,21
8/16/1971,8,0,2,3,13
8/17/1971,4,0,10,1,15
8/18/1971,7,0,3,2,12
8/19/1971,8,0,9,7,24
8/20/1971,9,0,2,7,18
8/21/1971,6,0,4,4,14
8/22/1971,10,0,5,10,25
8/23/1971,11,0,4,2,17
8/24/1971,11,0,10,4,25
8/25/1971,9,0,10,4,23
8/26/1971,10,0,10,6,26
8/27/1971,11,0,3,11,25
8/28/1971,10,0,10,0,20
8/29/1971,7,0,10,5,22
8/30/1971,12,0,7,3,22
8/31/1971,8,0,8,8,24
9/1/1971,8,0,8,5,21
9/2/1971,6,0,2,1,9
9/3/1971,4,0,8,1,13
9/4/1971,11,0,7,1,19
9/5/1971,7,0,10,1,18
9/6/1971,7,0,2,9,18
9/7/1971,4,0,2,0,6
9/8/1971,7,0,5,2,14
9/9/1971,8,0,3,1,12
9/10/1971,6,0,3,2,11
9/11/1971,4,0,5,11,20
9/12/1971,9,0,10,0,19
9/13/1971,4,0,4,8,16
9/14/1971,6,0,6,8,20
9/15/1971,5,0,7,11,23
9/16/1971,4,0,10,3,17
9/17/1971,9,0,7,3,19
9/18/1971,5,0,10,11,26
9/19/1971,6,0,6,7,19
9/20/1971,11,0,9,7,27
9/21/1971,10,0,10,6,26
9/22/1971,6,0,10,8,24
9/23/1971,7,0,2,2,11
9/24/1971,9,0,8,11,28
9/25/1971,11,0,5,10,26
9/26/1971,5,0,2,11,18
9/27/1971,8,0,9,3,20
9/28/1971,8,0,6,0,14
9/29/1971,11,0,5,3,19
9/30/1971,8,0,7,10,25
10/1/1971,4,0,10,8,22
10/2/1971,5,0,10,6,21
10/3/1971,10,0,7,9,26
10/4/1971,7,0,7,7,21
10/5/1971,6,0,4,2,12
10/6/1971,7,0,3,4,14
10/7/1971,12,0,5,3,20
10/8/1971,7,0,3,9,19
10/9/1971,11,0,4,4,19
10/10/1971,12,0,3,2,17
10/11/1971,9,0,2,11,22
10/12/1971,11,0,9,9,29
10/13/1971,4,0,6,5,15
10/14/1971,10,0,6,9,25
10/15/1971,11,0,9,7,27
10/16/1971,12,0,5,2,19
10/17/1971,12,0,2,7,21
10/18/1971,8,0,9,10,27
10/19/1971,6,0,4,11,21
10/20/1971,4,0,2,7,13
10/21/1971,7,0,2,7,16
10/22/1971,12,0,7,4,23
10/23/1971,7,0,6,5,18
10/24/1971,4,0,5,1,10
10/25/1971,5,0,2,5,12
10/26/1971,8,0,10,0,18
10/27/1971,9,0,3,11,23
10/28/1971,10,0,5,11,26
10/29/1971,10,0,2,1,13
10/30/1971,5,0,3,5,13
10/31/1971,9,0,4,9,22
11/1/1971,4,0,2,4,10
11/2/1971,6,0,8,2,16
11/3/1971,4,0,5,5,14
11/4/1971,9,0,6,4,19
11/5/1971,7,0,4,4,15
11/6/1971,4,0,9,2,15
11/7/1971,7,0,6,7,20
11/8/1971,7,0,8,1,16
11/9/1971,9,0,4,2,15
11/10/1971,11,0,8,7,26
11/11/1971,6,0,9,4,19
11/12/1971,4,0,4,10,18
11/13/1971,12,0,5,10,27
11/14/1971,10,0,6,5,21
11/15/1971,8,0,8,0,16
11/16/1971,9,0,4,11,24
11/17/1971,5,0,9,5,19
11/18/1971,9,0,5,6,20
11/19/1971,11,0,7,5,23
11/20/1971,5,0,10,2,17
11/21/1971,4,0,3,0,7
11/22/1971,6,0,7,9,22
11/23/1971,12,0,8,0,20
11/24/1971,10,0,9,4,23
11/25/1971,9,0,9,9,27
11/26/1971,4,0,9,0,13
11/27/1971,5,0,2,4,11
11/28/1971,5,0,5,10,20
11/29/1971,8,0,9,10,27
11/30/1971,12,0,5,0,17
12/1/1971,6,0,8,1,15
12/2/1971,5,0,4,2,11
12/3/1971,12,0,3,9,24
12/4/1971,8,0,8,8,24
12/5/1971,12,0,4,11,27
12/6/1971,9,0,10,10,29
12/7/1971,6,0,4,3,13
12/8/1971,7,0,5,7,19
12/9/1971,7,0,6,11,24
12/10/1971,12,0,9,6,27
12/11/1971,12,0,7,2,21
12/12/1971,9,0,2,2,13
12/13/1971,11,0,8,6,25
12/14/1971,5,0,10,3,18
12/15/1971,8,0,5,5,18
12/16/1971,5,0,3,8,16
12/17/1971,6,0,8,6,20
12/18/1971,11,0,8,9,28
12/19/1971,5,0,3,6,14
12/20/1971,5,0,9,10,24
12/21/1971,10,0,5,6,21
12/22/1971,5,0,6,9,20
12/23/1971,4,0,5,2,11
12/24/1971,9,0,3,8,20
12/25/1971,10,0,9,10,29
12/26/1971,8,0,7,1,16
12/27/1971,7,0,10,1,18
12/28/1971,7,0,3,4,14
12/29/1971,11,0,5,11,27
12/30/1971,8,0,8,0,16
12/31/1971,10,0,4,1,15
1/1/1972,5,0,10,5,20
1/2/1972,8,0,10,6,24
1/3/1972,9,0,3,8,20
1/4/1972,10,0,7,8,25
1/5/1972,12,0,9,10,31
1/6/1972,4,0,6,0,10
1/7/1972,12,0,8,9,29
1/8/1972,5,0,10,1,16
1/9/1972,8,0,6,11,25
1/10/1972,4,0,2,6,12
1/11/1972,9,0,8,5,22
1/12/1972,8,0,9,10,27
1/13/1972,11,0,9,10,30
1/14/1972,12,0,10,10,32
1/15/1972,4,0,9,8,21
1/16/1972,9,0,6,9,24
1/17/1972,4,0,8,10,22
1/18/1972,6,0,10,0,16
1/19/1972,8,0,3,8,19
1/20/1972,7,0,7,5,19
1/21/1972,5,0,8,9,22
1/22/1972,8,0,9,3,20
1/23/1972,10,0,4,3,17
1/24/1972,11,0,10,6,27
1/25/1972,6,0,7,5,18
1/26/1972,4,0,5,6,15
1/27/1972,5,0,2,2,9
1/28/1972,12,0,6,0,18
1/29/1972,12,0,6,4,22
1/30/1972,4,0,2,7,13
1/31/1972,12,0,2,7,21
2/1/1972,12,0,6,3,21
2/2/1972,7,0,5,8,20
2/3/1972,4,0,8,7,19
2/4/1972,8,0,3,11,22
2/5/1972,10,0,5,2,17
2/6/1972,10,0,3,10,23
2/7/1972,9,0,8,3,20
2/8/1972,5,0,7,1,13
2/9/1972,9,0,7,11,27
2/10/1972,12,0,7,3,22
2/11/1972,10,0,9,10,29
2/12/1972,5,0,8,4,17
2/13/1972,8,0,2,11,21
2/14/1972,7,0,4,7,18
2/15/1972,7,0,4,4,15
2/16/1972,11,0,4,8,23
2/17/1972,9,0,9,3,21
2/18/1972,11,0,10,2,23
2/19/1972,8,0,5,4,17
2/20/1972,10,0,6,3,19
2/21/1972,10,0,8,6,24
2/22/1972,8,0,6,6,20
2/23/1972,12,0,10,6,28
2/24/1972,4,0,9,9,22
2/25/1972,8,0,3,8,19
2/26/1972,6,0,5,2,13
2/27/1972,10,0,4,7,21
2/28/1972,12,0,10,5,27
2/29/1972,7,0,7,0,14
3/1/1972,6,0,3,9,18
3/2/1972,8,0,10,8,26
3/3/1972,7,0,3,3,13
3/4/1972,11,0,3,0,14
3/5/1972,10,0,5,1,16
3/6/1972,5,0,5,4,14
3/7/1972,5,0,7,0,12
3/8/1972,7,0,9,6,22
3/9/1972,5,0,9,3,17
3/10/1972,4,0,2,11,17
3/11/1972,8,0,6,5,19
3/12/1972,7,0,7,10,24
3/13/1972,7,0,2,2,11
3/14/1972,11,0,8,10,29
3/15/1972,12,0,5,4,21
3/16/1972,10,0,5,8,23
3/17/1972,5,0,8,1,14
3/18/1972,10,0,5,6,21
3/19/1972,9,0,6,9,24
3/20/1972,12,0,10,0,22
3/21/1972,10,0,2,11,23
3/22/1972,12,0,2,3,17
3/23/1972,12,0,3,11,26
3/24/1972,10,0,4,6,20
3/25/1972,10,0,10,0,20
3/26/1972,9,0,5,4,18
3/27/1972,6,0,10,6,22
3/28/1972,12,0,10,0,22
3/29/1972,8,0,8,11,27
3/30/1972,10,0,7,0,17
3/31/1972,6,0,9,2,17
4/1/1972,8,0,8,5,21
4/2/1972,11,0,10,4,25
4/3/1972,10,0,6,10,26
4/4/1972,5,0,3,5,13
4/5/1972,5,0,4,9,18
4/6/1972,10,0,2,0,12
4/7/1972,5,0,8,1,14
4/8/1972,10,0,10,1,21
4/9/1972,11,0,5,4,20
4/10/1972,6,0,3,9,18
4/11/1972,12,0,9,5,26
4/12/1972,8,0,9,8,25
4/13/1972,5,0,9,5,19
4/14/1972,8,0,7,0,15
4/15/1972,8,0,7,5,20
4/16/1972,9,0,2,6,17
4/17/1972,7,0,7,2,16
4/18/1972,7,0,8,2,17
4/19/1972,7,0,10,5,22
4/20/1972,10,0,2,11,23
4/21/1972,6,0,5,2,13
4/22/1972,8,0,7,6,21
4/23/1972,7,0,9,1,17
4/24/1972,10,0,5,8,23
4/25/1972,10,0,5,1,16
4/26/1972,6,0,7,10,23
4/27/1972,12,0,10,9,31
4/28/1972,4,0,9,0,13
4/29/1972,10,0,6,7,23
4/30/1972,6,0,6,5,17
5/1/1972,7,0,3,10,20
5/2/1972,12,0,10,7,29
5/3/1972,11,0,2,9,22
5/4/1972,5,0,2,5,12
5/5/1972,7,0,7,9,23
5/6/1972,5,0,4,7,16
5/7/1972,9,0,8,2,19
5/8/1972,8,0,7,4,19
5/9/1972,11,0,5,5,21
5/10/1972,10,0,7,3,20
5/11/1972,7,0,7,2,16
5/12/1972,10,0,10,5,25
5/13/1972,5,0,3,4,12
5/14/1972,7,0,9,4,20
5/15/1972,8,0,9,2,19
5/16/1972,9,0,8,9,26
5/17/1972,12,0,7,6,25
5/18/1972,4,0,3,7,14
5/19/1972,5,0,6,0,11
5/20/1972,6,0,4,3,13
5/21/1972,10,0,4,2,16
5/22/1972,4,0,9,11,24
5/23/1972,7,0,5,9,21
5/24/1972,5,0,7,2,14
5/25/1972,12,0,5,3,20
5/26/1972,9,0,8,9,26
5/27/1972,11,0,8,9,28
5/28/1972,5,0,10,8,23
5/29/1972,4,0,4,4,12
5/30/1972,7,0,7,3,17
5/31/1972,9,0,8,6,23
6/1/1972,7,0,5,9,21
6/2/1972,12,0,10,10,32
6/3/1972,4,0,2,7,13
6/4/1972,7,0,2,2,11
6/5/1972,4,0,8,8,20
6/6/1972,5,0,7,7,19
6/7/1972,5,0,3,7,15
6/8/1972,10,0,7,1,18
6/9/1972,11,0,6,10,27
6/10/1972,4,0,2,3,9
6/11/1972,9,0,8,1,18
6/12/1972,9,0,7,11,27
6/13/1972,11,0,8,11,30
6/14/1972,10,0,10,6,26
6/15/1972,7,0,7,5,19
6/16/1972,7,0,2,7,16
6/17/1972,5,0,7,1,13
6/18/1972,12,0,7,0,19
6/19/1972,7,0,3,9,19
6/20/1972,4,0,6,6,16
6/21/1972,4,0,5,7,16
6/22/1972,7,0,4,10,21
6/23/1972,6,0,2,2,10
6/24/1972,5,0,10,6,21
6/25/1972,8,0,10,11,29
6/26/1972,5,0,4,2,11
6/27/1972,10,0,8,11,29
6/28/1972,8,0,7,2,17
6/29/1972,10,0,4,2,16
6/30/1972,11,0,4,9,24
7/1/1972,8,0,7,7,22
7/2/1972,9,0,6,0,15
7/3/1972,12,0,8,10,30
7/4/1972,11,0,7,9,27
7/5/1972,5,0,10,5,20
7/6/1972,12,0,3,0,15
7/7/1972,10,0,6,9,25
7/8/1972,5,0,4,1,10
7/9/1972,12,0,8,3,23
7/10/1972,5,0,6,3,14
7/11/1972,4,0,3,0,7
7/12/1972,10,0,4,9,23
7/13/1972,6,0,10,0,16
7/14/1972,6,0,8,9,23
7/15/1972,10,0,3,8,21
7/16/1972,8,0,7,8,23
7/17/1972,4,0,5,4,13
7/18/1972,9,0,10,0,19
7/19/1972,12,0,3,6,21
7/20/1972,4,0,2,3,9
7/21/1972,4,0,8,1,13
7/22/1972,11,0,5,0,16
7/23/1972,7,0,4,4,15
7/24/1972,7,0,9,9,25
7/25/1972,5,0,3,7,15
7/26/1972,8,0,2,1,11
7/27/1972,7,0,9,3,19
7/28/1972,9,0,9,4,22
7/29/1972,6,0,3,2,11
7/30/1972,11,0,7,2,20
7/31/1972,11,0,10,11,32
8/1/1972,9,0,8,11,28
8/2/1972,9,0,3,8,20
8/3/1972,4,0,6,11,21
8/4/1972,12,0,2,10,24
8/5/1972,9,0,4,0,13
8/6/1972,7,0,9,0,16
8/7/1972,10,0,2,5,17
8/8/1972,11,0,7,4,22
8/9/1972,10,0,8,8,26
8/10/1972,8,0,10,10,28
8/11/1972,11,0,5,7,23
8/12/1972,9,0,7,3,19
8/13/1972,5,0,3,8,16
8/14/1972,5,0,5,5,15
8/15/1972,8,0,9,7,24
8/16/1972,4,0,2,2,8
8/17/1972,9,0,5,0,14
8/18/1972,11,0,4,8,23
8/19/1972,12,0,3,9,24
8/20/1972,8,0,6,9,23
8/21/1972,8,0,3,3,14
8/22/1972,10,0,8,5,23
8/23/1972,5,0,5,8,18
8/24/1972,10,0,7,9,26
8/25/1972,4,0,4,3,11
8/26/1972,8,0,7,7,22
8/27/1972,8,0,4,0,12
8/28/1972,11,0,8,4,23
8/29/1972,8,0,5,2,15
8/30/1972,8,0,6,6,20
8/31/1972,8,0,6,1,15
9/1/1972,12,0,3,6,21
9/2/1972,4,0,7,4,15
9/3/1972,12,0,9,3,24
9/4/1972,7,0,2,8,17
9/5/1972,12,0,2,7,21
9/6/1972,7,0,4,11,22
9/7/1972,8,0,7,10,25
9/8/1972,12,0,8,4,24
9/9/1972,8,0,8,11,27
9/10/1972,11,0,4,6,21
9/11/1972,6,0,3,2,11
9/12/1972,5,0,4,0,9
9/13/1972,7,0,2,7,16
9/14/1972,6,0,7,6,19
9/15/1972,10,0,5,1,16
9/16/1972,11,0,6,11,28
9/17/1972,7,0,5,11,23
9/18/1972,9,0,7,5,21
9/19/1972,6,0,5,10,21
9/20/1972,6,0,6,10,22
9/21/1972,6,0,7,3,16
9/22/1972,9,0,2,2,13
9/23/1972,11,0,4,1,16
9/24/1972,5,0,10,9,24
9/25/1972,11,0,2,3,16
9/26/1972,8,0,10,2,20
9/27/1972,11,0,5,6,22
9/28/1972,7,0,9,3,19
9/29/1972,4,0,9,2,15
9/30/1972,6,0,6,7,19
10/1/1972,4,0,4,2,10
10/2/1972,9,0,6,9,24
10/3/1972,4,0,3,0,7
10/4/1972,9,0,6,4,19
10/5/1972,7,0,3,2,12
10/6/1972,6,0,2,0,8
10/7/1972,12,0,4,11,27
10/8/1972,8,0,8,8,24
10/9/1972,5,0,2,8,15
10/10/1972,12,0,3,5,20
10/11/1972,6,0,5,10,21
10/12/1972,5,0,10,4,19
10/13/1972,11,0,4,6,21
10/14/1972,11,0,6,4,21
10/15/1972,5,0,3,4,12
10/16/1972,4,0,9,11,24
10/17/1972,6,0,4,9,19
10/18/1972,8,0,10,4,22
10/19/1972,4,0,2,10,16
10/20/1972,10,0,6,4,20
10/21/1972,7,0,4,11,22
10/22/1972,7,0,6,6,19
10/23/1972,10,0,2,9,21
10/24/1972,4,0,9,3,16
10/25/1972,6,0,8,7,21
10/26/1972,10,0,2,10,22
10/27/1972,5,0,7,10,22
10/28/1972,10,0,7,10,27
10/29/1972,4,0,6,7,17
10/30/1972,7,0,3,2,12
10/31/1972,10,0,9,3,22
11/1/1972,4,0,10,0,14
11/2/1972,6,0,5,9,20
11/3/1972,6,0,3,11,20
11/4/1972,10,0,7,7,24
11/5/1972,7,0,4,1,12
11/6/1972,10,0,4,7,21
11/7/1972,4,0,8,10,22
11/8/1972,12,0,6,7,25
11/9/1972,5,0,6,0,11
11/10/1972,8,0,3,3,14
11/11/1972,8,0,6,3,17
11/12/1972,5,0,5,5,15
11/13/1972,7,0,6,7,20
11/14/1972,11,0,7,5,23
11/15/1972,5,0,6,7,18
11/16/1972,7,0,8,3,18
11/17/1972,7,0,5,1,13
11/18/1972,4,0,2,5,11
11/19/1972,11,0,8,11,30
11/20/1972,5,0,4,1,10
11/21/1972,12,0,4,0,16
11/22/1972,12,0,4,2,18
11/23/1972,8,0,9,0,17
11/24/1972,9,0,5,3,17
11/25/1972,9,0,3,7,19
11/26/1972,7,0,6,6,19
11/27/1972,4,0,3,6,13
11/28/1972,9,0,7,8,24
11/29/1972,5,0,2,3,10
11/30/1972,7,0,10,1,18
12/1/1972,9,0,2,1,12
12/2/1972,9,0,10,9,28
12/3/1972,9,0,2,9,20
12/4/1972,9,0,5,8,22
12/5/1972,11,0,2,3,16
12/6/1972,11,0,2,0,13
12/7/1972,7,0,10,10,27
12/8/1972,8,0,4,10,22
12/9/1972,4,0,5,0,9
12/10/1972,4,0,8,2,14
12/11/1972,12,0,3,0,15
12/12/1972,10,0,10,6,26
12/13/1972,11,0,5,8,24
12/14/1972,9,0,7,5,21
12/15/1972,9,0,9,4,22
12/16/1972,12,0,7,3,22
12/17/1972,12,0,5,0,17
12/18/1972,12,0,7,10,29
12/19/1972,10,0,5,9,24
12/20/1972,11,0,10,6,27
12/21/1972,10,0,7,7,24
12/22/1972,6,0,10,2,18
12/23/1972,11,0,2,3,16
12/24/1972,12,0,8,1,21
12/25/1972,8,0,4,1,13
12/26/1972,9,0,4,3,16
12/27/1972,4,0,4,4,12
12/28/1972,12,0,8,8,28
12/29/1972,6,0,7,6,19
12/30/1972,10,0,3,6,19
12/31/1972,4,0,2,0,6
1/1/1973,12,0,2,9,23
1/2/1973,10,0,8,11,29
1/3/1973,10,0,7,2,19
1/4/1973,12,0,6,8,26
1/5/1973,7,0,4,3,14
1/6/1973,6,0,2,1,9
1/7/1973,11,0,4,2,17
1/8/1973,5,0,7,0,12
1/9/1973,8,0,7,4,19
1/10/1973,5,0,4,2,11
1/11/1973,9,0,4,7,20
1/12/1973,11,0,2,0,13
1/13/1973,5,0,2,4,11
1/14/1973,12,0,5,0,17
1/15/1973,7,0,2,0,9
1/16/1973,10,0,9,0,19
1/17/1973,9,0,9,0,18
1/18/1973,10,0,2,4,16
1/19/1973,11,0,6,4,21
1/20/1973,4,0,8,3,15
1/21/1973,5,0,8,11,24
1/22/1973,7,0,6,3,16
1/23/1973,12,0,3,4,19
1/24/1973,8,0,2,0,10
1/25/1973,5,0,6,9,20
1/26/1973,8,0,9,5,22
1/27/1973,5,0,3,10,18
1/28/1973,9,0,10,11,30
1/29/1973,6,0,10,4,20
1/30/1973,12,0,5,2,19
1/31/1973,4,0,9,1,14
2/1/1973,6,0,2,3,11
2/2/1973,6,0,3,8,17
2/3/1973,6,0,4,6,16
2/4/1973,10,0,3,6,19
2/5/1973,10,0,9,2,21
2/6/1973,5,0,2,8,15
2/7/1973,12,0,9,11,32
2/8/1973,11,0,10,8,29
2/9/1973,10,0,9,8,27
2/10/1973,12,0,8,9,29
2/11/1973,5,0,7,8,20
2/12/1973,12,0,4,3,19
2/13/1973,5,0,9,7,21
2/14/1973,7,0,4,3,14
2/15/1973,9,0,5,8,22
2/16/1973,5,0,2,0,7
2/17/1973,5,0,10,3,18
2/18/1973,7,0,4,11,22
2/19/1973,10,0,4,10,24
2/20/1973,9,0,6,6,21
2/21/1973,4,0,4,3,11
2/22/1973,8,0,9,1,18
2/23/1973,11,0,9,0,20
2/24/1973,10,0,9,9,28
2/25/1973,9,0,5,7,21
2/26/1973,9,0,3,4,16
2/27/1973,7,0,8,5,20
2/28/1973,8,0,4,0,12
3/1/1973,6,0,6,3,15
3/2/1973,11,0,7,10,28
3/3/1973,9,0,3,11,23
3/4/1973,12,0,9,0,21
3/5/1973,7,0,10,1,18
3/6/1973,9,0,2,4,15
3/7/1973,9,0,6,2,17
3/8/1973,9,0,2,3,14
3/9/1973,11,0,4,7,22
3/10/1973,6,0,5,4,15
3/11/1973,4,0,8,2,14
3/12/1973,12,0,6,10,28
3/13/1973,12,0,4,1,17
3/14/1973,4,0,3,8,15
3/15/1973,6,0,3,11,20
3/16/1973,9,0,2,8,19
3/17/1973,11,0,2,1,14
3/18/1973,8,0,10,6,24
3/19/1973,8,0,6,7,21
3/20/1973,10,0,2,2,14
3/21/1973,8,0,7,1,16
3/22/1973,12,0,6,0,18
3/23/1973,9,0,7,3,19
3/24/1973,9,0,5,2,16
3/25/1973,9,0,5,4,18
3/26/1973,10,0,4,8,22
3/27/1973,5,0,3,1,9
3/28/1973,7,0,9,7,23
3/29/1973,8,0,10,11,29
3/30/1973,7,0,3,6,16
3/31/1973,11,0,9,10,30
4/1/1973,11,0,9,3,23
4/2/1973,7,0,5,4,16
4/3/1973,10,0,9,8,27
4/4/1973,11,0,8,3,22
4/5/1973,10,0,5,11,26
4/6/1973,10,0,6,1,17
4/7/1973,9,0,8,10,27
4/8/1973,7,0,5,2,14
4/9/1973,8,0,2,8,18
4/10/1973,5,0,9,11,25
4/11/1973,9,0,10,2,21
4/12/1973,12,0,6,6,24
4/13/1973,6,0,9,9,24
4/14/1973,10,0,3,0,13
4/15/1973,12,0,2,10,24
4/16/1973,10,0,8,7,25
4/17/1973,9,0,10,6,25
4/18/1973,11,0,5,2,18
4/19/1973,7,0,9,6,22
4/20/1973,5,0,4,4,13
4/21/1973,12,0,2,2,16
4/22/1973,8,0,9,4,21
4/23/1973,4,0,6,8,18
4/24/1973,10,0,10,4,24
4/25/1973,12,0,3,0,15
4/26/1973,10,0,4,11,25
4/27/1973,5,0,7,8,20
4/28/1973,8,0,6,7,21
4/29/1973,8,0,2,4,14
4/30/1973,12,0,6,11,29
5/1/1973,8,0,6,2,16
5/2/1973,4,0,4,3,11
5/3/1973,4,0,3,1,8
5/4/1973,11,0,2,3,16
5/5/1973,4,0,3,4,11
5/6/1973,11,0,5,9,25
5/7/1973,6,0,9,7,22
5/8/1973,12,0,7,2,21
5/9/1973,7,0,10,3,20
5/10/1973,11,0,6,4,21
5/11/1973,10,0,5,4,19
5/12/1973,5,0,4,1,10
5/13/1973,12,0,2,1,15
5/14/1973,6,0,6,7,19
5/15/1973,12,0,5,8,25
5/16/1973,8,0,5,8,21
5/17/1973,9,0,6,1,16
5/18/1973,8,0,3,10,21
5/19/1973,9,0,8,6,23
5/20/1973,11,0,9,2,22
5/21/1973,12,0,3,8,23
5/22/1973,4,0,10,7,21
5/23/1973,8,0,9,9,26
5/24/1973,11,0,7,8,26
5/25/1973,8,0,2,10,20
5/26/1973,5,0,3,8,16
5/27/1973,9,0,6,2,17
5/28/1973,12,0,6,9,27
5/29/1973,4,0,6,5,15
5/30/1973,6,0,7,8,21
5/31/1973,8,0,8,11,27
6/1/1973,8,0,10,1,19
6/2/1973,4,0,6,9,19
6/3/1973,4,0,10,1,15
6/4/1973,5,0,9,10,24
6/5/1973,6,0,7,3,16
6/6/1973,6,0,7,5,18
6/7/1973,4,0,3,8,15
6/8/1973,9,0,9,0,18
6/9/1973,9,0,10,9,28
6/10/1973,11,0,6,3,20
6/11/1973,4,0,4,9,17
6/12/1973,4,0,7,10,21
6/13/1973,8,0,9,0,17
6/14/1973,8,0,4,6,18
6/15/1973,9,0,3,7,19
6/16/1973,6,0,5,1,12
6/17/1973,6,0,9,9,24
6/18/1973,11,0,6,0,17
6/19/1973,9,0,4,11,24
6/20/1973,4,0,9,10,23
6/21/1973,7,0,9,9,25
6/22/1973,12,0,9,1,22
6/23/1973,12,0,8,3,23
6/24/1973,9,0,4,10,23
6/25/1973,11,0,8,8,27
6/26/1973,7,0,9,10,26
6/27/1973,9,0,9,2,20
6/28/1973,7,0,3,6,16
6/29/1973,12,0,2,2,16
6/30/1973,10,0,7,1,18
7/1/1973,5,0,3,0,8
7/2/1973,6,0,8,2,16
7/3/1973,5,0,5,4,14
7/4/1973,4,0,10,7,21
7/5/1973,10,0,2,4,16
7/6/1973,11,0,9,11,31
7/7/1973,9,0,2,1,12
7/8/1973,9,0,10,3,22
7/9/1973,11,0,5,7,23
7/10/1973,12,0,2,10,24
7/11/1973,10,0,10,2,22
7/12/1973,7,0,4,0,11
7/13/1973,11,0,10,2,23
7/14/1973,7,0,5,3,15
7/15/1973,9,0,9,7,25
7/16/1973,9,0,9,11,29
7/17/1973,8,0,4,2,14
7/18/1973,5,0,6,4,15
7/19/1973,4,0,6,0,10
7/20/1973,12,0,2,10,24
7/21/1973,12,0,10,6,28
7/22/1973,4,0,8,10,22
7/23/1973,8,0,4,5,17
7/24/1973,4,0,5,7,16
7/25/1973,9,0,4,4,17
7/26/1973,11,0,7,8,26
7/27/1973,4,0,4,11,19
7/28/1973,5,0,3,8,16
7/29/1973,5,0,9,9,23
7/30/1973,5,0,10,0,15
7/31/1973,7,0,5,10,22
8/1/1973,9,0,4,10,23
8/2/1973,10,0,2,3,15
8/3/1973,12,0,5,6,23
8/4/1973,8,0,3,10,21
8/5/1973,4,0,2,11,17
8/6/1973,8,0,2,7,17
8/7/1973,4,0,2,0,6
8/8/1973,12,0,7,3,22
8/9/1973,10,0,8,9,27
8/10/1973,11,0,5,7,23
8/11/1973,4,0,4,0,8
8/12/1973,12,0,2,6,20
8/13/1973,8,0,10,4,22
8/14/1973,9,0,10,6,25
8/15/1973,5,0,10,10,25
8/16/1973,9,0,4,3,16
8/17/1973,12,0,10,10,32
8/18/1973,4,0,2,2,8
8/19/1973,9,0,5,5,19
8/20/1973,9,0,10,9,28
8/21/1973,5,0,9,3,17
8/22/1973,10,0,10,7,27
8/23/1973,12,0,5,2,19
8/24/1973,4,0,9,4,17
8/25/1973,6,0,6,10,22
8/26/1973,6,0,6,7,19
8/27/1973,4,0,5,7,16
8/28/1973,6,0,5,9,20
8/29/1973,11,0,7,6,24
8/30/1973,7,0,5,5,17
8/31/1973,5,0,8,11,24
9/1/1973,6,0,7,3,16
9/2/1973,10,0,7,2,19
9/3/1973,10,0,8,10,28
9/4/1973,12,0,3,6,21
9/5/1973,10,0,5,10,25
9/6/1973,4,0,8,9,21
9/7/1973,5,0,9,11,25
9/8/1973,5,0,2,1,8
9/9/1973,6,0,4,11,21
9/10/1973,12,0,2,0,14
9/11/1973,5,0,10,0,15
9/12/1973,11,0,6,1,18
9/13/1973,5,0,4,11,20
9/14/1973,9,0,5,10,24
9/15/1973,4,0,7,6,17
9/16/1973,10,0,6,2,18
9/17/1973,7,0,3,6,16
9/18/1973,4,0,6,3,13
9/19/1973,11,0,10,0,21
9/20/1973,4,0,6,3,13
9/21/1973,11,0,3,1,15
9/22/1973,7,0,8,4,19
9/23/1973,12,0,5,6,23
9/24/1973,8,0,4,10,22
9/25/1973,11,0,3,6,20
9/26/1973,7,0,5,6,18
9/27/1973,10,0,7,5,22
9/28/1973,5,0,7,0,12
9/29/1973,7,0,3,2,12
9/30/1973,10,0,8,5,23
10/1/1973,11,0,4,1,16
10/2/1973,6,0,7,2,15
10/3/1973,8,0,3,9,20
10/4/1973,8,0,4,9,21
10/5/1973,9,0,7,3,19
10/6/1973,9,0,5,8,22
10/7/1973,4,0,4,0,8
10/8/1973,6,0,4,4,14
10/9/1973,7,0,6,2,15
10/10/1973,7,0,3,6,16
10/11/1973,5,0,3,8,16
10/12/1973,8,0,7,9,24
10/13/1973,6,0,10,9,25
10/14/1973,9,0,9,11,29
10/15/1973,8,0,3,0,11
10/16/1973,12,0,5,5,22
10/17/1973,7,0,2,6,15
10/18/1973,9,0,9,11,29
10/19/1973,4,0,5,0,9
10/20/1973,6,0,7,11,24
10/21/1973,11,0,7,8,26
10/22/1973,12,0,6,3,21
10/23/1973,7,0,7,8,22
10/24/1973,4,0,9,4,17
10/25/1973,10,0,7,6,23
10/26/1973,6,0,7,9,22
10/27/1973,7,0,5,4,16
10/28/1973,6,0,10,1,17
10/29/1973,10,0,7,6,23
10/30/1973,9,0,10,4,23
10/31/1973,9,0,8,7,24
11/1/1973,12,0,6,3,21
11/2/1973,12,0,5,0,17
11/3/1973,12,0,10,7,29
11/4/1973,8,0,3,5,16
11/5/1973,6,0,4,6,16
11/6/1973,8,0,9,7,24
11/7/1973,11,0,6,3,20
11/8/1973,8,0,8,9,25
11/9/1973,6,0,3,8,17
11/10/1973,5,0,5,9,19
11/11/1973,7,0,6,0,13
11/12/1973,7,0,5,9,21
11/13/1973,4,0,4,0,8
11/14/1973,12,0,2,3,17
11/15/1973,4,0,6,2,12
11/16/1973,4,0,2,10,16
11/17/1973,6,0,10,7,23
11/18/1973,5,0,4,7,16
11/19/1973,10,0,4,4,18
11/20/1973,10,0,8,11,29
11/21/1973,5,0,5,6,16
11/22/1973,8,0,2,5,15
11/23/1973,10,0,5,11,26
11/24/1973,12,0,8,4,24
11/25/1973,10,0,4,3,17
11/26/1973,8,0,5,11,24
11/27/1973,7,0,2,6,15
11/28/1973,10,0,5,7,22
11/29/1973,11,0,2,1,14
11/30/1973,5,0,10,1,16
12/1/1973,5,0,3,7,15
12/2/1973,10,0,6,4,20
12/3/1973,10,0,8,0,18
12/4/1973,11,0,4,7,22
12/5/1973,11,0,3,5,19
12/6/1973,9,0,4,10,23
12/7/1973,12,0,6,5,23
12/8/1973,8,0,2,8,18
12/9/1973,10,0,9,3,22
12/10/1973,7,0,9,10,26
12/11/1973,11,0,7,10,28
12/12/1973,11,0,9,11,31
12/13/1973,6,0,8,2,16
12/14/1973,12,0,4,9,25
12/15/1973,8,0,2,8,18
12/16/1973,9,0,8,6,23
12/17/1973,5,0,8,10,23
12/18/1973,6,0,6,4,16
12/19/1973,11,0,4,6,21
12/20/1973,6,0,8,9,23
12/21/1973,12,0,6,1,19
12/22/1973,10,0,2,3,15
12/23/1973,10,0,9,3,22
12/24/1973,12,0,7,1,20
12/25/1973,6,0,5,8,19
12/26/1973,6,0,3,11,20
12/27/1973,7,0,7,9,23
12/28/1973,7,0,9,9,25
12/29/1973,9,0,8,10,27
12/30/1973,7,0,5,2,14
12/31/1973,12,0,5,3,20
1/1/1974,4,0,9,2,15
1/2/1974,8,0,3,0,11
1/3/1974,12,0,5,6,23
1/4/1974,6,0,8,4,18
1/5/1974,12,0,5,0,17
1/6/1974,4,0,9,5,18
1/7/1974,5,0,3,0,8
1/8/1974,9,0,7,4,20
1/9/1974,9,0,9,11,29
1/10/1974,8,0,8,4,20
1/11/1974,10,0,2,8,20
1/12/1974,7,0,10,6,23
1/13/1974,5,0,4,2,11
1/14/1974,8,0,7,10,25
1/15/1974,7,0,4,4,15
1/16/1974,9,0,2,4,15
1/17/1974,11,0,10,9,30
1/18/1974,7,0,4,4,15
1/19/1974,4,0,7,10,21
1/20/1974,4,0,9,7,20
1/21/1974,9,0,5,0,14
1/22/1974,11,0,3,0,14
1/23/1974,5,0,7,10,22
1/24/1974,6,0,7,5,18
1/25/1974,7,0,8,11,26
1/26/1974,12,0,5,6,23
1/27/1974,4,0,4,9,17
1/28/1974,12,0,3,1,16
1/29/1974,6,0,10,8,24
1/30/1974,12,0,6,2,20
1/31/1974,5,0,4,7,16
2/1/1974,4,0,4,5,13
2/2/1974,4,0,10,4,18
2/3/1974,5,0,3,1,9
2/4/1974,4,0,5,0,9
2/5/1974,8,0,2,0,10
2/6/1974,11,0,7,8,26
2/7/1974,4,0,6,10,20
2/8/1974,5,0,8,8,21
2/9/1974,8,0,8,6,22
2/10/1974,6,0,3,5,14
2/11/1974,6,0,8,2,16
2/12/1974,9,0,9,6,24
2/13/1974,4,0,4,11,19
2/14/1974,5,0,10,0,15
2/15/1974,9,0,8,1,18
2/16/1974,12,0,8,11,31
2/17/1974,4,0,8,6,18
2/18/1974,6,0,9,5,20
2/19/1974,10,0,2,11,23
2/20/1974,10,0,10,0,20
2/21/1974,7,0,3,5,15
2/22/1974,5,0,10,2,17
2/23/1974,7,0,7,5,19
2/24/1974,12,0,5,4,21
2/25/1974,7,0,6,0,13
2/26/1974,6,0,2,9,17
2/27/1974,12,0,5,5,22
2/28/1974,4,0,7,11,22
3/1/1974,7,0,3,6,16
3/2/1974,4,0,7,9,20
3/3/1974,10,0,5,9,24
3/4/1974,5,0,8,4,17
3/5/1974,9,0,10,8,27
3/6/1974,10,0,9,11,30
3/7/1974,11,0,4,11,26
3/8/1974,6,0,10,5,21
3/9/1974,9,0,3,2,14
3/10/1974,10,0,3,2,15
3/11/1974,9,0,10,5,24
3/12/1974,7,0,5,7,19
3/13/1974,9,0,8,5,22
3/14/1974,8,0,4,0,12
3/15/1974,10,0,6,2,18
3/16/1974,9,0,8,3,20
3/17/1974,6,0,6,8,20
3/18/1974,9,0,9,1,19
3/19/1974,9,0,7,2,18
3/20/1974,12,0,2,6,20
3/21/1974,6,0,7,6,19
3/22/1974,4,0,5,3,12
3/23/1974,12,0,7,0,19
3/24/1974,4,0,6,8,18
3/25/1974,8,0,5,5,18
3/26/1974,11,0,4,6,21
3/27/1974,10,0,3,10,23
3/28/1974,4,0,5,1,10
3/29/1974,7,0,5,6,18
3/30/1974,5,0,2,3,10
3/31/1974,6,0,5,8,19
4/1/1974,10,0,4,2,16
4/2/1974,10,0,2,5,17
4/3/1974,4,0,9,3,16
4/4/1974,5,0,5,2,12
4/5/1974,10,0,9,4,23
4/6/1974,8,0,8,9,25
4/7/1974,11,0,2,6,19
4/8/1974,9,0,2,3,14
4/9/1974,5,0,10,1,16
4/10/1974,7,0,5,6,18
4/11/1974,6,0,5,9,20
4/12/1974,8,0,9,7,24
4/13/1974,8,0,2,6,16
4/14/1974,8,0,10,3,21
4/15/1974,12,0,6,5,23
4/16/1974,4,0,3,10,17
4/17/1974,10,0,7,7,24
4/18/1974,9,0,3,3,15
4/19/1974,4,0,3,5,12
4/20/1974,9,0,7,10,26
4/21/1974,12,0,7,10,29
4/22/1974,6,0,9,10,25
4/23/1974,5,0,2,6,13
4/24/1974,7,0,9,11,27
4/25/1974,5,0,8,6,19
4/26/1974,4,0,7,5,16
4/27/1974,4,0,3,0,7
4/28/1974,4,0,5,7,16
4/29/1974,5,0,7,10,22
4/30/1974,9,0,10,7,26
5/1/1974,8,0,4,8,20
5/2/1974,7,0,10,2,19
5/3/1974,11,0,9,8,28
5/4/1974,5,0,2,2,9
5/5/1974,5,0,5,1,11
5/6/1974,9,0,2,3,14
5/7/1974,10,0,5,11,26
5/8/1974,12,0,3,6,21
5/9/1974,9,0,9,0,18
5/10/1974,9,0,8,8,25
5/11/1974,6,0,10,7,23
5/12/1974,9,0,10,9,28
5/13/1974,11,0,9,9,29
5/14/1974,10,0,3,3,16
5/15/1974,8,0,10,2,20
5/16/1974,7,0,5,11,23
5/17/1974,7,0,9,7,23
5/18/1974,9,0,7,7,23
5/19/1974,11,0,3,0,14
5/20/1974,4,0,5,4,13
5/21/1974,4,0,4,10,18
5/22/1974,10,0,2,11,23
5/23/1974,9,0,8,5,22
5/24/1974,8,0,2,10,20
5/25/1974,12,0,5,8,25
5/26/1974,7,0,10,1,18
5/27/1974,8,0,4,9,21
5/28/1974,8,0,3,4,15
5/29/1974,6,0,8,0,14
5/30/1974,4,0,2,6,12
5/31/1974,10,0,10,3,23
6/1/1974,4,0,2,1,7
6/2/1974,6,0,6,11,23
6/3/1974,12,0,5,6,23
6/4/1974,4,0,10,1,15
6/5/1974,11,0,3,4,18
6/6/1974,12,0,2,6,20
6/7/1974,6,0,5,5,16
6/8/1974,7,0,5,6,18
6/9/1974,9,0,7,11,27
6/10/1974,4,0,5,4,13
6/11/1974,11,0,4,7,22
6/12/1974,9,0,8,0,17
6/13/1974,4,0,9,1,14
6/14/1974,5,0,6,6,17
6/15/1974,6,0,10,10,26
6/16/1974,8,0,9,4,21
6/17/1974,5,0,6,5,16
6/18/1974,5,0,7,11,23
6/19/1974,10,0,7,4,21
6/20/1974,4,0,3,1,8
6/21/1974,6,0,7,2,15
6/22/1974,7,0,6,6,19
6/23/1974,11,0,6,0,17
6/24/1974,8,0,4,7,19
6/25/1974,11,0,4,11,26
6/26/1974,8,0,4,6,18
6/27/1974,8,0,3,10,21
6/28/1974,4,0,7,11,22
6/29/1974,11,0,4,0,15
6/30/1974,4,0,3,6,13
7/1/1974,6,0,5,7,18
7/2/1974,12,0,9,1,22
7/3/1974,6,0,2,6,14
7/4/1974,10,0,6,7,23
7/5/1974,4,0,5,3,12
7/6/1974,6,0,2,10,18
7/7/1974,10,0,3,11,24
7/8/1974,8,0,10,6,24
7/9/1974,9,0,3,6,18
7/10/1974,11,0,7,9,27
7/11/1974,11,0,9,7,27
7/12/1974,10,0,5,0,15
7/13/1974,8,0,3,6,17
7/14/1974,4,0,9,11,24
7/15/1974,6,0,10,5,21
7/16/1974,9,0,6,9,24
7/17/1974,5,0,4,3,12
7/18/1974,9,0,5,4,18
7/19/1974,8,0,8,3,19
7/20/1974,8,0,9,10,27
7/21/1974,6,0,6,10,22
7/22/1974,7,0,8,5,20
7/23/1974,5,0,5,5,15
7/24/1974,9,0,6,2,17
7/25/1974,9,0,4,9,22
7/26/1974,6,0,6,2,14
7/27/1974,8,0,10,4,22
7/28/1974,12,0,3,7,22
7/29/1974,9,0,7,2,18
7/30/1974,11,0,10,1,22
7/31/1974,5,0,7,9,21
8/1/1974,4,0,5,9,18
8/2/1974,5,0,6,10,21
8/3/1974,7,0,8,3,18
8/4/1974,4,0,6,3,13
8/5/1974,12,0,10,7,29
8/6/1974,8,0,7,10,25
8/7/1974,5,0,9,6,20
8/8/1974,7,0,9,0,16
8/9/1974,12,0,2,1,15
8/10/1974,9,0,9,2,20
8/11/1974,10,0,8,5,23
8/12/1974,7,0,2,8,17
8/13/1974,6,0,8,0,14
8/14/1974,8,0,4,10,22
8/15/1974,6,0,7,6,19
8/16/1974,12,0,6,1,19
8/17/1974,5,0,3,2,10
8/18/1974,8,0,3,3,14
8/19/1974,6,0,4,0,10
8/20/1974,6,0,9,1,16
8/21/1974,7,0,6,3,16
8/22/1974,9,0,7,2,18
8/23/1974,8,0,4,10,22
8/24/1974,8,0,7,3,18
8/25/1974,10,0,7,0,17
8/26/1974,5,0,9,8,22
8/27/1974,12,0,6,7,25
8/28/1974,7,0,8,4,19
8/29/1974,9,0,9,7,25
8/30/1974,10,0,3,10,23
8/31/1974,9,0,9,6,24
9/1/1974,10,0,6,5,21
9/2/1974,9,0,9,7,25
9/3/1974,6,0,7,3,16
9/4/1974,10,0,5,2,17
9/5/1974,11,0,2,9,22
9/6/1974,10,0,6,8,24
9/7/1974,5,0,6,4,15
9/8/1974,5,0,2,6,13
9/9/1974,10,0,8,9,27
9/10/1974,11,0,2,11,24
9/11/1974,8,0,3,3,14
9/12/1974,10,0,10,1,21
9/13/1974,5,0,8,11,24
9/14/1974,8,0,6,10,24
9/15/1974,10,0,2,1,13
9/16/1974,4,0,9,1,14
9/17/1974,9,0,2,2,13
9/18/1974,12,0,8,3,23
9/19/1974,4,0,2,8,14
9/20/1974,12,0,4,7,23
9/21/1974,7,0,2,0,9
9/22/1974,11,0,10,8,29
9/23/1974,8,0,3,2,13
9/24/1974,6,0,2,4,12
9/25/1974,10,0,2,7,19
9/26/1974,9,0,6,7,22
9/27/1974,6,0,10,8,24
9/28/1974,9,0,5,0,14
9/29/1974,4,0,5,2,11
9/30/1974,6,0,8,6,20
10/1/1974,7,0,2,6,15
10/2/1974,12,0,10,4,26
10/3/1974,4,0,7,8,19
10/4/1974,10,0,3,8,21
10/5/1974,10,0,5,5,20
10/6/1974,10,0,4,3,17
10/7/1974,8,0,6,4,18
10/8/1974,11,0,10,9,30
10/9/1974,10,0,7,1,18
10/10/1974,8,0,9,8,25
10/11/1974,6,0,4,4,14
10/12/1974,9,0,6,1,16
10/13/1974,5,0,4,2,11
10/14/1974,12,0,10,11,33
10/15/1974,10,0,10,0,20
10/16/1974,7,0,5,1,13
10/17/1974,7,0,5,4,16
10/18/1974,5,0,7,8,20
10/19/1974,5,0,5,3,13
10/20/1974,4,0,7,5,16
10/21/1974,5,0,3,11,19
10/22/1974,6,0,3,1,10
10/23/1974,6,0,10,6,22
10/24/1974,5,0,2,3,10
10/25/1974,9,0,4,2,15
10/26/1974,8,0,7,5,20
10/27/1974,12,0,10,1,23
10/28/1974,4,0,6,4,14
10/29/1974,7,0,4,4,15
10/30/1974,11,0,8,8,27
10/31/1974,8,0,10,2,20
11/1/1974,12,0,3,0,15
11/2/1974,8,0,5,2,15
11/3/1974,11,0,7,2,20
11/4/1974,6,0,10,7,23
11/5/1974,8,0,2,11,21
11/6/1974,7,0,8,5,20
11/7/1974,9,0,6,9,24
11/8/1974,6,0,4,5,15
11/9/1974,5,0,5,3,13
11/10/1974,9,0,8,7,24
11/11/1974,11,0,7,3,21
11/12/1974,9,0,6,3,18
11/13/1974,4,0,2,9,15
11/14/1974,7,0,2,1,10
11/15/1974,11,0,8,5,24
11/16/1974,6,0,5,8,19
11/17/1974,8,0,8,0,16
11/18/1974,6,0,8,1,15
11/19/1974,6,0,10,10,26
11/20/1974,11,0,8,3,22
11/21/1974,5,0,7,6,18
11/22/1974,7,0,3,11,21
11/23/1974,11,0,2,0,13
11/24/1974,10,0,2,9,21
11/25/1974,5,0,9,5,19
11/26/1974,4,0,8,7,19
11/27/1974,8,0,5,1,14
11/28/1974,4,0,6,1,11
11/29/1974,10,0,10,11,31
11/30/1974,12,0,7,5,24
12/1/1974,5,0,4,10,19
12/2/1974,6,0,7,5,18
12/3/1974,7,0,3,8,18
12/4/1974,5,0,3,10,18
12/5/1974,4,0,7,10,21
12/6/1974,9,0,8,8,25
12/7/1974,4,0,10,9,23
12/8/1974,9,0,3,10,22
12/9/1974,6,0,5,0,11
12/10/1974,6,0,3,10,19
12/11/1974,9,0,7,5,21
12/12/1974,10,0,3,2,15
12/13/1974,4,0,10,6,20
12/14/1974,5,0,3,5,13
12/15/1974,10,0,10,11,31
12/16/1974,6,0,2,1,9
12/17/1974,12,0,5,2,19
12/18/1974,11,0,8,11,30
12/19/1974,9,0,2,11,22
12/20/1974,10,0,9,6,25
12/21/1974,9,0,5,3,17
12/22/1974,6,0,3,0,9
12/23/1974,10,0,9,10,29
12/24/1974,9,0,4,5,18
12/25/1974,11,0,8,2,21
12/26/1974,11,0,6,8,25
12/27/1974,7,0,4,3,14
12/28/1974,12,0,3,4,19
12/29/1974,5,0,2,11,18
12/30/1974,11,0,5,9,25
12/31/1974,4,0,3,5,12
1/1/1975,12,0,9,3,24
1/2/1975,7,0,10,7,24
1/3/1975,5,0,2,0,7
1/4/1975,5,0,5,8,18
1/5/1975,8,0,10,8,26
1/6/1975,4,0,8,5,17
1/7/1975,9,0,5,10,24
1/8/1975,10,0,9,10,29
1/9/1975,10,0,6,4,20
1/10/1975,8,0,6,8,22
1/11/1975,11,0,3,9,23
1/12/1975,10,0,2,5,17
1/13/1975,9,0,9,5,23
1/14/1975,5,0,5,3,13
1/15/1975,8,0,3,7,18
1/16/1975,4,0,5,9,18
1/17/1975,8,0,4,5,17
1/18/1975,6,0,3,10,19
1/19/1975,9,0,5,5,19
1/20/1975,12,0,2,7,21
1/21/1975,9,0,10,6,25
1/22/1975,4,0,10,4,18
1/23/1975,5,0,8,6,19
1/24/1975,4,0,10,8,22
1/25/1975,7,0,6,9,22
1/26/1975,8,0,2,8,18
1/27/1975,8,0,2,10,20
1/28/1975,12,0,9,6,27
1/29/1975,10,0,2,10,22
1/30/1975,6,0,2,1,9
1/31/1975,6,0,4,0,10
2/1/1975,12,0,10,2,24
2/2/1975,10,0,9,6,25
2/3/1975,7,0,5,8,20
2/4/1975,4,0,6,7,17
2/5/1975,6,0,10,8,24
2/6/1975,8,0,5,6,19
2/7/1975,9,0,4,8,21
2/8/1975,6,0,2,1,9
2/9/1975,5,0,10,6,21
2/10/1975,7,0,2,8,17
2/11/1975,7,0,4,1,12
2/12/1975,11,0,9,0,20
2/13/1975,10,0,7,8,25
2/14/1975,9,0,5,1,15
2/15/1975,8,0,7,1,16
2/16/1975,11,0,3,8,22
2/17/1975,5,0,6,1,12
2/18/1975,4,0,6,1,11
2/19/1975,12,0,2,2,16
2/20/1975,8,0,7,11,26
2/21/1975,9,0,10,1,20
2/22/1975,5,0,2,5,12
2/23/1975,8,0,3,4,15
2/24/1975,7,0,10,3,20
2/25/1975,12,0,2,4,18
2/26/1975,5,0,4,6,15
2/27/1975,10,0,3,4,17
2/28/1975,7,0,5,6,18
3/1/1975,7,0,6,3,16
3/2/1975,8,0,8,6,22
3/3/1975,11,0,9,5,25
3/4/1975,10,0,3,9,22
3/5/1975,6,0,10,4,20
3/6/1975,10,0,4,3,17
3/7/1975,9,0,3,7,19
3/8/1975,5,0,2,7,14
3/9/1975,9,0,10,3,22
3/10/1975,10,0,8,9,27
3/11/1975,7,0,2,11,20
3/12/1975,7,0,10,9,26
3/13/1975,4,0,10,1,15
3/14/1975,10,0,9,2,21
3/15/1975,11,0,9,1,21
3/16/1975,8,0,2,11,21
3/17/1975,7,0,10,5,22
3/18/1975,12,0,4,6,22
3/19/1975,12,0,8,5,25
3/20/1975,4,0,5,8,17
3/21/1975,7,0,6,7,20
3/22/1975,8,0,4,2,14
3/23/1975,6,0,8,3,17
3/24/1975,11,0,7,0,18
3/25/1975,11,0,6,1,18
3/26/1975,6,0,9,9,24
3/27/1975,9,0,6,9,24
3/28/1975,5,0,6,11,22
3/29/1975,5,0,8,10,23
3/30/1975,5,0,5,8,18
3/31/1975,5,0,3,6,14
4/1/1975,10,0,10,4,24
4/2/1975,5,0,9,3,17
4/3/1975,5,0,6,4,15
4/4/1975,5,0,7,2,14
4/5/1975,7,0,9,7,23
4/6/1975,4,0,5,3,12
4/7/1975,12,0,2,0,14
4/8/1975,7,0,6,0,13
4/9/1975,10,0,9,3,22
4/10/1975,7,0,8,5,20
4/11/1975,5,0,8,3,16
4/12/1975,10,0,10,9,29
4/13/1975,6,0,4,10,20
4/14/1975,12,0,4,4,20
4/15/1975,11,0,7,5,23
4/16/1975,6,0,9,6,21
4/17/1975,10,0,4,7,21
4/18/1975,8,0,3,0,11
4/19/1975,12,0,3,9,24
4/20/1975,7,0,6,9,22
4/21/1975,9,0,6,4,19
4/22/1975,7,0,10,0,17
4/23/1975,6,0,10,10,26
4/24/1975,4,0,7,2,13
4/25/1975,9,0,2,1,12
4/26/1975,8,0,10,10,28
4/27/1975,6,0,8,8,22
4/28/1975,12,0,10,8,30
4/29/1975,12,0,4,0,16
4/30/1975,9,0,10,11,30
5/1/1975,9,0,2,9,20
5/2/1975,5,0,3,6,14
5/3/1975,8,0,2,6,16
5/4/1975,5,0,2,11,18
5/5/1975,9,0,8,5,22
5/6/1975,8,0,5,2,15
5/7/1975,8,0,8,3,19
5/8/1975,9,0,5,7,21
5/9/1975,10,0,8,0,18
5/10/1975,6,0,8,3,17
5/11/1975,6,0,6,9,21
5/12/1975,10,0,7,5,22
5/13/1975,8,0,2,11,21
5/14/1975,5,0,9,5,19
5/15/1975,5,0,2,9,16
5/16/1975,5,0,4,8,17
5/17/1975,11,0,4,2,17
5/18/1975,9,0,2,0,11
5/19/1975,9,0,2,6,17
5/20/1975,10,0,3,6,19
5/21/1975,9,0,2,0,11
5/22/1975,8,0,7,5,20
5/23/1975,12,0,5,6,23
5/24/1975,4,0,2,11,17
5/25/1975,4,0,2,11,17
5/26/1975,11,0,5,6,22
5/27/1975,7,0,9,9,25
5/28/1975,11,0,8,9,28
5/29/1975,5,0,9,7,21
5/30/1975,11,0,7,4,22
5/31/1975,7,0,9,6,22
6/1/1975,12,0,4,7,23
6/2/1975,8,0,5,8,21
6/3/1975,7,0,8,8,23
6/4/1975,6,0,10,9,25
6/5/1975,10,0,6,7,23
6/6/1975,5,0,4,0,9
6/7/1975,7,0,9,3,19
6/8/1975,4,0,3,0,7
6/9/1975,10,0,4,6,20
6/10/1975,7,0,4,0,11
6/11/1975,9,0,10,7,26
6/12/1975,9,0,5,1,15
6/13/1975,9,0,4,5,18
6/14/1975,9,0,8,1,18
6/15/1975,9,0,8,4,21
6/16/1975,12,0,8,6,26
6/17/1975,10,0,7,11,28
6/18/1975,12,0,9,10,31
6/19/1975,11,0,2,11,24
6/20/1975,4,0,2,6,12
6/21/1975,7,0,5,10,22
6/22/1975,12,0,8,2,22
6/23/1975,12,0,5,0,17
6/24/1975,5,0,7,0,12
6/25/1975,4,0,2,9,15
6/26/1975,11,0,4,6,21
6/27/1975,5,0,10,11,26
6/28/1975,10,0,6,7,23
6/29/1975,7,0,7,5,19
6/30/1975,12,0,8,10,30
7/1/1975,4,0,10,8,22
7/2/1975,10,0,7,1,18
7/3/1975,7,0,7,5,19
7/4/1975,9,0,4,4,17
7/5/1975,4,0,3,11,18
7/6/1975,11,0,6,6,23
7/7/1975,8,0,4,6,18
7/8/1975,10,0,5,8,23
7/9/1975,8,0,9,7,24
7/10/1975,9,0,5,11,25
7/11/1975,10,0,7,8,25
7/12/1975,9,0,10,7,26
7/13/1975,6,0,10,7,23
7/14/1975,12,0,3,7,22
7/15/1975,8,0,2,4,14
7/16/1975,8,0,2,11,21
7/17/1975,6,0,5,7,18
7/18/1975,8,0,6,1,15
7/19/1975,12,0,9,3,24
7/20/1975,5,0,3,10,18
7/21/1975,9,0,10,6,25
7/22/1975,12,0,9,5,26
7/23/1975,10,0,4,0,14
7/24/1975,9,0,5,2,16
7/25/1975,5,0,9,1,15
7/26/1975,12,0,7,11,30
7/27/1975,8,0,3,3,14
7/28/1975,6,0,4,7,17
7/29/1975,6,0,5,0,11
7/30/1975,4,0,6,9,19
7/31/1975,9,0,8,7,24
8/1/1975,4,0,6,11,21
8/2/1975,10,0,4,1,15
8/3/1975,4,0,9,11,24
8/4/1975,4,0,2,4,10
8/5/1975,8,0,5,9,22
8/6/1975,6,0,2,4,12
8/7/1975,8,0,8,8,24
8/8/1975,11,0,8,10,29
8/9/1975,12,0,7,9,28
8/10/1975,12,0,5,0,17
8/11/1975,11,0,3,1,15
8/12/1975,7,0,8,9,24
8/13/1975,4,0,6,4,14
8/14/1975,6,0,3,4,13
8/15/1975,4,0,7,0,11
8/16/1975,11,0,2,3,16
8/17/1975,11,0,8,4,23
8/18/1975,12,0,4,8,24
8/19/1975,7,0,6,9,22
8/20/1975,6,0,4,7,17
8/21/1975,4,0,10,2,16
8/22/1975,12,0,6,9,27
8/23/1975,5,0,9,2,16
8/24/1975,4,0,6,11,21
8/25/1975,7,0,8,6,21
8/26/1975,9,0,2,1,12
8/27/1975,6,0,4,9,19
8/28/1975,4,0,9,0,13
8/29/1975,10,0,5,3,18
8/30/1975,6,0,2,11,19
8/31/1975,5,0,5,9,19
9/1/1975,6,0,7,2,15
9/2/1975,7,0,8,5,20
9/3/1975,8,0,5,4,17
9/4/1975,4,0,6,3,13
9/5/1975,5,0,10,6,21
9/6/1975,9,0,9,3,21
9/7/1975,5,0,10,10,25
9/8/1975,7,0,2,5,14
9/9/1975,10,0,6,6,22
9/10/1975,8,0,5,2,15
9/11/1975,4,0,5,6,15
9/12/1975,11,0,9,8,28
9/13/1975,11,0,7,6,24
9/14/1975,10,0,6,8,24
9/15/1975,10,0,5,7,22
9/16/1975,4,0,10,0,14
9/17/1975,9,0,5,4,18
9/18/1975,11,0,8,8,27
9/19/1975,12,0,3,1,16
9/20/1975,7,0,2,5,14
9/21/1975,11,0,7,0,18
9/22/1975,5,0,8,6,19
9/23/1975,7,0,8,6,21
9/24/1975,6,0,5,9,20
9/25/1975,10,0,7,0,17
9/26/1975,11,0,9,6,26
9/27/1975,8,0,4,8,20
9/28/1975,9,0,10,7,26
9/29/1975,7,0,10,7,24
9/30/1975,7,0,3,8,18
10/1/1975,11,0,6,8,25
10/2/1975,5,0,2,6,13
10/3/1975,5,0,9,7,21
10/4/1975,8,0,2,3,13
10/5/1975,10,0,9,0,19
10/6/1975,9,0,2,7,18
10/7/1975,4,0,2,3,9
10/8/1975,12,0,7,8,27
10/9/1975,5,0,2,2,9
10/10/1975,6,0,10,8,24
10/11/1975,11,0,6,9,26
10/12/1975,4,0,9,9,22
10/13/1975,7,0,4,11,22
10/14/1975,11,0,2,3,16
10/15/1975,6,0,8,4,18
10/16/1975,8,0,7,5,20
10/17/1975,8,0,8,0,16
10/18/1975,7,0,5,10,22
10/19/1975,12,0,3,2,17
10/20/1975,5,0,7,10,22
10/21/1975,5,0,8,0,13
10/22/1975,10,0,8,11,29
10/23/1975,6,0,10,11,27
10/24/1975,11,0,6,8,25
10/25/1975,9,0,9,1,19
10/26/1975,11,0,5,11,27
10/27/1975,5,0,10,1,16
10/28/1975,12,0,4,8,24
10/29/1975,12,0,9,2,23
10/30/1975,4,0,6,10,20
10/31/1975,12,0,10,4,26
11/1/1975,6,0,2,0,8
11/2/1975,12,0,6,10,28
11/3/1975,8,0,5,3,16
11/4/1975,11,0,8,6,25
11/5/1975,8,0,8,0,16
11/6/1975,7,0,5,10,22
11/7/1975,11,0,7,4,22
11/8/1975,11,0,7,2,20
11/9/1975,12,0,5,1,18
11/10/1975,7,0,4,10,21
11/11/1975,4,0,3,7,14
11/12/1975,4,0,3,3,10
11/13/1975,6,0,10,9,25
11/14/1975,8,0,8,8,24
11/15/1975,5,0,4,2,11
11/16/1975,10,0,8,9,27
11/17/1975,4,0,3,2,9
11/18/1975,9,0,5,0,14
11/19/1975,11,0,4,11,26
11/20/1975,8,0,5,2,15
11/21/1975,8,0,5,7,20
11/22/1975,6,0,10,4,20
11/23/1975,8,0,5,5,18
11/24/1975,6,0,5,3,14
11/25/1975,5,0,6,8,19
11/26/1975,7,0,5,8,20
11/27/1975,5,0,4,8,17
11/28/1975,6,0,6,0,12
11/29/1975,12,0,7,5,24
11/30/1975,7,0,7,4,18
12/1/1975,8,0,5,1,14
12/2/1975,5,0,3,0,8
12/3/1975,7,0,2,2,11
12/4/1975,4,0,2,1,7
12/5/1975,7,0,7,5,19
12/6/1975,12,0,4,6,22
12/7/1975,10,0,3,5,18
12/8/1975,7,0,6,2,15
12/9/1975,6,0,5,2,13
12/10/1975,6,0,4,7,17
12/11/1975,4,0,2,10,16
12/12/1975,10,0,5,4,19
12/13/1975,6,0,2,6,14
12/14/1975,5,0,4,11,20
12/15/1975,12,0,2,3,17
12/16/1975,12,0,8,3,23
12/17/1975,7,0,6,0,13
12/18/1975,6,0,4,7,17
12/19/1975,7,0,3,3,13
12/20/1975,6,0,8,1,15
12/21/1975,5,0,7,9,21
12/22/1975,9,0,6,8,23
12/23/1975,6,0,4,1,11
12/24/1975,6,0,7,8,21
12/25/1975,11,0,2,0,13
12/26/1975,6,0,5,2,13
12/27/1975,5,0,6,2,13
12/28/1975,6,0,7,8,21
12/29/1975,7,0,2,9,18
12/30/1975,12,0,10,7,29
12/31/1975,6,0,5,0,11
1/1/1976,4,0,4,6,14
1/2/1976,6,0,2,11,19
1/3/1976,11,0,2,7,20
1/4/1976,11,0,4,4,19
1/5/1976,6,0,5,8,19
1/6/1976,9,0,3,1,13
1/7/1976,9,0,5,6,20
1/8/1976,4,0,5,2,11
1/9/1976,7,0,7,10,24
1/10/1976,6,0,6,6,18
1/11/1976,5,0,3,10,18
1/12/1976,5,0,6,7,18
1/13/1976,5,0,5,8,18
1/14/1976,9,0,4,7,20
1/15/1976,4,0,6,11,21
1/16/1976,11,0,3,6,20
1/17/1976,9,0,9,5,23
1/18/1976,8,0,10,1,19
1/19/1976,4,0,5,7,16
1/20/1976,10,0,10,1,21
1/21/1976,4,0,10,9,23
1/22/1976,5,0,5,3,13
1/23/1976,9,0,6,6,21
1/24/1976,4,0,7,5,16
1/25/1976,6,0,3,7,16
1/26/1976,6,0,6,2,14
1/27/1976,10,0,3,0,13
1/28/1976,9,0,2,5,16
1/29/1976,7,0,6,11,24
1/30/1976,7,0,10,1,18
1/31/1976,8,0,9,1,18
2/1/1976,12,0,2,0,14
2/2/1976,5,0,3,4,12
2/3/1976,12,0,9,9,30
2/4/1976,8,0,10,4,22
2/5/1976,10,0,2,10,22
2/6/1976,10,0,10,6,26
2/7/1976,10,0,8,6,24
2/8/1976,6,0,6,10,22
2/9/1976,4,0,2,5,11
2/10/1976,9,0,3,6,18
2/11/1976,5,0,5,5,15
2/12/1976,6,0,10,6,22
2/13/1976,5,0,10,8,23
2/14/1976,9,0,5,3,17
2/15/1976,8,0,5,11,24
2/16/1976,10,0,4,10,24
2/17/1976,4,0,7,10,21
2/18/1976,12,0,6,10,28
2/19/1976,5,0,9,5,19
2/20/1976,10,0,6,0,16
2/21/1976,5,0,5,3,13
2/22/1976,7,0,4,4,15
2/23/1976,4,0,6,11,21
2/24/1976,12,0,4,3,19
2/25/1976,12,0,8,11,31
2/26/1976,8,0,9,11,28
2/27/1976,12,0,3,9,24
2/28/1976,10,0,5,3,18
2/29/1976,5,0,10,7,22
3/1/1976,10,0,10,1,21
3/2/1976,9,0,8,0,17
3/3/1976,12,0,5,10,27
3/4/1976,12,0,9,10,31
3/5/1976,4,0,4,6,14
3/6/1976,11,0,4,3,18
3/7/1976,8,0,6,11,25
3/8/1976,7,0,10,1,18
3/9/1976,10,0,2,6,18
3/10/1976,9,0,7,7,23
3/11/1976,8,0,2,6,16
3/12/1976,6,0,9,11,26
3/13/1976,8,0,9,0,17
3/14/1976,7,0,2,5,14
3/15/1976,5,0,4,6,15
3/16/1976,10,0,7,0,17
3/17/1976,10,0,2,8,20
3/18/1976,7,0,7,7,21
3/19/1976,5,0,7,0,12
3/20/1976,7,0,2,8,17
3/21/1976,4,0,6,9,19
3/22/1976,4,0,5,9,18
3/23/1976,12,0,4,6,22
3/24/1976,12,0,9,2,23
3/25/1976,6,0,2,8,16
3/26/1976,12,0,7,4,23
3/27/1976,10,0,6,5,21
3/28/1976,6,0,7,1,14
3/29/1976,8,0,6,10,24
3/30/1976,4,0,2,10,16
3/31/1976,5,0,4,2,11
4/1/1976,4,0,2,10,16
4/2/1976,9,0,2,3,14
4/3/1976,10,0,3,3,16
4/4/1976,8,0,6,11,25
4/5/1976,8,0,2,8,18
4/6/1976,8,0,7,10,25
4/7/1976,7,0,8,4,19
4/8/1976,8,0,8,2,18
4/9/1976,10,0,5,3,18
4/10/1976,6,0,10,3,19
4/11/1976,4,0,5,9,18
4/12/1976,12,0,3,9,24
4/13/1976,7,0,6,2,15
4/14/1976,10,0,6,0,16
4/15/1976,11,0,9,10,30
4/16/1976,10,0,4,5,19
4/17/1976,6,0,5,4,15
4/18/1976,12,0,2,10,24
4/19/1976,7,0,9,7,23
4/20/1976,10,0,9,11,30
4/21/1976,11,0,8,6,25
4/22/1976,7,0,4,2,13
4/23/1976,8,0,3,9,20
4/24/1976,7,0,2,10,19
4/25/1976,11,0,6,3,20
4/26/1976,8,0,7,9,24
4/27/1976,7,0,9,9,25
4/28/1976,6,0,8,11,25
4/29/1976,11,0,9,2,22
4/30/1976,7,0,10,2,19
5/1/1976,11,0,3,6,20
5/2/1976,12,0,10,3,25
5/3/1976,9,0,6,4,19
5/4/1976,4,0,8,10,22
5/5/1976,7,0,9,3,19
5/6/1976,10,0,2,11,23
5/7/1976,10,0,3,11,24
5/8/1976,11,0,9,9,29
5/9/1976,7,0,10,11,28
5/10/1976,10,0,7,10,27
5/11/1976,7,0,2,3,12
5/12/1976,8,0,9,0,17
5/13/1976,5,0,9,2,16
5/14/1976,10,0,7,8,25
5/15/1976,5,0,4,2,11
5/16/1976,5,0,8,5,18
5/17/1976,11,0,4,11,26
5/18/1976,5,0,6,1,12
5/19/1976,8,0,7,6,21
5/20/1976,10,0,4,8,22
5/21/1976,4,0,8,5,17
5/22/1976,12,0,10,0,22
5/23/1976,10,0,5,8,23
5/24/1976,7,0,7,4,18
5/25/1976,11,0,6,11,28
5/26/1976,12,0,6,4,22
5/27/1976,4,0,8,4,16
5/28/1976,8,0,10,6,24
5/29/1976,4,0,4,8,16
5/30/1976,6,0,9,3,18
5/31/1976,7,0,8,6,21
6/1/1976,8,0,7,5,20
6/2/1976,12,0,7,3,22
6/3/1976,5,0,10,9,24
6/4/1976,6,0,4,3,13
6/5/1976,7,0,8,9,24
6/6/1976,11,0,2,10,23
6/7/1976,5,0,2,2,9
6/8/1976,8,0,5,5,18
6/9/1976,4,0,8,2,14
6/10/1976,7,0,8,11,26
6/11/1976,9,0,8,2,19
6/12/1976,11,0,3,4,18
6/13/1976,10,0,5,5,20
6/14/1976,6,0,9,7,22
6/15/1976,9,0,4,8,21
6/16/1976,4,0,7,10,21
6/17/1976,7,0,7,8,22
6/18/1976,7,0,5,4,16
6/19/1976,4,0,2,9,15
6/20/1976,8,0,3,8,19
6/21/1976,4,0,4,2,10
6/22/1976,7,0,7,7,21
6/23/1976,8,0,3,5,16
6/24/1976,5,0,3,8,16
6/25/1976,6,0,8,5,19
6/26/1976,7,0,10,0,17
6/27/1976,4,0,4,7,15
6/28/1976,10,0,10,3,23
6/29/1976,8,0,5,0,13
6/30/1976,4,0,9,0,13
7/1/1976,8,0,8,10,26
7/2/1976,10,0,4,8,22
7/3/1976,9,0,3,6,18
7/4/1976,7,0,7,0,14
7/5/1976,11,0,7,2,20
7/6/1976,12,0,3,9,24
7/7/1976,5,0,8,2,15
7/8/1976,5,0,9,6,20
7/9/1976,10,0,4,8,22
7/10/1976,4,0,10,10,24
7/11/1976,6,0,9,4,19
7/12/1976,9,0,5,6,20
7/13/1976,11,0,10,1,22
7/14/1976,6,0,5,5,16
7/15/1976,7,0,7,10,24
7/16/1976,7,0,3,9,19
7/17/1976,9,0,4,10,23
7/18/1976,5,0,7,1,13
7/19/1976,11,0,3,0,14
7/20/1976,5,0,9,0,14
7/21/1976,6,0,8,11,25
7/22/1976,4,0,4,11,19
7/23/1976,9,0,2,4,15
7/24/1976,11,0,9,5,25
7/25/1976,10,0,8,9,27
7/26/1976,9,0,3,1,13
7/27/1976,4,0,7,4,15
7/28/1976,8,0,7,8,23
7/29/1976,12,0,5,0,17
7/30/1976,9,0,4,7,20
7/31/1976,4,0,2,5,11
8/1/1976,10,0,7,9,26
8/2/1976,8,0,4,4,16
8/3/1976,5,0,10,6,21
8/4/1976,4,0,8,1,13
8/5/1976,8,0,3,2,13
8/6/1976,10,0,9,0,19
8/7/1976,4,0,2,0,6
8/8/1976,10,0,5,10,25
8/9/1976,12,0,5,10,27
8/10/1976,10,0,2,4,16
8/11/1976,8,0,9,7,24
8/12/1976,4,0,9,8,21
8/13/1976,9,0,8,10,27
8/14/1976,4,0,5,4,13
8/15/1976,12,0,9,3,24
8/16/1976,10,0,9,4,23
8/17/1976,12,0,7,7,26
8/18/1976,8,0,4,4,16
8/19/1976,4,0,8,5,17
8/20/1976,11,0,4,6,21
8/21/1976,8,0,2,0,10
8/22/1976,4,0,8,1,13
8/23/1976,8,0,10,9,27
8/24/1976,12,0,2,6,20
8/25/1976,8,0,5,6,19
8/26/1976,5,0,9,3,17
8/27/1976,8,0,5,11,24
8/28/1976,4,0,6,9,19
8/29/1976,7,0,5,3,15
8/30/1976,12,0,7,11,30
8/31/1976,4,0,6,1,11
9/1/1976,9,0,7,11,27
9/2/1976,7,0,5,0,12
9/3/1976,6,0,10,11,27
9/4/1976,10,0,4,0,14
9/5/1976,12,0,10,2,24
9/6/1976,4,0,10,7,21
9/7/1976,7,0,9,4,20
9/8/1976,8,0,8,10,26
9/9/1976,6,0,2,9,17
9/10/1976,7,0,2,2,11
9/11/1976,12,0,7,1,20
9/12/1976,12,0,4,1,17
9/13/1976,9,0,5,2,16
9/14/1976,6,0,4,3,13
9/15/1976,6,0,6,6,18
9/16/1976,10,0,8,5,23
9/17/1976,7,0,8,2,17
9/18/1976,4,0,6,10,20
9/19/1976,8,0,4,7,19
9/20/1976,11,0,7,2,20
9/21/1976,6,0,2,11,19
9/22/1976,8,0,7,9,24
9/23/1976,9,0,2,1,12
9/24/1976,9,0,4,5,18
9/25/1976,12,0,2,4,18
9/26/1976,9,0,10,8,27
9/27/1976,6,0,4,11,21
9/28/1976,12,0,10,5,27
9/29/1976,4,0,5,2,11
9/30/1976,7,0,3,7,17
10/1/1976,6,0,9,11,26
10/2/1976,9,0,5,5,19
10/3/1976,7,0,8,11,26
10/4/1976,6,0,2,2,10
10/5/1976,12,0,2,0,14
10/6/1976,10,0,8,7,25
10/7/1976,7,0,2,4,13
10/8/1976,12,0,3,6,21
10/9/1976,5,0,10,6,21
10/10/1976,10,0,7,10,27
10/11/1976,8,0,6,9,23
10/12/1976,6,0,7,0,13
10/13/1976,9,0,3,0,12
10/14/1976,10,0,6,11,27
10/15/1976,12,0,6,10,28
10/16/1976,11,0,7,0,18
10/17/1976,11,0,2,0,13
10/18/1976,4,0,4,11,19
10/19/1976,10,0,10,2,22
10/20/1976,5,0,6,8,19
10/21/1976,7,0,5,4,16
10/22/1976,11,0,3,10,24
10/23/1976,4,0,9,3,16
10/24/1976,7,0,2,7,16
10/25/1976,8,0,10,10,28
10/26/1976,6,0,5,6,17
10/27/1976,9,0,10,1,20
10/28/1976,10,0,9,6,25
10/29/1976,7,0,4,9,20
10/30/1976,11,0,10,3,24
10/31/1976,5,0,8,11,24
11/1/1976,10,0,5,4,19
11/2/1976,8,0,9,10,27
11/3/1976,10,0,8,10,28
11/4/1976,11,0,3,6,20
11/5/1976,4,0,4,7,15
11/6/1976,7,0,3,1,11
11/7/1976,12,0,10,11,33
11/8/1976,4,0,4,5,13
11/9/1976,9,0,4,8,21
11/10/1976,12,0,8,4,24
11/11/1976,7,0,2,9,18
11/12/1976,12,0,7,10,29
11/13/1976,5,0,6,4,15
11/14/1976,5,0,3,11,19
11/15/1976,8,0,3,6,17
11/16/1976,7,0,2,0,9
11/17/1976,11,0,3,9,23
11/18/1976,10,0,7,8,25
11/19/1976,6,0,9,0,15
11/20/1976,9,0,3,11,23
11/21/1976,5,0,6,1,12
11/22/1976,5,0,8,6,19
11/23/1976,4,0,5,10,19
11/24/1976,4,0,7,4,15
11/25/1976,9,0,2,4,15
11/26/1976,12,0,5,10,27
11/27/1976,7,0,6,6,19
11/28/1976,10,0,4,9,23
11/29/1976,7,0,5,6,18
11/30/1976,10,0,2,9,21
12/1/1976,7,0,2,1,10
12/2/1976,8,0,3,2,13
12/3/1976,5,0,2,5,12
12/4/1976,9,0,8,1,18
12/5/1976,9,0,7,6,22
12/6/1976,5,0,5,5,15
12/7/1976,12,0,8,6,26
12/8/1976,6,0,3,11,20
12/9/1976,5,0,8,10,23
12/10/1976,7,0,3,4,14
12/11/1976,9,0,3,6,18
12/12/1976,7,0,10,1,18
12/13/1976,6,0,2,0,8
12/14/1976,10,0,5,3,18
12/15/1976,10,0,4,10,24
12/16/1976,6,0,10,7,23
12/17/1976,8,0,3,7,18
12/18/1976,8,0,8,2,18
12/19/1976,12,0,7,8,27
12/20/1976,5,0,4,11,20
12/21/1976,8,0,8,1,17
12/22/1976,10,0,9,5,24
12/23/1976,5,0,9,4,18
12/24/1976,10,0,7,7,24
12/25/1976,8,0,6,4,18
12/26/1976,7,0,3,6,16
12/27/1976,7,0,7,7,21
12/28/1976,11,0,4,8,23
12/29/1976,11,0,5,8,24
12/30/1976,8,0,2,11,21
12/31/1976,9,0,9,4,22
1/1/1977,12,0,10,11,33
1/2/1977,5,0,10,3,18
1/3/1977,5,0,10,6,21
1/4/1977,6,0,9,1,16
1/5/1977,7,0,3,6,16
1/6/1977,11,0,4,7,22
1/7/1977,10,0,10,2,22
1/8/1977,4,0,7,5,16
1/9/1977,4,0,9,9,22
1/10/1977,5,0,9,4,18
1/11/1977,7,0,2,2,11
1/12/1977,5,0,4,1,10
1/13/1977,12,0,6,0,18
1/14/1977,6,0,10,11,27
1/15/1977,10,0,5,11,26
1/16/1977,11,0,2,8,21
1/17/1977,6,0,9,11,26
1/18/1977,11,0,8,5,24
1/19/1977,5,0,9,0,14
1/20/1977,7,0,4,8,19
1/21/1977,12,0,2,9,23
1/22/1977,7,0,4,6,17
1/23/1977,10,0,10,2,22
1/24/1977,8,0,5,6,19
1/25/1977,12,0,5,2,19
1/26/1977,6,0,6,9,21
1/27/1977,9,0,7,0,16
1/28/1977,7,0,10,0,17
1/29/1977,12,0,6,4,22
1/30/1977,5,0,4,11,20
1/31/1977,8,0,10,8,26
2/1/1977,4,0,10,0,14
2/2/1977,8,0,3,7,18
2/3/1977,11,0,5,1,17
2/4/1977,10,0,2,7,19
2/5/1977,8,0,9,9,26
2/6/1977,8,0,8,5,21
2/7/1977,9,0,4,5,18
2/8/1977,12,0,10,7,29
2/9/1977,6,0,3,1,10
2/10/1977,5,0,6,5,16
2/11/1977,8,0,4,5,17
2/12/1977,7,0,10,8,25
2/13/1977,4,0,5,6,15
2/14/1977,5,0,4,5,14
2/15/1977,11,0,10,9,30
2/16/1977,5,0,7,7,19
2/17/1977,10,0,2,8,20
2/18/1977,10,0,4,7,21
2/19/1977,8,0,5,4,17
2/20/1977,9,0,4,7,20
2/21/1977,11,0,8,8,27
2/22/1977,6,0,4,5,15
2/23/1977,11,0,9,3,23
2/24/1977,9,0,7,2,18
2/25/1977,4,0,10,4,18
2/26/1977,8,0,3,5,16
2/27/1977,8,0,9,2,19
2/28/1977,9,0,2,8,19
3/1/1977,11,0,8,5,24
3/2/1977,8,0,8,0,16
3/3/1977,5,0,10,6,21
3/4/1977,8,0,5,2,15
3/5/1977,11,0,5,4,20
3/6/1977,6,0,10,9,25
3/7/1977,6,0,5,4,15
3/8/1977,5,0,4,11,20
3/9/1977,4,0,8,11,23
3/10/1977,8,0,8,0,16
3/11/1977,12,0,2,1,15
3/12/1977,12,0,3,10,25
3/13/1977,8,0,3,5,16
3/14/1977,10,0,4,9,23
3/15/1977,7,0,8,1,16
3/16/1977,11,0,9,7,27
3/17/1977,7,0,7,7,21
3/18/1977,4,0,4,7,15
3/19/1977,6,0,6,11,23
3/20/1977,7,0,7,4,18
3/21/1977,12,0,10,5,27
3/22/1977,7,0,5,0,12
3/23/1977,11,0,8,4,23
3/24/1977,8,0,4,5,17
3/25/1977,6,0,2,3,11
3/26/1977,4,0,6,7,17
3/27/1977,8,0,10,0,18
3/28/1977,11,0,2,10,23
3/29/1977,12,0,10,5,27
3/30/1977,7,0,7,2,16
3/31/1977,10,0,4,11,25
4/1/1977,7,0,2,11,20
4/2/1977,12,0,8,5,25
4/3/1977,12,0,9,4,25
4/4/1977,11,0,2,11,24
4/5/1977,4,0,9,3,16
4/6/1977,11,0,5,11,27
4/7/1977,12,0,5,10,27
4/8/1977,11,0,5,6,22
4/9/1977,11,0,10,3,24
4/10/1977,7,0,10,9,26
4/11/1977,4,0,9,0,13
4/12/1977,10,0,8,3,21
4/13/1977,8,0,8,8,24
4/14/1977,7,0,6,11,24
4/15/1977,8,0,7,5,20
4/16/1977,9,0,3,0,12
4/17/1977,5,0,2,0,7
4/18/1977,12,0,4,0,16
4/19/1977,10,0,9,2,21
4/20/1977,10,0,5,1,16
4/21/1977,10,0,10,0,20
4/22/1977,12,0,7,7,26
4/23/1977,12,0,2,0,14
4/24/1977,12,0,7,3,22
4/25/1977,8,0,9,1,18
4/26/1977,11,0,5,7,23
4/27/1977,9,0,9,10,28
4/28/1977,6,0,6,8,20
4/29/1977,10,0,7,7,24
4/30/1977,7,0,6,3,16
5/1/1977,11,0,8,1,20
5/2/1977,7,0,4,6,17
5/3/1977,12,0,2,9,23
5/4/1977,12,0,5,0,17
5/5/1977,8,0,3,2,13
5/6/1977,6,0,10,5,21
5/7/1977,8,0,7,5,20
5/8/1977,9,0,6,10,25
5/9/1977,8,0,5,2,15
5/10/1977,8,0,3,7,18
5/11/1977,11,0,8,10,29
5/12/1977,5,0,10,7,22
5/13/1977,8,0,8,9,25
5/14/1977,11,0,8,10,29
5/15/1977,9,0,7,8,24
5/16/1977,4,0,10,7,21
5/17/1977,10,0,8,10,28
5/18/1977,6,0,2,11,19
5/19/1977,10,0,9,9,28
5/20/1977,11,0,8,11,30
5/21/1977,9,0,2,2,13
5/22/1977,10,0,5,11,26
5/23/1977,8,0,8,10,26
5/24/1977,6,0,6,9,21
5/25/1977,9,0,6,10,25
5/26/1977,8,0,3,6,17
5/27/1977,5,0,3,4,12
5/28/1977,6,0,10,3,19
5/29/1977,4,0,7,6,17
5/30/1977,4,0,2,0,6
5/31/1977,8,0,9,5,22
6/1/1977,7,0,8,5,20
6/2/1977,6,0,5,6,17
6/3/1977,5,0,8,6,19
6/4/1977,10,0,9,7,26
6/5/1977,7,0,8,11,26
6/6/1977,11,0,5,7,23
6/7/1977,12,0,7,8,27
6/8/1977,7,0,2,10,19
6/9/1977,12,0,8,6,26
6/10/1977,7,0,7,9,23
6/11/1977,8,0,6,7,21
6/12/1977,10,0,4,3,17
6/13/1977,9,0,3,9,21
6/14/1977,9,0,3,11,23
6/15/1977,12,0,10,3,25
6/16/1977,6,0,6,0,12
6/17/1977,6,0,4,5,15
6/18/1977,4,0,7,1,12
6/19/1977,11,0,4,7,22
6/20/1977,6,0,5,0,11
6/21/1977,11,0,3,11,25
6/22/1977,5,0,3,6,14
6/23/1977,5,0,8,0,13
6/24/1977,6,0,9,9,24
6/25/1977,5,0,5,7,17
6/26/1977,10,0,9,0,19
6/27/1977,12,0,8,5,25
6/28/1977,8,0,3,2,13
6/29/1977,5,0,6,7,18
6/30/1977,12,0,5,10,27
7/1/1977,7,0,8,5,20
7/2/1977,5,0,2,8,15
7/3/1977,9,0,9,5,23
7/4/1977,8,0,10,9,27
7/5/1977,4,0,9,5,18
7/6/1977,8,0,2,9,19
7/7/1977,11,0,4,4,19
7/8/1977,5,0,4,4,13
7/9/1977,11,0,5,2,18
7/10/1977,11,0,5,4,20
7/11/1977,12,0,10,10,32
7/12/1977,11,0,4,8,23
7/13/1977,11,0,6,9,26
7/14/1977,8,0,7,9,24
7/15/1977,6,0,4,1,11
7/16/1977,9,0,4,6,19
7/17/1977,6,0,6,11,23
7/18/1977,6,0,3,1,10
7/19/1977,11,0,7,0,18
7/20/1977,6,0,2,2,10
7/21/1977,8,0,3,8,19
7/22/1977,9,0,6,8,23
7/23/1977,8,0,6,4,18
7/24/1977,10,0,4,0,14
7/25/1977,9,0,3,8,20
7/26/1977,6,0,2,9,17
7/27/1977,4,0,9,3,16
7/28/1977,10,0,4,2,16
7/29/1977,8,0,6,6,20
7/30/1977,8,0,5,2,15
7/31/1977,9,0,10,3,22
8/1/1977,8,0,9,8,25
8/2/1977,5,0,6,11,22
8/3/1977,8,0,8,2,18
8/4/1977,10,0,5,5,20
8/5/1977,7,0,2,6,15
8/6/1977,9,0,2,10,21
8/7/1977,11,0,4,1,16
8/8/1977,10,0,6,9,25
8/9/1977,10,0,5,9,24
8/10/1977,10,0,9,5,24
8/11/1977,5,0,6,0,11
8/12/1977,8,0,4,7,19
8/13/1977,11,0,9,10,30
8/14/1977,8,0,5,8,21
8/15/1977,4,0,9,4,17
8/16/1977,4,0,8,10,22
8/17/1977,7,0,6,7,20
8/18/1977,12,0,10,11,33
8/19/1977,11,0,3,4,18
8/20/1977,7,0,2,7,16
8/21/1977,11,0,7,10,28
8/22/1977,7,0,8,8,23
8/23/1977,9,0,6,8,23
8/24/1977,7,0,3,6,16
8/25/1977,5,0,10,5,20
8/26/1977,11,0,5,9,25
8/27/1977,12,0,2,4,18
8/28/1977,12,0,3,7,22
8/29/1977,7,0,7,4,18
8/30/1977,9,0,6,6,21
8/31/1977,12,0,9,4,25
9/1/1977,8,0,10,9,27
9/2/1977,6,0,2,10,18
9/3/1977,9,0,6,10,25
9/4/1977,9,0,10,1,20
9/5/1977,7,0,6,10,23
9/6/1977,10,0,7,9,26
9/7/1977,9,0,7,10,26
9/8/1977,5,0,4,9,18
9/9/1977,9,0,6,5,20
9/10/1977,8,0,7,8,23
9/11/1977,12,0,9,4,25
9/12/1977,4,0,4,4,12
9/13/1977,9,0,8,2,19
9/14/1977,10,0,9,2,21
9/15/1977,10,0,5,3,18
9/16/1977,9,0,6,1,16
9/17/1977,9,0,5,3,17
9/18/1977,8,0,10,0,18
9/19/1977,10,0,4,4,18
9/20/1977,4,0,9,10,23
9/21/1977,10,0,6,3,19
9/22/1977,10,0,5,6,21
9/23/1977,9,0,5,11,25
9/24/1977,5,0,4,8,17
9/25/1977,7,0,4,8,19
9/26/1977,10,0,10,2,22
9/27/1977,11,0,5,5,21
9/28/1977,7,0,6,7,20
9/29/1977,9,0,3,7,19
9/30/1977,5,0,5,2,12
10/1/1977,7,0,4,7,18
10/2/1977,12,0,10,2,24
10/3/1977,11,0,10,8,29
10/4/1977,4,0,9,5,18
10/5/1977,10,0,6,1,17
10/6/1977,7,0,2,3,12
10/7/1977,5,0,6,1,12
10/8/1977,10,0,3,5,18
10/9/1977,5,0,3,9,17
10/10/1977,5,0,3,5,13
10/11/1977,10,0,7,1,18
10/12/1977,11,0,8,9,28
10/13/1977,6,0,6,0,12
10/14/1977,10,0,9,10,29
10/15/1977,10,0,5,10,25
10/16/1977,6,0,10,11,27
10/17/1977,4,0,3,7,14
10/18/1977,4,0,3,1,8
10/19/1977,9,0,4,5,18
10/20/1977,8,0,5,1,14
10/21/1977,4,0,5,8,17
10/22/1977,11,0,7,8,26
10/23/1977,7,0,2,6,15
10/24/1977,9,0,3,0,12
10/25/1977,7,0,8,6,21
10/26/1977,4,0,7,4,15
10/27/1977,6,0,5,5,16
10/28/1977,5,0,10,4,19
10/29/1977,9,0,4,4,17
10/30/1977,9,0,4,1,14
10/31/1977,10,0,7,8,25
11/1/1977,8,0,6,9,23
11/2/1977,12,0,9,10,31
11/3/1977,5,0,2,1,8
11/4/1977,5,0,4,10,19
11/5/1977,5,0,3,9,17
11/6/1977,11,0,8,11,30
11/7/1977,4,0,9,9,22
11/8/1977,4,0,9,4,17
11/9/1977,10,0,5,10,25
11/10/1977,7,0,3,9,19
11/11/1977,12,0,9,8,29
11/12/1977,9,0,10,8,27
11/13/1977,5,0,10,2,17
11/14/1977,10,0,9,3,22
11/15/1977,12,0,3,2,17
11/16/1977,7,0,2,0,9
11/17/1977,4,0,5,8,17
11/18/1977,12,0,6,1,19
11/19/1977,5,0,10,2,17
11/20/1977,11,0,7,3,21
11/21/1977,7,0,10,1,18
11/22/1977,4,0,8,5,17
11/23/1977,10,0,2,8,20
11/24/1977,9,0,6,0,15
11/25/1977,11,0,6,0,17
11/26/1977,11,0,4,3,18
11/27/1977,4,0,7,8,19
11/28/1977,10,0,3,6,19
11/29/1977,9,0,9,7,25
11/30/1977,11,0,2,11,24
12/1/1977,11,0,4,10,25
12/2/1977,6,0,3,11,20
12/3/1977,9,0,8,8,25
12/4/1977,5,0,3,8,16
12/5/1977,6,0,8,1,15
12/6/1977,8,0,5,5,18
12/7/1977,7,0,9,2,18
12/8/1977,11,0,4,6,21
12/9/1977,6,0,10,3,19
12/10/1977,9,0,10,5,24
12/11/1977,7,0,2,6,15
12/12/1977,5,0,4,7,16
12/13/1977,6,0,5,9,20
12/14/1977,11,0,9,11,31
12/15/1977,9,0,2,2,13
12/16/1977,5,0,4,3,12
12/17/1977,6,0,2,4,12
12/18/1977,10,0,5,4,19
12/19/1977,5,0,3,1,9
12/20/1977,7,0,8,7,22
12/21/1977,5,0,9,0,14
12/22/1977,7,0,8,7,22
12/23/1977,6,0,9,9,24
12/24/1977,4,0,9,6,19
12/25/1977,4,0,9,2,15
12/26/1977,4,0,8,10,22
12/27/1977,12,0,10,3,25
12/28/1977,8,0,10,9,27
12/29/1977,10,0,5,1,16
12/30/1977,8,0,6,7,21
12/31/1977,7,0,7,11,25
1/1/1978,5,0,2,7,14
1/2/1978,5,0,7,3,15
1/3/1978,6,0,6,3,15
1/4/1978,8,0,9,10,27
1/5/1978,9,0,5,9,23
1/6/1978,6,0,3,9,18
1/7/1978,9,0,4,3,16
1/8/1978,9,0,7,11,27
1/9/1978,6,0,3,10,19
1/10/1978,11,0,3,6,20
1/11/1978,7,0,7,0,14
1/12/1978,6,0,10,1,17
1/13/1978,9,0,2,9,20
1/14/1978,4,0,2,10,16
1/15/1978,7,0,6,7,20
1/16/1978,7,0,7,1,15
1/17/1978,9,0,2,1,12
1/18/1978,6,0,6,4,16
1/19/1978,5,0,3,4,12
1/20/1978,11,0,4,11,26
1/21/1978,11,0,8,11,30
1/22/1978,9,0,8,6,23
1/23/1978,10,0,3,10,23
1/24/1978,11,0,5,3,19
1/25/1978,4,0,3,0,7
1/26/1978,5,0,7,9,21
1/27/1978,12,0,2,0,14
1/28/1978,6,0,10,11,27
1/29/1978,4,0,10,11,25
1/30/1978,5,0,6,2,13
1/31/1978,9,0,7,4,20
2/1/1978,12,0,7,11,30
2/2/1978,4,0,5,3,12
2/3/1978,11,0,7,7,25
2/4/1978,7,0,8,2,17
2/5/1978,5,0,10,1,16
2/6/1978,9,0,8,8,25
2/7/1978,6,0,8,7,21
2/8/1978,5,0,10,3,18
2/9/1978,4,0,6,11,21
2/10/1978,10,0,3,5,18
2/11/1978,6,0,9,11,26
2/12/1978,9,0,3,3,15
2/13/1978,4,0,6,3,13
2/14/1978,4,0,8,6,18
2/15/1978,10,0,5,9,24
2/16/1978,12,0,9,5,26
2/17/1978,6,0,2,9,17
2/18/1978,8,0,7,7,22
2/19/1978,10,0,7,1,18
2/20/1978,6,0,10,1,17
2/21/1978,5,0,7,5,17
2/22/1978,9,0,9,11,29
2/23/1978,9,0,6,4,19
2/24/1978,12,0,5,8,25
2/25/1978,12,0,7,10,29
2/26/1978,6,0,10,10,26
2/27/1978,11,0,8,4,23
2/28/1978,10,0,5,4,19
3/1/1978,4,0,8,4,16
3/2/1978,7,0,4,7,18
3/3/1978,7,0,3,2,12
3/4/1978,12,0,5,2,19
3/5/1978,7,0,6,8,21
3/6/1978,11,0,5,10,26
3/7/1978,10,0,9,6,25
3/8/1978,7,0,9,3,19
3/9/1978,8,0,10,9,27
3/10/1978,6,0,3,6,15
3/11/1978,12,0,4,4,20
3/12/1978,5,0,5,6,16
3/13/1978,8,0,6,10,24
3/14/1978,10,0,5,11,26
3/15/1978,8,0,6,10,24
3/16/1978,10,0,2,9,21
3/17/1978,6,0,6,6,18
3/18/1978,7,0,4,0,11
3/19/1978,10,0,7,1,18
3/20/1978,7,0,5,1,13
3/21/1978,6,0,10,1,17
3/22/1978,11,0,8,4,23
3/23/1978,7,0,4,2,13
3/24/1978,8,0,4,0,12
3/25/1978,12,0,4,9,25
3/26/1978,7,0,9,9,25
3/27/1978,6,0,7,3,16
3/28/1978,10,0,6,2,18
3/29/1978,10,0,3,1,14
3/30/1978,10,0,7,1,18
3/31/1978,4,0,2,0,6
4/1/1978,6,0,9,10,25
4/2/1978,5,0,8,10,23
4/3/1978,4,0,2,5,11
4/4/1978,9,0,6,6,21
4/5/1978,12,0,3,8,23
4/6/1978,9,0,6,7,22
4/7/1978,10,0,7,6,23
4/8/1978,7,0,8,6,21
4/9/1978,8,0,6,0,14
4/10/1978,7,0,2,0,9
4/11/1978,12,0,9,11,32
4/12/1978,4,0,7,5,16
4/13/1978,4,0,9,1,14
4/14/1978,8,0,4,4,16
4/15/1978,12,0,4,3,19
4/16/1978,12,0,2,6,20
4/17/1978,5,0,2,9,16
4/18/1978,6,0,9,3,18
4/19/1978,12,0,8,0,20
4/20/1978,10,0,10,10,30
4/21/1978,5,0,7,1,13
4/22/1978,4,0,4,6,14
4/23/1978,4,0,9,11,24
4/24/1978,9,0,8,9,26
4/25/1978,11,0,5,3,19
4/26/1978,7,0,6,5,18
4/27/1978,4,0,3,6,13
4/28/1978,6,0,6,9,21
4/29/1978,12,0,6,7,25
4/30/1978,9,0,6,6,21
5/1/1978,11,0,2,11,24
5/2/1978,5,0,10,9,24
5/3/1978,10,0,3,7,20
5/4/1978,9,0,7,10,26
5/5/1978,12,0,7,10,29
5/6/1978,4,0,3,6,13
5/7/1978,7,0,4,10,21
5/8/1978,6,0,9,10,25
5/9/1978,11,0,2,8,21
5/10/1978,6,0,4,0,10
5/11/1978,9,0,7,1,17
5/12/1978,4,0,3,3,10
5/13/1978,8,0,6,7,21
5/14/1978,11,0,9,1,21
5/15/1978,5,0,2,8,15
5/16/1978,7,0,8,11,26
5/17/1978,11,0,2,11,24
5/18/1978,5,0,10,11,26
5/19/1978,12,0,8,1,21
5/20/1978,9,0,5,10,24
5/21/1978,12,0,7,0,19
5/22/1978,6,0,6,2,14
5/23/1978,10,0,4,9,23
5/24/1978,4,0,7,9,20
5/25/1978,7,0,9,10,26
5/26/1978,12,0,3,5,20
5/27/1978,12,0,7,8,27
5/28/1978,11,0,6,9,26
5/29/1978,5,0,4,10,19
5/30/1978,10,0,2,11,23
5/31/1978,8,0,6,0,14
6/1/1978,9,0,2,10,21
6/2/1978,7,0,7,8,22
6/3/1978,6,0,7,0,13
6/4/1978,12,0,9,6,27
6/5/1978,8,0,9,7,24
6/6/1978,8,0,3,6,17
6/7/1978,5,0,2,8,15
6/8/1978,12,0,3,5,20
6/9/1978,12,0,4,6,22
6/10/1978,5,0,10,5,20
6/11/1978,12,0,9,10,31
6/12/1978,10,0,5,9,24
6/13/1978,12,0,7,8,27
6/14/1978,5,0,2,10,17
6/15/1978,6,0,8,3,17
6/16/1978,5,0,5,10,20
6/17/1978,11,0,7,0,18
6/18/1978,7,0,4,7,18
6/19/1978,9,0,10,5,24
6/20/1978,12,0,4,11,27
6/21/1978,4,0,4,10,18
6/22/1978,9,0,10,10,29
6/23/1978,11,0,8,7,26
6/24/1978,11,0,5,5,21
6/25/1978,11,0,2,2,15
6/26/1978,8,0,7,10,25
6/27/1978,7,0,3,8,18
6/28/1978,11,0,8,2,21
6/29/1978,8,0,10,3,21
6/30/1978,10,0,7,10,27
7/1/1978,10,0,9,8,27
7/2/1978,8,0,10,11,29
7/3/1978,4,0,4,9,17
7/4/1978,11,0,3,5,19
7/5/1978,9,0,3,11,23
7/6/1978,12,0,2,11,25
7/7/1978,6,0,3,4,13
7/8/1978,11,0,8,5,24
7/9/1978,5,0,2,10,17
7/10/1978,6,0,9,7,22
7/11/1978,5,0,6,2,13
7/12/1978,6,0,3,11,20
7/13/1978,11,0,7,9,27
7/14/1978,12,0,5,3,20
7/15/1978,6,0,3,6,15
7/16/1978,12,0,7,6,25
7/17/1978,7,0,10,6,23
7/18/1978,9,0,5,4,18
7/19/1978,6,0,10,7,23
7/20/1978,9,0,8,11,28
7/21/1978,11,0,4,11,26
7/22/1978,9,0,4,4,17
7/23/1978,9,0,3,4,16
7/24/1978,9,0,7,8,24
7/25/1978,11,0,9,6,26
7/26/1978,10,0,9,0,19
7/27/1978,7,0,7,6,20
7/28/1978,10,0,4,8,22
7/29/1978,6,0,10,4,20
7/30/1978,8,0,2,2,12
7/31/1978,7,0,2,5,14
8/1/1978,12,0,10,2,24
8/2/1978,4,0,5,8,17
8/3/1978,5,0,5,11,21
8/4/1978,12,0,2,6,20
8/5/1978,5,0,10,8,23
8/6/1978,9,0,3,11,23
8/7/1978,11,0,3,8,22
8/8/1978,4,0,2,10,16
8/9/1978,9,0,6,1,16
8/10/1978,9,0,2,1,12
8/11/1978,4,0,3,10,17
8/12/1978,4,0,10,1,15
8/13/1978,4,0,4,8,16
8/14/1978,7,0,5,2,14
8/15/1978,9,0,10,7,26
8/16/1978,10,0,3,1,14
8/17/1978,6,0,5,9,20
8/18/1978,7,0,4,9,20
8/19/1978,12,0,3,11,26
8/20/1978,4,0,4,2,10
8/21/1978,9,0,2,2,13
8/22/1978,10,0,4,10,24
8/23/1978,12,0,6,2,20
8/24/1978,9,0,3,1,13
8/25/1978,10,0,5,8,23
8/26/1978,8,0,4,5,17
8/27/1978,10,0,9,5,24
8/28/1978,12,0,8,2,22
8/29/1978,4,0,3,6,13
8/30/1978,7,0,3,0,10
8/31/1978,9,0,4,5,18
9/1/1978,9,0,4,4,17
9/2/1978,6,0,2,11,19
9/3/1978,7,0,5,10,22
9/4/1978,8,0,7,3,18
9/5/1978,4,0,5,0,9
9/6/1978,7,0,3,8,18
9/7/1978,10,0,6,0,16
9/8/1978,12,0,9,7,28
9/9/1978,4,0,5,2,11
9/10/1978,4,0,5,3,12
9/11/1978,9,0,2,6,17
9/12/1978,9,0,8,11,28
9/13/1978,6,0,5,1,12
9/14/1978,12,0,7,4,23
9/15/1978,8,0,4,10,22
9/16/1978,12,0,7,8,27
9/17/1978,12,0,5,10,27
9/18/1978,4,0,2,11,17
9/19/1978,7,0,2,1,10
9/20/1978,11,0,6,7,24
9/21/1978,11,0,7,8,26
9/22/1978,5,0,9,0,14
9/23/1978,8,0,8,11,27
9/24/1978,12,0,8,9,29
9/25/1978,4,0,9,3,16
9/26/1978,8,0,9,10,27
9/27/1978,11,0,7,0,18
9/28/1978,7,0,5,9,21
9/29/1978,12,0,5,0,17
9/30/1978,6,0,7,10,23
10/1/1978,12,0,9,5,26
10/2/1978,7,0,2,9,18
10/3/1978,6,0,10,9,25
10/4/1978,6,0,5,4,15
10/5/1978,10,0,10,4,24
10/6/1978,9,0,6,4,19
10/7/1978,5,0,7,7,19
10/8/1978,9,0,10,7,26
10/9/1978,9,0,4,4,17
10/10/1978,12,0,10,3,25
10/11/1978,11,0,9,6,26
10/12/1978,8,0,8,0,16
10/13/1978,7,0,4,6,17
10/14/1978,5,0,5,3,13
10/15/1978,5,0,6,8,19
10/16/1978,10,0,4,1,15
10/17/1978,12,0,7,10,29
10/18/1978,5,0,7,3,15
10/19/1978,4,0,5,5,14
10/20/1978,5,0,3,11,19
10/21/1978,5,0,3,1,9
10/22/1978,6,0,7,0,13
10/23/1978,4,0,4,6,14
10/24/1978,9,0,9,0,18
10/25/1978,7,0,8,10,25
10/26/1978,10,0,5,3,18
10/27/1978,7,0,3,6,16
10/28/1978,9,0,6,0,15
10/29/1978,11,0,10,10,31
10/30/1978,12,0,9,2,23
10/31/1978,12,0,10,3,25
11/1/1978,7,0,10,3,20
11/2/1978,11,0,6,10,27
11/3/1978,10,0,9,1,20
11/4/1978,7,0,6,1,14
11/5/1978,8,0,9,0,17
11/6/1978,10,0,3,5,18
11/7/1978,10,0,9,8,27
11/8/1978,4,0,7,3,14
11/9/1978,8,0,8,1,17
11/10/1978,9,0,9,10,28
11/11/1978,12,0,10,8,30
11/12/1978,12,0,7,1,20
11/13/1978,9,0,3,11,23
11/14/1978,10,0,7,8,25
11/15/1978,7,0,5,4,16
11/16/1978,8,0,6,2,16
11/17/1978,8,0,4,2,14
11/18/1978,7,0,6,10,23
11/19/1978,6,0,2,6,14
11/20/1978,9,0,9,0,18
11/21/1978,12,0,4,8,24
11/22/1978,12,0,9,0,21
11/23/1978,10,0,3,1,14
11/24/1978,5,0,8,3,16
11/25/1978,11,0,2,2,15
11/26/1978,10,0,5,7,22
11/27/1978,4,0,4,1,9
11/28/1978,6,0,9,1,16
11/29/1978,6,0,6,4,16
11/30/1978,12,0,5,6,23
12/1/1978,5,0,6,4,15
12/2/1978,7,0,8,7,22
12/3/1978,6,0,3,6,15
12/4/1978,9,0,6,0,15
12/5/1978,8,0,5,5,18
12/6/1978,6,0,8,0,14
12/7/1978,4,0,10,9,23
12/8/1978,8,0,10,7,25
12/9/1978,12,0,2,1,15
12/10/1978,9,0,3,5,17
12/11/1978,8,0,7,11,26
12/12/1978,5,0,7,9,21
12/13/1978,6,0,8,8,22
12/14/1978,9,0,7,7,23
12/15/1978,6,0,7,4,17
12/16/1978,11,0,5,5,21
12/17/1978,8,0,4,4,16
12/18/1978,5,0,9,3,17
12/19/1978,9,0,5,4,18
12/20/1978,12,0,2,1,15
12/21/1978,8,0,2,11,21
12/22/1978,12,0,2,0,14
12/23/1978,4,0,3,5,12
12/24/1978,8,0,9,8,25
12/25/1978,11,0,3,10,24
12/26/1978,9,0,3,7,19
12/27/1978,6,0,8,4,18
12/28/1978,12,0,7,9,28
12/29/1978,7,0,4,6,17
12/30/1978,8,0,5,5,18
12/31/1978,9,0,2,5,16
1/1/1979,9,0,8,8,25
1/2/1979,5,0,9,4,18
1/3/1979,5,0,2,9,16
1/4/1979,11,0,6,4,21
1/5/1979,12,0,8,0,20
1/6/1979,7,0,5,6,18
1/7/1979,8,0,9,10,27
1/8/1979,6,0,6,8,20
1/9/1979,10,0,8,1,19
1/10/1979,4,0,10,0,14
1/11/1979,8,0,7,5,20
1/12/1979,11,0,2,3,16
1/13/1979,11,0,4,5,20
1/14/1979,8,0,4,5,17
1/15/1979,7,0,9,0,16
1/16/1979,4,0,7,11,22
1/17/1979,9,0,5,5,19
1/18/1979,4,0,6,7,17
1/19/1979,5,0,3,10,18
1/20/1979,11,0,3,2,16
1/21/1979,12,0,3,3,18
1/22/1979,10,0,9,1,20
1/23/1979,10,0,2,1,13
1/24/1979,4,0,4,3,11
1/25/1979,5,0,9,7,21
1/26/1979,10,0,6,6,22
1/27/1979,9,0,2,10,21
1/28/1979,9,0,5,9,23
1/29/1979,5,0,9,5,19
1/30/1979,4,0,10,5,19
1/31/1979,12,0,10,4,26
2/1/1979,4,0,3,4,11
2/2/1979,11,0,4,2,17
2/3/1979,11,0,8,3,22
2/4/1979,7,0,2,3,12
2/5/1979,5,0,9,2,16
2/6/1979,10,0,5,3,18
2/7/1979,6,0,10,8,24
2/8/1979,6,0,8,1,15
2/9/1979,5,0,2,8,15
2/10/1979,6,0,7,10,23
2/11/1979,6,0,9,7,22
2/12/1979,6,0,7,4,17
2/13/1979,12,0,4,7,23
2/14/1979,10,0,3,7,20
2/15/1979,9,0,7,10,26
2/16/1979,7,0,5,3,15
2/17/1979,12,0,6,5,23
2/18/1979,8,0,2,3,13
2/19/1979,6,0,8,2,16
2/20/1979,10,0,5,8,23
2/21/1979,12,0,7,9,28
2/22/1979,11,0,7,10,28
2/23/1979,5,0,2,7,14
2/24/1979,4,0,7,3,14
2/25/1979,5,0,3,6,14
2/26/1979,6,0,10,11,27
2/27/1979,9,0,10,7,26
2/28/1979,11,0,10,10,31
3/1/1979,10,0,8,1,19
3/2/1979,4,0,10,1,15
3/3/1979,11,0,6,3,20
3/4/1979,8,0,5,2,15
3/5/1979,10,0,5,4,19
3/6/1979,8,0,3,3,14
3/7/1979,11,0,7,1,19
3/8/1979,12,0,5,8,25
3/9/1979,5,0,9,8,22
3/10/1979,8,0,8,6,22
3/11/1979,8,0,10,10,28
3/12/1979,7,0,6,1,14
3/13/1979,6,0,9,1,16
3/14/1979,9,0,6,0,15
3/15/1979,12,0,4,0,16
3/16/1979,9,0,5,1,15
3/17/1979,8,0,3,3,14
3/18/1979,6,0,2,8,16
3/19/1979,5,0,4,8,17
3/20/1979,10,0,7,10,27
3/21/1979,11,0,8,9,28
3/22/1979,12,0,9,2,23
3/23/1979,11,0,2,1,14
3/24/1979,5,0,2,10,17
3/25/1979,11,0,6,5,22
3/26/1979,9,0,8,5,22
3/27/1979,12,0,9,4,25
3/28/1979,10,0,9,5,24
3/29/1979,8,0,8,2,18
3/30/1979,7,0,10,3,20
3/31/1979,9,0,7,8,24
4/1/1979,6,0,7,1,14
4/2/1979,7,0,7,3,17
4/3/1979,12,0,4,1,17
4/4/1979,4,0,7,11,22
4/5/1979,10,0,9,0,19
4/6/1979,11,0,5,1,17
4/7/1979,12,0,9,6,27
4/8/1979,10,0,4,3,17
4/9/1979,12,0,2,6,20
4/10/1979,11,0,9,6,26
4/11/1979,6,0,5,1,12
4/12/1979,12,0,3,4,19
4/13/1979,11,0,3,10,24
4/14/1979,7,0,5,11,23
4/15/1979,10,0,9,7,26
4/16/1979,8,0,2,3,13
4/17/1979,10,0,2,5,17
4/18/1979,10,0,5,7,22
4/19/1979,6,0,4,5,15
4/20/1979,10,0,10,7,27
4/21/1979,5,0,10,6,21
4/22/1979,4,0,4,0,8
4/23/1979,5,0,9,1,15
4/24/1979,8,0,7,5,20
4/25/1979,10,0,4,10,24
4/26/1979,11,0,2,2,15
4/27/1979,4,0,2,0,6
4/28/1979,6,0,7,5,18
4/29/1979,6,0,9,6,21
4/30/1979,5,0,9,1,15
5/1/1979,4,0,10,1,15
5/2/1979,12,0,10,3,25
5/3/1979,10,0,4,4,18
5/4/1979,4,0,10,5,19
5/5/1979,10,0,3,11,24
5/6/1979,8,0,9,0,17
5/7/1979,12,0,5,4,21
5/8/1979,12,0,5,8,25
5/9/1979,10,0,5,9,24
5/10/1979,4,0,4,0,8
5/11/1979,7,0,8,8,23
5/12/1979,5,0,9,7,21
5/13/1979,12,0,3,7,22
5/14/1979,8,0,3,10,21
5/15/1979,11,0,8,7,26
5/16/1979,11,0,10,1,22
5/17/1979,11,0,7,8,26
5/18/1979,12,0,7,8,27
5/19/1979,6,0,10,1,17
5/20/1979,10,0,4,10,24
5/21/1979,12,0,7,3,22
5/22/1979,12,0,4,11,27
5/23/1979,10,0,5,4,19
5/24/1979,12,0,7,6,25
5/25/1979,4,0,9,8,21
5/26/1979,5,0,4,11,20
5/27/1979,6,0,7,3,16
5/28/1979,12,0,8,8,28
5/29/1979,5,0,4,8,17
5/30/1979,9,0,8,2,19
5/31/1979,9,0,5,6,20
6/1/1979,9,0,10,8,27
6/2/1979,10,0,8,9,27
6/3/1979,6,0,8,1,15
6/4/1979,10,0,9,2,21
6/5/1979,8,0,6,5,19
6/6/1979,10,0,5,4,19
6/7/1979,8,0,5,5,18
6/8/1979,6,0,2,6,14
6/9/1979,8,0,3,7,18
6/10/1979,10,0,7,6,23
6/11/1979,10,0,7,5,22
6/12/1979,7,0,10,7,24
6/13/1979,6,0,3,9,18
6/14/1979,8,0,7,5,20
6/15/1979,12,0,5,3,20
6/16/1979,9,0,3,2,14
6/17/1979,4,0,3,0,7
6/18/1979,11,0,8,3,22
6/19/1979,11,0,4,6,21
6/20/1979,6,0,10,0,16
6/21/1979,11,0,9,6,26
6/22/1979,11,0,4,1,16
6/23/1979,6,0,9,4,19
6/24/1979,4,0,5,6,15
6/25/1979,12,0,8,11,31
6/26/1979,8,0,3,7,18
6/27/1979,12,0,6,0,18
6/28/1979,12,0,8,9,29
6/29/1979,9,0,10,2,21
6/30/1979,9,0,6,7,22
7/1/1979,7,0,3,0,10
7/2/1979,11,0,8,1,20
7/3/1979,7,0,9,2,18
7/4/1979,7,0,6,1,14
7/5/1979,11,0,5,6,22
7/6/1979,9,0,9,7,25
7/7/1979,7,0,8,5,20
7/8/1979,12,0,5,6,23
7/9/1979,8,0,4,4,16
7/10/1979,7,0,8,0,15
7/11/1979,9,0,7,11,27
7/12/1979,12,0,10,0,22
7/13/1979,6,0,8,11,25
7/14/1979,6,0,2,4,12
7/15/1979,7,0,8,6,21
7/16/1979,11,0,5,1,17
7/17/1979,8,0,4,5,17
7/18/1979,11,0,6,1,18
7/19/1979,8,0,3,9,20
7/20/1979,6,0,2,5,13
7/21/1979,7,0,6,4,17
7/22/1979,10,0,5,2,17
7/23/1979,9,0,8,0,17
7/24/1979,5,0,3,6,14
7/25/1979,10,0,9,10,29
7/26/1979,9,0,6,5,20
7/27/1979,11,0,9,4,24
7/28/1979,5,0,4,5,14
7/29/1979,5,0,5,8,18
7/30/1979,9,0,3,2,14
7/31/1979,5,0,8,7,20
8/1/1979,4,0,6,6,16
8/2/1979,11,0,8,5,24
8/3/1979,5,0,2,9,16
8/4/1979,5,0,6,2,13
8/5/1979,5,0,9,10,24
8/6/1979,4,0,3,11,18
8/7/1979,10,0,9,5,24
8/8/1979,4,0,9,9,22
8/9/1979,8,0,10,1,19
8/10/1979,4,0,10,2,16
8/11/1979,12,0,6,7,25
8/12/1979,8,0,2,0,10
8/13/1979,9,0,8,3,20
8/14/1979,5,0,2,9,16
8/15/1979,11,0,7,9,27
8/16/1979,6,0,2,6,14
8/17/1979,4,0,7,8,19
8/18/1979,7,0,6,7,20
8/19/1979,11,0,4,5,20
8/20/1979,7,0,7,1,15
8/21/1979,9,0,5,3,17
8/22/1979,6,0,7,6,19
8/23/1979,8,0,8,6,22
8/24/1979,7,0,9,11,27
8/25/1979,11,0,7,3,21
8/26/1979,10,0,3,8,21
8/27/1979,5,0,9,9,23
8/28/1979,11,0,5,10,26
8/29/1979,6,0,7,9,22
8/30/1979,6,0,2,2,10
8/31/1979,10,0,3,7,20
9/1/1979,9,0,3,10,22
9/2/1979,10,0,3,4,17
9/3/1979,9,0,4,3,16
9/4/1979,6,0,4,0,10
9/5/1979,7,0,7,3,17
9/6/1979,9,0,9,7,25
9/7/1979,8,0,6,0,14
9/8/1979,12,0,7,7,26
9/9/1979,12,0,9,4,25
9/10/1979,6,0,3,1,10
9/11/1979,11,0,7,3,21
9/12/1979,5,0,4,1,10
9/13/1979,12,0,2,2,16
9/14/1979,9,0,7,3,19
9/15/1979,8,0,8,3,19
9/16/1979,9,0,5,11,25
9/17/1979,10,0,6,10,26
9/18/1979,12,0,5,11,28
9/19/1979,9,0,7,7,23
9/20/1979,6,0,3,6,15
9/21/1979,4,0,6,1,11
9/22/1979,9,0,9,5,23
9/23/1979,11,0,7,6,24
9/24/1979,8,0,4,0,12
9/25/1979,7,0,9,11,27
9/26/1979,8,0,4,0,12
9/27/1979,9,0,2,11,22
9/28/1979,8,0,9,2,19
9/29/1979,12,0,2,11,25
9/30/1979,12,0,8,5,25
10/1/1979,7,0,4,11,22
10/2/1979,12,0,4,7,23
10/3/1979,4,0,9,5,18
10/4/1979,9,0,8,3,20
10/5/1979,5,0,4,11,20
10/6/1979,10,0,3,8,21
10/7/1979,9,0,6,8,23
10/8/1979,12,0,8,6,26
10/9/1979,9,0,8,1,18
10/10/1979,11,0,7,8,26
10/11/1979,5,0,4,11,20
10/12/1979,7,0,2,9,18
10/13/1979,12,0,2,3,17
10/14/1979,11,0,2,8,21
10/15/1979,5,0,2,0,7
10/16/1979,11,0,6,1,18
10/17/1979,6,0,6,9,21
10/18/1979,12,0,3,3,18
10/19/1979,4,0,7,1,12
10/20/1979,10,0,6,11,27
10/21/1979,8,0,7,7,22
10/22/1979,4,0,7,11,22
10/23/1979,6,0,4,8,18
10/24/1979,6,0,10,11,27
10/25/1979,5,0,4,3,12
10/26/1979,7,0,2,0,9
10/27/1979,12,0,7,1,20
10/28/1979,8,0,10,1,19
10/29/1979,11,0,5,5,21
10/30/1979,10,0,6,0,16
10/31/1979,9,0,4,1,14
11/1/1979,5,0,5,11,21
11/2/1979,6,0,3,10,19
11/3/1979,5,0,2,4,11
11/4/1979,8,0,3,8,19
11/5/1979,10,0,3,7,20
11/6/1979,9,0,3,3,15
11/7/1979,6,0,6,1,13
11/8/1979,10,0,8,9,27
11/9/1979,4,0,10,1,15
11/10/1979,9,0,5,9,23
11/11/1979,8,0,10,0,18
11/12/1979,8,0,4,3,15
11/13/1979,8,0,2,6,16
11/14/1979,4,0,8,10,22
11/15/1979,12,0,2,10,24
11/16/1979,10,0,5,0,15
11/17/1979,4,0,3,3,10
11/18/1979,5,0,7,11,23
11/19/1979,4,0,7,7,18
11/20/1979,5,0,6,2,13
11/21/1979,6,0,7,9,22
11/22/1979,10,0,2,0,12
11/23/1979,7,0,7,6,20
11/24/1979,11,0,5,2,18
11/25/1979,8,0,8,10,26
11/26/1979,6,0,10,1,17
11/27/1979,4,0,8,7,19
11/28/1979,5,0,3,0,8
11/29/1979,11,0,2,4,17
11/30/1979,8,0,6,1,15
12/1/1979,8,0,8,9,25
12/2/1979,6,0,8,7,21
12/3/1979,11,0,5,6,22
12/4/1979,4,0,10,10,24
12/5/1979,6,0,2,3,11
12/6/1979,9,0,7,9,25
12/7/1979,11,0,9,10,30
12/8/1979,8,0,3,2,13
12/9/1979,5,0,3,2,10
12/10/1979,12,0,3,0,15
12/11/1979,5,0,3,3,11
12/12/1979,6,0,3,9,18
12/13/1979,5,0,6,6,17
12/14/1979,10,0,9,4,23
12/15/1979,12,0,7,7,26
12/16/1979,4,0,6,7,17
12/17/1979,7,0,4,0,11
12/18/1979,9,0,3,11,23
12/19/1979,9,0,2,3,14
12/20/1979,8,0,3,4,15
12/21/1979,5,0,2,2,9
12/22/1979,8,0,6,1,15
12/23/1979,8,0,5,3,16
12/24/1979,9,0,10,4,23
12/25/1979,12,0,5,6,23
12/26/1979,5,0,6,6,17
12/27/1979,7,0,10,1,18
12/28/1979,5,0,7,9,21
12/29/1979,5,0,8,8,21
12/30/1979,11,0,4,4,19
12/31/1979,9,0,8,8,25
1/1/1980,10,0,9,6,25
1/2/1980,4,0,3,11,18
1/3/1980,7,0,5,10,22
1/4/1980,11,0,9,7,27
1/5/1980,10,0,2,6,18
1/6/1980,4,0,4,1,9
1/7/1980,4,0,3,1,8
1/8/1980,4,0,2,7,13
1/9/1980,4,0,7,2,13
1/10/1980,8,0,7,2,17
1/11/1980,10,0,6,10,26
1/12/1980,6,0,7,7,20
1/13/1980,10,0,8,10,28
1/14/1980,5,0,9,4,18
1/15/1980,12,0,5,6,23
1/16/1980,9,0,10,7,26
1/17/1980,4,0,2,1,7
1/18/1980,12,0,5,8,25
1/19/1980,10,0,7,11,28
1/20/1980,10,0,10,10,30
1/21/1980,11,0,3,3,17
1/22/1980,9,0,2,3,14
1/23/1980,4,0,3,10,17
1/24/1980,12,0,7,8,27
1/25/1980,9,0,7,2,18
1/26/1980,6,0,3,6,15
1/27/1980,5,0,2,10,17
1/28/1980,10,0,3,9,22
1/29/1980,7,0,8,11,26
1/30/1980,7,0,3,2,12
1/31/1980,5,0,10,3,18
2/1/1980,4,0,5,2,11
2/2/1980,5,0,6,11,22
2/3/1980,11,0,6,6,23
2/4/1980,11,0,3,6,20
2/5/1980,10,0,10,0,20
2/6/1980,9,0,9,0,18
2/7/1980,11,0,3,5,19
2/8/1980,6,0,7,5,18
2/9/1980,7,0,8,2,17
2/10/1980,11,0,6,2,19
2/11/1980,12,0,3,5,20
2/12/1980,9,0,6,6,21
2/13/1980,7,0,3,11,21
2/14/1980,12,0,7,6,25
2/15/1980,10,0,4,11,25
2/16/1980,7,0,10,10,27
2/17/1980,5,0,2,11,18
2/18/1980,11,0,6,8,25
2/19/1980,5,0,9,7,21
2/20/1980,4,0,5,2,11
2/21/1980,10,0,4,11,25
2/22/1980,12,0,2,3,17
2/23/1980,12,0,6,11,29
2/24/1980,11,0,3,0,14
2/25/1980,5,0,5,4,14
2/26/1980,10,0,8,4,22
2/27/1980,4,0,6,11,21
2/28/1980,7,0,8,11,26
2/29/1980,7,0,10,2,19
3/1/1980,9,0,10,3,22
3/2/1980,4,0,6,9,19
3/3/1980,6,0,7,11,24
3/4/1980,12,0,7,5,24
3/5/1980,6,0,4,1,11
3/6/1980,10,0,8,2,20
3/7/1980,12,0,10,6,28
3/8/1980,12,0,8,10,30
3/9/1980,9,0,3,9,21
3/10/1980,7,0,5,6,18
3/11/1980,10,0,2,1,13
3/12/1980,4,0,3,10,17
3/13/1980,6,0,6,0,12
3/14/1980,5,0,4,3,12
3/15/1980,4,0,3,7,14
3/16/1980,12,0,6,7,25
3/17/1980,8,0,5,10,23
3/18/1980,7,0,4,3,14
3/19/1980,10,0,3,2,15
3/20/1980,9,0,10,9,28
3/21/1980,11,0,3,4,18
3/22/1980,10,0,5,2,17
3/23/1980,12,0,4,0,16
3/24/1980,10,0,10,6,26
3/25/1980,7,0,6,4,17
3/26/1980,8,0,10,5,23
3/27/1980,8,0,8,5,21
3/28/1980,5,0,9,1,15
3/29/1980,7,0,8,4,19
3/30/1980,10,0,5,2,17
3/31/1980,6,0,5,3,14
4/1/1980,8,0,5,4,17
4/2/1980,4,0,5,8,17
4/3/1980,12,0,8,7,27
4/4/1980,6,0,3,4,13
4/5/1980,5,0,6,7,18
4/6/1980,7,0,2,0,9
4/7/1980,12,0,9,9,30
4/8/1980,6,0,10,5,21
4/9/1980,9,0,9,10,28
4/10/1980,8,0,6,4,18
4/11/1980,12,0,5,2,19
4/12/1980,5,0,8,7,20
4/13/1980,9,0,5,0,14
4/14/1980,11,0,7,2,20
4/15/1980,12,0,7,11,30
4/16/1980,4,0,6,1,11
4/17/1980,10,0,2,7,19
4/18/1980,7,0,9,4,20
4/19/1980,8,0,6,8,22
4/20/1980,5,0,6,6,17
4/21/1980,11,0,10,8,29
4/22/1980,6,0,4,9,19
4/23/1980,11,0,4,8,23
4/24/1980,12,0,6,2,20
4/25/1980,12,0,10,4,26
4/26/1980,8,0,3,11,22
4/27/1980,12,0,4,1,17
4/28/1980,6,0,3,9,18
4/29/1980,12,0,4,1,17
4/30/1980,7,0,7,10,24
5/1/1980,7,0,7,5,19
5/2/1980,6,0,10,6,22
5/3/1980,6,0,9,6,21
5/4/1980,6,0,5,2,13
5/5/1980,9,0,2,7,18
5/6/1980,7,0,3,10,20
5/7/1980,8,0,7,8,23
5/8/1980,9,0,7,2,18
5/9/1980,7,0,9,6,22
5/10/1980,12,0,2,9,23
5/11/1980,8,0,6,4,18
5/12/1980,9,0,6,4,19
5/13/1980,6,0,4,2,12
5/14/1980,11,0,6,4,21
5/15/1980,11,0,3,11,25
5/16/1980,5,0,10,2,17
5/17/1980,12,0,7,10,29
5/18/1980,4,0,4,7,15
5/19/1980,10,0,10,9,29
5/20/1980,12,0,5,6,23
5/21/1980,11,0,3,7,21
5/22/1980,4,0,3,7,14
5/23/1980,10,0,5,3,18
5/24/1980,9,0,3,0,12
5/25/1980,8,0,6,1,15
5/26/1980,8,0,9,9,26
5/27/1980,11,0,4,10,25
5/28/1980,9,0,6,7,22
5/29/1980,10,0,9,9,28
5/30/1980,6,0,7,4,17
5/31/1980,4,0,6,10,20
6/1/1980,12,0,3,9,24
6/2/1980,12,0,7,1,20
6/3/1980,7,0,6,0,13
6/4/1980,4,0,8,7,19
6/5/1980,7,0,6,11,24
6/6/1980,4,0,2,10,16
6/7/1980,8,0,8,8,24
6/8/1980,8,0,5,7,20
6/9/1980,4,0,8,7,19
6/10/1980,4,0,10,0,14
6/11/1980,4,0,5,6,15
6/12/1980,8,0,9,11,28
6/13/1980,10,0,3,10,23
6/14/1980,4,0,5,5,14
6/15/1980,9,0,10,4,23
6/16/1980,6,0,5,0,11
6/17/1980,8,0,6,2,16
6/18/1980,7,0,5,1,13
6/19/1980,9,0,2,2,13
6/20/1980,8,0,2,3,13
6/21/1980,11,0,3,4,18
6/22/1980,10,0,7,1,18
6/23/1980,9,0,9,4,22
6/24/1980,12,0,9,6,27
6/25/1980,5,0,4,2,11
6/26/1980,5,0,4,11,20
6/27/1980,5,0,8,6,19
6/28/1980,11,0,3,10,24
6/29/1980,9,0,6,9,24
6/30/1980,10,0,2,1,13
7/1/1980,5,0,3,5,13
7/2/1980,10,0,7,7,24
7/3/1980,8,0,2,11,21
7/4/1980,7,0,10,6,23
7/5/1980,5,0,9,11,25
7/6/1980,9,0,2,11,22
7/7/1980,6,0,10,7,23
7/8/1980,7,0,7,4,18
7/9/1980,7,0,6,11,24
7/10/1980,6,0,10,3,19
7/11/1980,5,0,7,6,18
7/12/1980,5,0,5,11,21
7/13/1980,6,0,7,5,18
7/14/1980,12,0,5,2,19
7/15/1980,9,0,5,9,23
7/16/1980,11,0,9,9,29
7/17/1980,10,0,6,3,19
7/18/1980,10,0,2,4,16
7/19/1980,12,0,3,0,15
7/20/1980,11,0,8,3,22
7/21/1980,10,0,2,8,20
7/22/1980,9,0,5,11,25
7/23/1980,11,0,10,10,31
7/24/1980,10,0,4,4,18
7/25/1980,7,0,6,11,24
7/26/1980,7,0,5,7,19
7/27/1980,10,0,5,2,17
7/28/1980,4,0,3,5,12
7/29/1980,9,0,7,8,24
7/30/1980,11,0,9,4,24
7/31/1980,8,0,3,4,15
8/1/1980,4,0,3,7,14
8/2/1980,12,0,7,11,30
8/3/1980,7,0,8,2,17
8/4/1980,12,0,6,3,21
8/5/1980,8,0,4,8,20
8/6/1980,12,0,9,1,22
8/7/1980,6,0,10,10,26
8/8/1980,4,0,5,6,15
8/9/1980,10,0,7,11,28
8/10/1980,9,0,8,6,23
8/11/1980,12,0,7,2,21
8/12/1980,5,0,6,3,14
8/13/1980,5,0,4,0,9
8/14/1980,8,0,10,3,21
8/15/1980,6,0,3,4,13
8/16/1980,10,0,9,5,24
8/17/1980,8,0,2,6,16
8/18/1980,10,0,7,11,28
8/19/1980,12,0,4,5,21
8/20/1980,10,0,4,1,15
8/21/1980,4,0,4,3,11
8/22/1980,8,0,8,3,19
8/23/1980,6,0,4,9,19
8/24/1980,8,0,7,7,22
8/25/1980,12,0,9,3,24
8/26/1980,11,0,8,7,26
8/27/1980,10,0,10,2,22
8/28/1980,6,0,3,11,20
8/29/1980,8,0,10,10,28
8/30/1980,4,0,10,8,22
8/31/1980,6,0,6,5,17
9/1/1980,11,0,3,0,14
9/2/1980,8,0,2,6,16
9/3/1980,11,0,2,6,19
9/4/1980,8,0,6,5,19
9/5/1980,12,0,9,2,23
9/6/1980,5,0,10,4,19
9/7/1980,5,0,8,7,20
9/8/1980,5,0,4,11,20
9/9/1980,11,0,7,0,18
9/10/1980,5,0,10,9,24
9/11/1980,12,0,9,1,22
9/12/1980,9,0,2,4,15
9/13/1980,6,0,5,5,16
9/14/1980,9,0,8,8,25
9/15/1980,5,0,8,4,17
9/16/1980,5,0,2,10,17
9/17/1980,6,0,10,0,16
9/18/1980,7,0,10,5,22
9/19/1980,6,0,5,3,14
9/20/1980,10,0,10,5,25
9/21/1980,11,0,5,4,20
9/22/1980,4,0,7,4,15
9/23/1980,7,0,6,1,14
9/24/1980,10,0,9,10,29
9/25/1980,4,0,2,5,11
9/26/1980,12,0,3,4,19
9/27/1980,11,0,2,10,23
9/28/1980,4,0,5,8,17
9/29/1980,9,0,2,9,20
9/30/1980,5,0,8,1,14
10/1/1980,4,0,8,0,12
10/2/1980,5,0,3,6,14
10/3/1980,11,0,2,11,24
10/4/1980,10,0,9,2,21
10/5/1980,10,0,10,6,26
10/6/1980,4,0,6,1,11
10/7/1980,9,0,10,4,23
10/8/1980,8,0,7,6,21
10/9/1980,12,0,7,11,30
10/10/1980,7,0,9,11,27
10/11/1980,11,0,6,4,21
10/12/1980,11,0,6,10,27
10/13/1980,4,0,7,10,21
10/14/1980,7,0,2,3,12
10/15/1980,9,0,8,3,20
10/16/1980,5,0,6,10,21
10/17/1980,4,0,4,2,10
10/18/1980,6,0,5,1,12
10/19/1980,7,0,8,11,26
10/20/1980,5,0,6,6,17
10/21/1980,9,0,2,4,15
10/22/1980,10,0,2,4,16
10/23/1980,11,0,2,3,16
10/24/1980,10,0,3,6,19
10/25/1980,9,0,7,6,22
10/26/1980,9,0,8,8,25
10/27/1980,7,0,3,6,16
10/28/1980,5,0,7,8,20
10/29/1980,9,0,8,8,25
10/30/1980,8,0,6,6,20
10/31/1980,8,0,10,11,29
11/1/1980,7,0,3,6,16
11/2/1980,12,0,6,6,24
11/3/1980,5,0,4,8,17
11/4/1980,6,0,5,5,16
11/5/1980,7,0,6,6,19
11/6/1980,9,0,9,7,25
11/7/1980,11,0,10,6,27
11/8/1980,10,0,2,1,13
11/9/1980,4,0,4,1,9
11/10/1980,6,0,6,0,12
11/11/1980,7,0,6,3,16
11/12/1980,12,0,4,6,22
11/13/1980,6,0,6,8,20
11/14/1980,7,0,8,2,17
11/15/1980,8,0,7,9,24
11/16/1980,6,0,10,3,19
11/17/1980,9,0,8,11,28
11/18/1980,7,0,5,7,19
11/19/1980,5,0,5,11,21
11/20/1980,9,0,7,6,22
11/21/1980,6,0,5,3,14
11/22/1980,11,0,10,6,27
11/23/1980,9,0,10,4,23
11/24/1980,10,0,9,8,27
11/25/1980,8,0,4,6,18
11/26/1980,4,0,8,4,16
11/27/1980,10,0,9,10,29
11/28/1980,8,0,6,2,16
11/29/1980,5,0,7,7,19
11/30/1980,11,0,7,5,23
12/1/1980,5,0,9,0,14
12/2/1980,11,0,3,2,16
12/3/1980,4,0,4,2,10
12/4/1980,6,0,5,7,18
12/5/1980,7,0,3,8,18
12/6/1980,7,0,4,1,12
12/7/1980,4,0,9,4,17
12/8/1980,10,0,9,8,27
12/9/1980,7,0,5,4,16
12/10/1980,7,0,8,2,17
12/11/1980,5,0,3,9,17
12/12/1980,7,0,4,9,20
12/13/1980,10,0,7,7,24
12/14/1980,8,0,5,2,15
12/15/1980,7,0,9,1,17
12/16/1980,11,0,5,0,16
12/17/1980,8,0,8,1,17
12/18/1980,9,0,8,2,19
12/19/1980,9,0,7,1,17
12/20/1980,4,0,6,11,21
12/21/1980,11,0,7,11,29
12/22/1980,12,0,7,2,21
12/23/1980,8,0,9,8,25
12/24/1980,6,0,9,2,17
12/25/1980,7,0,10,0,17
12/26/1980,11,0,4,6,21
12/27/1980,4,0,4,10,18
12/28/1980,10,0,3,6,19
12/29/1980,8,0,7,5,20
12/30/1980,5,0,6,9,20
12/31/1980,6,0,5,5,16
1/1/1981,7,0,4,9,20
1/2/1981,8,0,5,7,20
1/3/1981,12,0,7,4,23
1/4/1981,8,0,9,11,28
1/5/1981,4,0,5,8,17
1/6/1981,6,0,5,2,13
1/7/1981,7,0,2,11,20
1/8/1981,8,0,9,1,18
1/9/1981,6,0,7,7,20
1/10/1981,9,0,8,11,28
1/11/1981,4,0,7,10,21
1/12/1981,7,0,8,0,15
1/13/1981,9,0,5,2,16
1/14/1981,11,0,2,10,23
1/15/1981,10,0,2,8,20
1/16/1981,7,0,4,5,16
1/17/1981,11,0,2,1,14
1/18/1981,5,0,3,4,12
1/19/1981,6,0,7,10,23
1/20/1981,10,0,4,3,17
1/21/1981,11,0,9,7,27
1/22/1981,4,0,9,3,16
1/23/1981,6,0,5,3,14
1/24/1981,12,0,2,5,19
1/25/1981,8,0,8,10,26
1/26/1981,9,0,8,3,20
1/27/1981,11,0,7,5,23
1/28/1981,7,0,6,2,15
1/29/1981,4,0,5,1,10
1/30/1981,7,0,3,0,10
1/31/1981,5,0,9,11,25
2/1/1981,11,0,7,2,20
2/2/1981,10,0,7,0,17
2/3/1981,6,0,8,6,20
2/4/1981,7,0,8,2,17
2/5/1981,5,0,9,8,22
2/6/1981,6,0,2,3,11
2/7/1981,4,0,10,5,19
2/8/1981,11,0,7,11,29
2/9/1981,7,0,9,5,21
2/10/1981,11,0,8,3,22
2/11/1981,4,0,9,0,13
2/12/1981,11,0,9,6,26
2/13/1981,10,0,8,7,25
2/14/1981,9,0,10,3,22
2/15/1981,10,0,7,8,25
2/16/1981,4,0,5,7,16
2/17/1981,6,0,7,10,23
2/18/1981,6,0,2,9,17
2/19/1981,4,0,2,2,8
2/20/1981,5,0,6,1,12
2/21/1981,8,0,5,11,24
2/22/1981,12,0,4,9,25
2/23/1981,9,0,9,10,28
2/24/1981,10,0,7,3,20
2/25/1981,7,0,2,8,17
2/26/1981,5,0,4,0,9
2/27/1981,5,0,9,11,25
2/28/1981,4,0,5,3,12
3/1/1981,4,0,9,7,20
3/2/1981,5,0,6,1,12
3/3/1981,11,0,8,9,28
3/4/1981,9,0,4,5,18
3/5/1981,9,0,6,1,16
3/6/1981,6,0,7,4,17
3/7/1981,11,0,7,8,26
3/8/1981,8,0,4,8,20
3/9/1981,8,0,3,11,22
3/10/1981,10,0,7,3,20
3/11/1981,7,0,4,0,11
3/12/1981,8,0,10,1,19
3/13/1981,10,0,2,8,20
3/14/1981,7,0,2,0,9
3/15/1981,9,0,8,8,25
3/16/1981,6,0,3,3,12
3/17/1981,6,0,7,10,23
3/18/1981,9,0,9,10,28
3/19/1981,12,0,6,7,25
3/20/1981,9,0,3,2,14
3/21/1981,9,0,8,4,21
3/22/1981,4,0,7,0,11
3/23/1981,11,0,10,7,28
3/24/1981,5,0,8,5,18
3/25/1981,4,0,4,1,9
3/26/1981,10,0,7,10,27
3/27/1981,10,0,5,0,15
3/28/1981,5,0,9,6,20
3/29/1981,6,0,8,5,19
3/30/1981,6,0,9,9,24
3/31/1981,8,0,2,1,11
4/1/1981,7,0,4,11,22
4/2/1981,5,0,5,5,15
4/3/1981,11,0,4,11,26
4/4/1981,5,0,3,1,9
4/5/1981,10,0,3,0,13
4/6/1981,7,0,9,11,27
4/7/1981,5,0,9,5,19
4/8/1981,12,0,8,6,26
4/9/1981,12,0,4,3,19
4/10/1981,6,0,8,8,22
4/11/1981,11,0,5,2,18
4/12/1981,4,0,3,5,12
4/13/1981,4,0,8,1,13
4/14/1981,6,0,5,8,19
4/15/1981,11,0,5,9,25
4/16/1981,7,0,10,11,28
4/17/1981,7,0,5,6,18
4/18/1981,12,0,3,6,21
4/19/1981,10,0,8,5,23
4/20/1981,12,0,9,7,28
4/21/1981,12,0,6,6,24
4/22/1981,11,0,6,1,18
4/23/1981,6,0,5,5,16
4/24/1981,11,0,3,3,17
4/25/1981,5,0,4,3,12
4/26/1981,8,0,6,2,16
4/27/1981,6,0,7,8,21
4/28/1981,7,0,6,6,19
4/29/1981,5,0,9,1,15
4/30/1981,7,0,8,11,26
5/1/1981,12,0,8,10,30
5/2/1981,10,0,5,9,24
5/3/1981,12,0,4,9,25
5/4/1981,7,0,3,2,12
5/5/1981,7,0,8,8,23
5/6/1981,10,0,5,0,15
5/7/1981,6,0,5,0,11
5/8/1981,9,0,6,8,23
5/9/1981,10,0,8,10,28
5/10/1981,4,0,10,7,21
5/11/1981,4,0,9,7,20
5/12/1981,5,0,4,7,16
5/13/1981,10,0,7,10,27
5/14/1981,8,0,8,2,18
5/15/1981,9,0,5,4,18
5/16/1981,7,0,5,10,22
5/17/1981,11,0,9,4,24
5/18/1981,7,0,7,5,19
5/19/1981,5,0,10,9,24
5/20/1981,8,0,6,2,16
5/21/1981,5,0,6,2,13
5/22/1981,11,0,7,7,25
5/23/1981,4,0,2,3,9
5/24/1981,6,0,4,1,11
5/25/1981,9,0,4,6,19
5/26/1981,9,0,3,4,16
5/27/1981,4,0,7,11,22
5/28/1981,11,0,4,8,23
5/29/1981,7,0,4,9,20
5/30/1981,8,0,7,3,18
5/31/1981,11,0,5,11,27
6/1/1981,11,0,5,5,21
6/2/1981,11,0,8,0,19
6/3/1981,8,0,5,5,18
6/4/1981,8,0,8,2,18
6/5/1981,8,0,4,6,18
6/6/1981,12,0,2,6,20
6/7/1981,4,0,5,4,13
6/8/1981,7,0,2,10,19
6/9/1981,6,0,5,6,17
6/10/1981,9,0,10,2,21
6/11/1981,5,0,4,6,15
6/12/1981,5,0,2,9,16
6/13/1981,9,0,2,6,17
6/14/1981,7,0,8,3,18
6/15/1981,7,0,10,10,27
6/16/1981,5,0,6,5,16
6/17/1981,4,0,3,3,10
6/18/1981,5,0,5,11,21
6/19/1981,10,0,6,7,23
6/20/1981,6,0,6,5,17
6/21/1981,5,0,5,2,12
6/22/1981,11,0,8,9,28
6/23/1981,9,0,8,4,21
6/24/1981,4,0,10,5,19
6/25/1981,6,0,10,9,25
6/26/1981,4,0,6,6,16
6/27/1981,12,0,10,3,25
6/28/1981,6,0,4,0,10
6/29/1981,4,0,10,8,22
6/30/1981,10,0,4,5,19
7/1/1981,5,0,6,11,22
7/2/1981,7,0,9,8,24
7/3/1981,5,0,5,11,21
7/4/1981,5,0,9,10,24
7/5/1981,11,0,8,0,19
7/6/1981,10,0,5,0,15
7/7/1981,8,0,3,8,19
7/8/1981,5,0,7,4,16
7/9/1981,7,0,8,3,18
7/10/1981,12,0,10,2,24
7/11/1981,9,0,8,6,23
7/12/1981,9,0,7,7,23
7/13/1981,6,0,9,8,23
7/14/1981,7,0,3,9,19
7/15/1981,6,0,3,1,10
7/16/1981,12,0,4,10,26
7/17/1981,7,0,10,6,23
7/18/1981,11,0,5,9,25
7/19/1981,6,0,2,4,12
7/20/1981,7,0,6,7,20
7/21/1981,4,0,2,6,12
7/22/1981,6,0,3,5,14
7/23/1981,10,0,7,1,18
7/24/1981,9,0,9,8,26
7/25/1981,4,0,10,7,21
7/26/1981,9,0,3,2,14
7/27/1981,9,0,2,7,18
7/28/1981,9,0,5,7,21
7/29/1981,8,0,2,6,16
7/30/1981,4,0,8,5,17
7/31/1981,11,0,5,1,17
8/1/1981,8,0,7,2,17
8/2/1981,10,0,2,1,13
8/3/1981,4,0,6,9,19
8/4/1981,5,0,4,1,10
8/5/1981,6,0,3,0,9
8/6/1981,5,0,9,7,21
8/7/1981,7,0,8,1,16
8/8/1981,4,0,6,1,11
8/9/1981,4,0,8,4,16
8/10/1981,4,0,7,4,15
8/11/1981,11,0,7,4,22
8/12/1981,8,0,2,7,17
8/13/1981,6,0,3,8,17
8/14/1981,6,0,3,2,11
8/15/1981,11,0,7,10,28
8/16/1981,11,0,3,2,16
8/17/1981,11,0,7,11,29
8/18/1981,6,0,3,9,18
8/19/1981,11,0,2,2,15
8/20/1981,10,0,7,7,24
8/21/1981,5,0,8,6,19
8/22/1981,11,0,6,2,19
8/23/1981,5,0,9,11,25
8/24/1981,11,0,2,9,22
8/25/1981,12,0,2,2,16
8/26/1981,11,0,4,2,17
8/27/1981,12,0,3,6,21
8/28/1981,11,0,4,4,19
8/29/1981,11,0,5,10,26
8/30/1981,11,0,6,4,21
8/31/1981,9,0,10,6,25
9/1/1981,5,0,6,0,11
9/2/1981,7,0,6,11,24
9/3/1981,7,0,9,2,18
9/4/1981,11,0,2,8,21
9/5/1981,12,0,2,7,21
9/6/1981,7,0,9,11,27
9/7/1981,10,0,7,8,25
9/8/1981,6,0,4,9,19
9/9/1981,9,0,3,9,21
9/10/1981,11,0,8,8,27
9/11/1981,12,0,2,1,15
9/12/1981,9,0,5,1,15
9/13/1981,8,0,9,8,25
9/14/1981,7,0,9,6,22
9/15/1981,9,0,7,11,27
9/16/1981,5,0,8,9,22
9/17/1981,8,0,2,11,21
9/18/1981,6,0,2,1,9
9/19/1981,12,0,7,10,29
9/20/1981,6,0,7,6,19
9/21/1981,5,0,7,7,19
9/22/1981,11,0,2,0,13
9/23/1981,7,0,4,10,21
9/24/1981,8,0,9,8,25
9/25/1981,5,0,6,2,13
9/26/1981,5,0,2,5,12
9/27/1981,6,0,8,4,18
9/28/1981,4,0,3,7,14
9/29/1981,12,0,3,3,18
9/30/1981,10,0,7,8,25
10/1/1981,10,0,10,2,22
10/2/1981,11,0,6,1,18
10/3/1981,7,0,8,7,22
10/4/1981,9,0,3,2,14
10/5/1981,6,0,4,9,19
10/6/1981,6,0,3,11,20
10/7/1981,11,0,8,7,26
10/8/1981,6,0,7,2,15
10/9/1981,5,0,3,1,9
10/10/1981,6,0,7,11,24
10/11/1981,11,0,2,6,19
10/12/1981,7,0,4,3,14
10/13/1981,11,0,6,4,21
10/14/1981,4,0,9,7,20
10/15/1981,7,0,6,4,17
10/16/1981,10,0,8,1,19
10/17/1981,8,0,9,2,19
10/18/1981,11,0,9,5,25
10/19/1981,4,0,6,2,12
10/20/1981,7,0,6,1,14
10/21/1981,4,0,5,8,17
10/22/1981,6,0,2,4,12
10/23/1981,6,0,3,9,18
10/24/1981,8,0,8,5,21
10/25/1981,8,0,8,6,22
10/26/1981,5,0,8,5,18
10/27/1981,10,0,6,6,22
10/28/1981,10,0,5,4,19
10/29/1981,11,0,10,9,30
10/30/1981,9,0,4,7,20
10/31/1981,12,0,2,11,25
11/1/1981,9,0,7,9,25
11/2/1981,12,0,9,0,21
11/3/1981,11,0,4,0,15
11/4/1981,4,0,2,3,9
11/5/1981,6,0,4,7,17
11/6/1981,4,0,10,3,17
11/7/1981,8,0,3,4,15
11/8/1981,12,0,4,4,20
11/9/1981,6,0,4,7,17
11/10/1981,9,0,9,11,29
11/11/1981,11,0,10,0,21
11/12/1981,5,0,8,6,19
11/13/1981,11,0,4,6,21
11/14/1981,5,0,5,0,10
11/15/1981,7,0,3,6,16
11/16/1981,5,0,10,1,16
11/17/1981,11,0,2,7,20
11/18/1981,7,0,3,2,12
11/19/1981,6,0,2,4,12
11/20/1981,5,0,9,9,23
11/21/1981,5,0,6,7,18
11/22/1981,7,0,2,5,14
11/23/1981,11,0,9,10,30
11/24/1981,8,0,3,0,11
11/25/1981,12,0,6,10,28
11/26/1981,11,0,2,6,19
11/27/1981,9,0,9,0,18
11/28/1981,9,0,7,0,16
11/29/1981,6,0,3,2,11
11/30/1981,11,0,10,1,22
12/1/1981,4,0,3,3,10
12/2/1981,9,0,5,4,18
12/3/1981,12,0,9,2,23
12/4/1981,4,0,6,3,13
12/5/1981,12,0,6,9,27
12/6/1981,6,0,9,5,20
12/7/1981,5,0,9,4,18
12/8/1981,12,0,9,4,25
12/9/1981,8,0,7,4,19
12/10/1981,12,0,8,7,27
12/11/1981,4,0,3,10,17
12/12/1981,11,0,9,10,30
12/13/1981,8,0,3,2,13
12/14/1981,11,0,2,5,18
12/15/1981,8,0,3,5,16
12/16/1981,6,0,3,4,13
12/17/1981,6,0,8,5,19
12/18/1981,11,0,10,2,23
12/19/1981,9,0,8,11,28
12/20/1981,8,0,8,2,18
12/21/1981,4,0,9,10,23
12/22/1981,7,0,8,3,18
12/23/1981,11,0,3,9,23
12/24/1981,11,0,5,4,20
12/25/1981,7,0,5,0,12
12/26/1981,9,0,2,7,18
12/27/1981,12,0,3,10,25
12/28/1981,5,0,9,7,21
12/29/1981,5,0,2,8,15
12/30/1981,4,0,5,5,14
12/31/1981,8,0,9,0,17
1/1/1982,8,0,7,7,22
1/2/1982,4,0,4,8,16
1/3/1982,5,0,4,1,10
1/4/1982,12,0,2,7,21
1/5/1982,5,0,7,2,14
1/6/1982,6,0,9,10,25
1/7/1982,11,0,5,10,26
1/8/1982,4,0,5,7,16
1/9/1982,8,0,10,5,23
1/10/1982,4,0,7,6,17
1/11/1982,9,0,9,6,24
1/12/1982,4,0,3,11,18
1/13/1982,8,0,8,7,23
1/14/1982,10,0,2,10,22
1/15/1982,8,0,3,5,16
1/16/1982,8,0,5,0,13
1/17/1982,12,0,3,6,21
1/18/1982,4,0,3,8,15
1/19/1982,7,0,6,9,22
1/20/1982,7,0,3,10,20
1/21/1982,10,0,4,9,23
1/22/1982,10,0,7,9,26
1/23/1982,8,0,4,0,12
1/24/1982,10,0,9,7,26
1/25/1982,5,0,2,11,18
1/26/1982,12,0,8,8,28
1/27/1982,7,0,5,10,22
1/28/1982,7,0,6,3,16
1/29/1982,7,0,6,11,24
1/30/1982,12,0,9,7,28
1/31/1982,7,0,5,10,22
2/1/1982,4,0,10,8,22
2/2/1982,6,0,6,5,17
2/3/1982,9,0,8,9,26
2/4/1982,11,0,6,6,23
2/5/1982,11,0,2,11,24
2/6/1982,9,0,3,9,21
2/7/1982,9,0,3,10,22
2/8/1982,5,0,2,4,11
2/9/1982,12,0,6,7,25
2/10/1982,6,0,8,10,24
2/11/1982,11,0,10,8,29
2/12/1982,9,0,4,5,18
2/13/1982,12,0,6,8,26
2/14/1982,4,0,5,11,20
2/15/1982,6,0,10,4,20
2/16/1982,9,0,10,4,23
2/17/1982,7,0,8,6,21
2/18/1982,7,0,7,8,22
2/19/1982,9,0,4,6,19
2/20/1982,10,0,6,6,22
2/21/1982,4,0,5,9,18
2/22/1982,8,0,2,4,14
2/23/1982,11,0,3,2,16
2/24/1982,10,0,9,11,30
2/25/1982,7,0,10,9,26
2/26/1982,4,0,6,6,16
2/27/1982,5,0,4,3,12
2/28/1982,10,0,7,4,21
3/1/1982,11,0,8,2,21
3/2/1982,6,0,2,8,16
3/3/1982,5,0,2,0,7
3/4/1982,4,0,3,10,17
3/5/1982,11,0,8,4,23
3/6/1982,9,0,2,10,21
3/7/1982,9,0,2,1,12
3/8/1982,11,0,4,1,16
3/9/1982,5,0,9,5,19
3/10/1982,8,0,8,1,17
3/11/1982,5,0,7,1,13
3/12/1982,11,0,5,6,22
3/13/1982,10,0,8,8,26
3/14/1982,6,0,5,11,22
3/15/1982,6,0,3,3,12
3/16/1982,9,0,5,9,23
3/17/1982,5,0,4,0,9
3/18/1982,8,0,10,9,27
3/19/1982,9,0,10,7,26
3/20/1982,10,0,3,10,23
3/21/1982,11,0,4,4,19
3/22/1982,7,0,7,8,22
3/23/1982,10,0,10,11,31
3/24/1982,10,0,10,4,24
3/25/1982,5,0,2,6,13
3/26/1982,11,0,10,1,22
3/27/1982,10,0,10,3,23
3/28/1982,4,0,6,6,16
3/29/1982,8,0,8,5,21
3/30/1982,10,0,9,4,23
3/31/1982,11,0,8,5,24
4/1/1982,10,0,6,5,21
4/2/1982,9,0,5,5,19
4/3/1982,7,0,5,7,19
4/4/1982,5,0,2,7,14
4/5/1982,5,0,8,4,17
4/6/1982,6,0,9,10,25
4/7/1982,5,0,2,2,9
4/8/1982,7,0,5,4,16
4/9/1982,10,0,2,0,12
4/10/1982,12,0,3,11,26
4/11/1982,10,0,2,2,14
4/12/1982,4,0,7,10,21
4/13/1982,10,0,3,3,16
4/14/1982,4,0,7,7,18
4/15/1982,5,0,4,11,20
4/16/1982,12,0,5,7,24
4/17/1982,7,0,5,2,14
4/18/1982,9,0,8,7,24
4/19/1982,6,0,5,5,16
4/20/1982,5,0,3,3,11
4/21/1982,10,0,2,11,23
4/22/1982,10,0,6,7,23
4/23/1982,8,0,3,3,14
4/24/1982,7,0,4,6,17
4/25/1982,7,0,7,3,17
4/26/1982,7,0,7,11,25
4/27/1982,6,0,4,3,13
4/28/1982,4,0,8,10,22
4/29/1982,7,0,4,5,16
4/30/1982,8,0,3,2,13
5/1/1982,7,0,5,1,13
5/2/1982,5,0,5,11,21
5/3/1982,9,0,8,11,28
5/4/1982,4,0,6,4,14
5/5/1982,4,0,5,9,18
5/6/1982,6,0,4,0,10
5/7/1982,9,0,8,11,28
5/8/1982,9,0,7,8,24
5/9/1982,4,0,2,11,17
5/10/1982,8,0,5,6,19
5/11/1982,10,0,5,4,19
5/12/1982,11,0,8,4,23
5/13/1982,11,0,4,11,26
5/14/1982,12,0,6,3,21
5/15/1982,12,0,10,10,32
5/16/1982,7,0,4,11,22
5/17/1982,11,0,2,7,20
5/18/1982,12,0,3,1,16
5/19/1982,4,0,8,4,16
5/20/1982,8,0,5,4,17
5/21/1982,5,0,4,3,12
5/22/1982,6,0,10,7,23
5/23/1982,4,0,9,11,24
5/24/1982,8,0,8,0,16
5/25/1982,11,0,7,4,22
5/26/1982,11,0,2,5,18
5/27/1982,7,0,10,5,22
5/28/1982,12,0,5,5,22
5/29/1982,4,0,7,0,11
5/30/1982,7,0,4,5,16
5/31/1982,9,0,6,5,20
6/1/1982,10,0,2,10,22
6/2/1982,6,0,2,5,13
6/3/1982,9,0,5,4,18
6/4/1982,11,0,10,3,24
6/5/1982,7,0,3,7,17
6/6/1982,9,0,2,3,14
6/7/1982,6,0,2,11,19
6/8/1982,8,0,2,11,21
6/9/1982,4,0,3,10,17
6/10/1982,9,0,4,0,13
6/11/1982,7,0,6,0,13
6/12/1982,9,0,2,2,13
6/13/1982,6,0,10,1,17
6/14/1982,12,0,8,10,30
6/15/1982,6,0,4,1,11
6/16/1982,5,0,7,8,20
6/17/1982,4,0,2,3,9
6/18/1982,5,0,2,7,14
6/19/1982,7,0,9,4,20
6/20/1982,6,0,9,7,22
6/21/1982,5,0,4,6,15
6/22/1982,10,0,8,2,20
6/23/1982,12,0,2,8,22
6/24/1982,4,0,2,7,13
6/25/1982,5,0,5,2,12
6/26/1982,4,0,9,1,14
6/27/1982,12,0,10,8,30
6/28/1982,8,0,4,9,21
6/29/1982,12,0,8,11,31
6/30/1982,4,0,9,0,13
7/1/1982,12,0,4,3,19
7/2/1982,8,0,10,4,22
7/3/1982,9,0,9,5,23
7/4/1982,4,0,2,2,8
7/5/1982,7,0,2,11,20
7/6/1982,8,0,4,9,21
7/7/1982,4,0,2,4,10
7/8/1982,12,0,10,1,23
7/9/1982,9,0,2,9,20
7/10/1982,11,0,9,6,26
7/11/1982,11,0,7,6,24
7/12/1982,10,0,6,10,26
7/13/1982,12,0,7,3,22
7/14/1982,12,0,7,5,24
7/15/1982,11,0,3,8,22
7/16/1982,8,0,4,2,14
7/17/1982,10,0,7,4,21
7/18/1982,7,0,10,1,18
7/19/1982,4,0,5,3,12
7/20/1982,9,0,4,10,23
7/21/1982,8,0,7,1,16
7/22/1982,4,0,8,7,19
7/23/1982,11,0,3,1,15
7/24/1982,11,0,8,4,23
7/25/1982,5,0,3,6,14
7/26/1982,4,0,8,7,19
7/27/1982,7,0,2,3,12
7/28/1982,9,0,9,9,27
7/29/1982,10,0,10,2,22
7/30/1982,8,0,5,9,22
7/31/1982,11,0,3,6,20
8/1/1982,10,0,10,8,28
8/2/1982,8,0,2,6,16
8/3/1982,12,0,10,10,32
8/4/1982,7,0,5,6,18
8/5/1982,7,0,2,9,18
8/6/1982,7,0,2,2,11
8/7/1982,5,0,9,10,24
8/8/1982,12,0,9,6,27
8/9/1982,6,0,4,8,18
8/10/1982,7,0,6,4,17
8/11/1982,10,0,3,4,17
8/12/1982,10,0,2,9,21
8/13/1982,5,0,10,7,22
8/14/1982,12,0,8,0,20
8/15/1982,10,0,5,5,20
8/16/1982,6,0,6,0,12
8/17/1982,7,0,10,3,20
8/18/1982,12,0,5,11,28
8/19/1982,5,0,6,4,15
8/20/1982,4,0,2,7,13
8/21/1982,10,0,6,6,22
8/22/1982,10,0,2,6,18
8/23/1982,7,0,10,3,20
8/24/1982,4,0,9,5,18
8/25/1982,12,0,4,4,20
8/26/1982,9,0,3,11,23
8/27/1982,10,0,5,11,26
8/28/1982,11,0,2,3,16
8/29/1982,6,0,2,9,17
8/30/1982,12,0,9,9,30
8/31/1982,4,0,9,4,17
9/1/1982,8,0,3,7,18
9/2/1982,8,0,7,4,19
9/3/1982,7,0,6,10,23
9/4/1982,9,0,3,1,13
9/5/1982,12,0,9,6,27
9/6/1982,4,0,2,1,7
9/7/1982,10,0,8,7,25
9/8/1982,4,0,5,0,9
9/9/1982,12,0,10,7,29
9/10/1982,12,0,10,1,23
9/11/1982,9,0,2,6,17
9/12/1982,7,0,2,2,11
9/13/1982,11,0,8,7,26
9/14/1982,6,0,4,6,16
9/15/1982,10,0,6,4,20
9/16/1982,6,0,8,6,20
9/17/1982,12,0,6,5,23
9/18/1982,9,0,10,2,21
9/19/1982,5,0,8,7,20
9/20/1982,5,0,2,1,8
9/21/1982,7,0,10,6,23
9/22/1982,6,0,8,0,14
9/23/1982,5,0,7,2,14
9/24/1982,8,0,6,3,17
9/25/1982,8,0,7,9,24
9/26/1982,6,0,10,0,16
9/27/1982,9,0,3,2,14
9/28/1982,6,0,9,0,15
9/29/1982,10,0,10,0,20
9/30/1982,4,0,10,11,25
10/1/1982,6,0,9,0,15
10/2/1982,12,0,3,0,15
10/3/1982,6,0,3,5,14
10/4/1982,6,0,3,11,20
10/5/1982,7,0,6,9,22
10/6/1982,12,0,10,8,30
10/7/1982,10,0,5,9,24
10/8/1982,8,0,9,0,17
10/9/1982,10,0,5,11,26
10/10/1982,9,0,10,2,21
10/11/1982,6,0,8,9,23
10/12/1982,7,0,9,8,24
10/13/1982,11,0,2,4,17
10/14/1982,6,0,2,9,17
10/15/1982,4,0,9,0,13
10/16/1982,5,0,5,5,15
10/17/1982,8,0,8,6,22
10/18/1982,4,0,6,7,17
10/19/1982,6,0,10,9,25
10/20/1982,9,0,5,2,16
10/21/1982,12,0,3,10,25
10/22/1982,7,0,2,6,15
10/23/1982,5,0,5,9,19
10/24/1982,5,0,5,9,19
10/25/1982,7,0,8,10,25
10/26/1982,8,0,9,2,19
10/27/1982,6,0,2,1,9
10/28/1982,12,0,8,7,27
10/29/1982,8,0,5,0,13
10/30/1982,10,0,10,11,31
10/31/1982,9,0,10,3,22
11/1/1982,6,0,7,0,13
11/2/1982,4,0,3,1,8
11/3/1982,11,0,10,11,32
11/4/1982,9,0,10,9,28
11/5/1982,8,0,8,1,17
11/6/1982,10,0,7,7,24
11/7/1982,8,0,3,11,22
11/8/1982,8,0,6,1,15
11/9/1982,10,0,9,9,28
11/10/1982,8,0,2,1,11
11/11/1982,5,0,6,11,22
11/12/1982,8,0,3,1,12
11/13/1982,7,0,5,10,22
11/14/1982,4,0,6,9,19
11/15/1982,11,0,6,9,26
11/16/1982,10,0,8,5,23
11/17/1982,7,0,8,3,18
11/18/1982,11,0,4,11,26
11/19/1982,10,0,7,7,24
11/20/1982,12,0,10,6,28
11/21/1982,7,0,6,3,16
11/22/1982,6,0,10,1,17
11/23/1982,10,0,10,0,20
11/24/1982,8,0,3,6,17
11/25/1982,5,0,5,6,16
11/26/1982,11,0,4,11,26
11/27/1982,10,0,5,7,22
11/28/1982,12,0,2,9,23
11/29/1982,10,0,7,2,19
11/30/1982,10,0,6,10,26
12/1/1982,6,0,6,1,13
12/2/1982,10,0,10,5,25
12/3/1982,5,0,9,11,25
12/4/1982,5,0,6,10,21
12/5/1982,4,0,3,5,12
12/6/1982,8,0,10,9,27
12/7/1982,9,0,9,9,27
12/8/1982,9,0,9,8,26
12/9/1982,8,0,4,11,23
12/10/1982,11,0,10,9,30
12/11/1982,9,0,2,7,18
12/12/1982,10,0,8,9,27
12/13/1982,12,0,6,9,27
12/14/1982,10,0,9,1,20
12/15/1982,6,0,2,10,18
12/16/1982,10,0,9,8,27
12/17/1982,6,0,9,7,22
12/18/1982,7,0,9,5,21
12/19/1982,8,0,7,11,26
12/20/1982,11,0,8,5,24
12/21/1982,12,0,7,5,24
12/22/1982,9,0,7,10,26
12/23/1982,8,0,5,3,16
12/24/1982,10,0,2,9,21
12/25/1982,5,0,9,9,23
12/26/1982,12,0,7,10,29
12/27/1982,12,0,8,2,22
12/28/1982,12,0,3,2,17
12/29/1982,5,0,6,6,17
12/30/1982,6,0,5,3,14
12/31/1982,6,0,10,7,23
1/1/1983,6,0,2,5,13
1/2/1983,6,0,4,7,17
1/3/1983,10,0,8,7,25
1/4/1983,5,0,7,11,23
1/5/1983,8,0,3,0,11
1/6/1983,12,0,4,11,27
1/7/1983,12,0,6,5,23
1/8/1983,5,0,10,3,18
1/9/1983,8,0,7,6,21
1/10/1983,8,0,7,2,17
1/11/1983,6,0,2,6,14
1/12/1983,6,0,5,3,14
1/13/1983,10,0,7,4,21
1/14/1983,5,0,9,8,22
1/15/1983,6,0,8,11,25
1/16/1983,4,0,10,10,24
1/17/1983,5,0,10,1,16
1/18/1983,10,0,5,1,16
1/19/1983,8,0,9,4,21
1/20/1983,11,0,8,8,27
1/21/1983,12,0,8,10,30
1/22/1983,9,0,4,11,24
1/23/1983,4,0,4,11,19
1/24/1983,11,0,8,3,22
1/25/1983,6,0,9,7,22
1/26/1983,10,0,10,8,28
1/27/1983,6,0,3,10,19
1/28/1983,4,0,2,11,17
1/29/1983,6,0,3,5,14
1/30/1983,4,0,8,5,17
1/31/1983,6,0,8,8,22
2/1/1983,11,0,5,5,21
2/2/1983,10,0,7,9,26
2/3/1983,12,0,5,9,26
2/4/1983,12,0,8,10,30
2/5/1983,7,0,6,7,20
2/6/1983,4,0,8,8,20
2/7/1983,8,0,7,9,24
2/8/1983,4,0,6,1,11
2/9/1983,10,0,5,5,20
2/10/1983,9,0,8,11,28
2/11/1983,10,0,8,9,27
2/12/1983,7,0,5,1,13
2/13/1983,11,0,5,6,22
2/14/1983,5,0,8,10,23
2/15/1983,12,0,6,8,26
2/16/1983,9,0,6,10,25
2/17/1983,6,0,5,0,11
2/18/1983,7,0,10,4,21
2/19/1983,11,0,10,5,26
2/20/1983,7,0,8,8,23
2/21/1983,4,0,4,4,12
2/22/1983,8,0,2,3,13
2/23/1983,5,0,2,1,8
2/24/1983,6,0,10,0,16
2/25/1983,5,0,4,7,16
2/26/1983,5,0,2,10,17
2/27/1983,12,0,6,2,20
2/28/1983,11,0,10,5,26
3/1/1983,4,0,7,2,13
3/2/1983,10,0,8,7,25
3/3/1983,4,0,7,7,18
3/4/1983,5,0,9,4,18
3/5/1983,12,0,2,4,18
3/6/1983,12,0,3,9,24
3/7/1983,5,0,2,6,13
3/8/1983,6,0,3,8,17
3/9/1983,11,0,5,2,18
3/10/1983,12,0,2,3,17
3/11/1983,5,0,5,10,20
3/12/1983,12,0,10,8,30
3/13/1983,12,0,3,11,26
3/14/1983,12,0,4,2,18
3/15/1983,11,0,5,8,24
3/16/1983,6,0,9,11,26
3/17/1983,7,0,5,8,20
3/18/1983,4,0,10,5,19
3/19/1983,4,0,5,7,16
3/20/1983,5,0,2,8,15
3/21/1983,9,0,8,9,26
3/22/1983,4,0,3,8,15
3/23/1983,7,0,8,0,15
3/24/1983,7,0,10,9,26
3/25/1983,6,0,7,4,17
3/26/1983,4,0,7,10,21
3/27/1983,5,0,8,7,20
3/28/1983,4,0,4,2,10
3/29/1983,4,0,10,9,23
3/30/1983,10,0,8,5,23
3/31/1983,7,0,7,4,18
4/1/1983,8,0,9,1,18
4/2/1983,6,0,4,5,15
4/3/1983,6,0,5,11,22
4/4/1983,5,0,6,7,18
4/5/1983,12,0,10,10,32
4/6/1983,8,0,7,5,20
4/7/1983,9,0,7,2,18
4/8/1983,12,0,4,3,19
4/9/1983,4,0,8,3,15
4/10/1983,11,0,6,8,25
4/11/1983,11,0,7,9,27
4/12/1983,4,0,2,7,13
4/13/1983,7,0,10,5,22
4/14/1983,8,0,2,0,10
4/15/1983,7,0,8,2,17
4/16/1983,5,0,5,11,21
4/17/1983,7,0,4,0,11
4/18/1983,12,0,5,7,24
4/19/1983,9,0,7,4,20
4/20/1983,7,0,4,11,22
4/21/1983,9,0,5,3,17
4/22/1983,5,0,2,5,12
4/23/1983,12,0,2,11,25
4/24/1983,7,0,8,11,26
4/25/1983,4,0,2,2,8
4/26/1983,7,0,2,3,12
4/27/1983,5,0,6,5,16
4/28/1983,9,0,9,0,18
4/29/1983,5,0,9,8,22
4/30/1983,7,0,10,2,19
5/1/1983,12,0,5,7,24
5/2/1983,7,0,5,0,12
5/3/1983,8,0,10,2,20
5/4/1983,11,0,8,2,21
5/5/1983,8,0,8,9,25
5/6/1983,7,0,6,0,13
5/7/1983,8,0,10,11,29
5/8/1983,6,0,2,6,14
5/9/1983,5,0,5,1,11
5/10/1983,10,0,5,11,26
5/11/1983,9,0,2,10,21
5/12/1983,11,0,4,11,26
5/13/1983,5,0,10,2,17
5/14/1983,7,0,2,6,15
5/15/1983,7,0,2,8,17
5/16/1983,12,0,10,7,29
5/17/1983,7,0,6,2,15
5/18/1983,9,0,8,7,24
5/19/1983,8,0,6,7,21
5/20/1983,11,0,2,11,24
5/21/1983,6,0,8,4,18
5/22/1983,8,0,4,6,18
5/23/1983,10,0,3,2,15
5/24/1983,10,0,10,5,25
5/25/1983,11,0,6,8,25
5/26/1983,5,0,8,4,17
5/27/1983,6,0,3,5,14
5/28/1983,11,0,8,4,23
5/29/1983,11,0,9,10,30
5/30/1983,11,0,3,8,22
5/31/1983,8,0,6,9,23
6/1/1983,9,0,9,11,29
6/2/1983,9,0,5,1,15
6/3/1983,9,0,10,1,20
6/4/1983,8,0,6,11,25
6/5/1983,9,0,5,4,18
6/6/1983,7,0,4,10,21
6/7/1983,6,0,9,5,20
6/8/1983,7,0,7,0,14
6/9/1983,10,0,7,7,24
6/10/1983,9,0,8,5,22
6/11/1983,8,0,6,11,25
6/12/1983,10,0,5,4,19
6/13/1983,7,0,10,2,19
6/14/1983,7,0,10,2,19
6/15/1983,8,0,3,5,16
6/16/1983,12,0,5,4,21
6/17/1983,9,0,9,4,22
6/18/1983,10,0,10,8,28
6/19/1983,6,0,2,9,17
6/20/1983,6,0,6,4,16
6/21/1983,6,0,5,2,13
6/22/1983,9,0,5,8,22
6/23/1983,9,0,4,10,23
6/24/1983,7,0,8,9,24
6/25/1983,5,0,3,11,19
6/26/1983,12,0,6,3,21
6/27/1983,6,0,3,4,13
6/28/1983,5,0,2,1,8
6/29/1983,9,0,3,10,22
6/30/1983,9,0,6,9,24
7/1/1983,8,0,6,1,15
7/2/1983,7,0,5,7,19
7/3/1983,5,0,7,3,15
7/4/1983,9,0,5,8,22
7/5/1983,8,0,3,2,13
7/6/1983,7,0,5,11,23
7/7/1983,11,0,5,1,17
7/8/1983,11,0,10,10,31
7/9/1983,4,0,10,4,18
7/10/1983,6,0,10,7,23
7/11/1983,4,0,9,11,24
7/12/1983,12,0,2,4,18
7/13/1983,4,0,9,2,15
7/14/1983,7,0,5,10,22
7/15/1983,6,0,5,0,11
7/16/1983,5,0,10,0,15
7/17/1983,6,0,6,3,15
7/18/1983,6,0,10,11,27
7/19/1983,11,0,8,9,28
7/20/1983,4,0,10,9,23
7/21/1983,12,0,3,1,16
7/22/1983,10,0,8,8,26
7/23/1983,12,0,4,2,18
7/24/1983,7,0,5,10,22
7/25/1983,8,0,7,2,17
7/26/1983,9,0,10,8,27
7/27/1983,9,0,6,7,22
7/28/1983,12,0,10,10,32
7/29/1983,9,0,10,10,29
7/30/1983,11,0,6,6,23
7/31/1983,6,0,5,6,17
8/1/1983,12,0,2,4,18
8/2/1983,11,0,10,8,29
8/3/1983,9,0,7,4,20
8/4/1983,4,0,5,9,18
8/5/1983,8,0,8,1,17
8/6/1983,4,0,6,7,17
8/7/1983,11,0,3,9,23
8/8/1983,12,0,3,10,25
8/9/1983,11,0,10,11,32
8/10/1983,5,0,10,5,20
8/11/1983,12,0,5,9,26
8/12/1983,6,0,8,4,18
8/13/1983,8,0,5,5,18
8/14/1983,10,0,3,10,23
8/15/1983,9,0,8,7,24
8/16/1983,8,0,6,5,19
8/17/1983,10,0,5,8,23
8/18/1983,12,0,5,3,20
8/19/1983,7,0,9,11,27
8/20/1983,9,0,5,5,19
8/21/1983,8,0,8,10,26
8/22/1983,12,0,9,10,31
8/23/1983,5,0,3,0,8
8/24/1983,7,0,5,4,16
8/25/1983,11,0,8,1,20
8/26/1983,5,0,6,4,15
8/27/1983,9,0,10,1,20
8/28/1983,11,0,6,2,19
8/29/1983,6,0,3,3,12
8/30/1983,5,0,3,11,19
8/31/1983,12,0,7,0,19
9/1/1983,7,0,6,5,18
9/2/1983,6,0,3,10,19
9/3/1983,10,0,7,9,26
9/4/1983,12,0,6,2,20
9/5/1983,4,0,10,5,19
9/6/1983,8,0,9,6,23
9/7/1983,4,0,2,3,9
9/8/1983,11,0,7,4,22
9/9/1983,6,0,4,1,11
9/10/1983,9,0,7,5,21
9/11/1983,6,0,8,8,22
9/12/1983,11,0,8,7,26
9/13/1983,7,0,7,5,19
9/14/1983,7,0,2,2,11
9/15/1983,4,0,9,5,18
9/16/1983,8,0,4,6,18
9/17/1983,8,0,4,5,17
9/18/1983,4,0,2,9,15
9/19/1983,8,0,5,4,17
9/20/1983,9,0,2,5,16
9/21/1983,5,0,2,6,13
9/22/1983,12,0,3,0,15
9/23/1983,10,0,3,6,19
9/24/1983,12,0,7,4,23
9/25/1983,5,0,7,9,21
9/26/1983,10,0,4,10,24
9/27/1983,8,0,6,1,15
9/28/1983,11,0,8,4,23
9/29/1983,12,0,3,0,15
9/30/1983,10,0,6,11,27
10/1/1983,4,0,8,5,17
10/2/1983,10,0,6,7,23
10/3/1983,5,0,7,9,21
10/4/1983,4,0,5,8,17
10/5/1983,5,0,3,10,18
10/6/1983,7,0,6,11,24
10/7/1983,7,0,10,6,23
10/8/1983,4,0,2,7,13
10/9/1983,6,0,10,9,25
10/10/1983,11,0,8,4,23
10/11/1983,6,0,2,1,9
10/12/1983,10,0,9,11,30
10/13/1983,9,0,2,6,17
10/14/1983,5,0,3,3,11
10/15/1983,12,0,7,9,28
10/16/1983,10,0,10,7,27
10/17/1983,11,0,9,4,24
10/18/1983,8,0,7,10,25
10/19/1983,11,0,6,2,19
10/20/1983,11,0,8,7,26
10/21/1983,8,0,10,9,27
10/22/1983,11,0,3,2,16
10/23/1983,7,0,8,0,15
10/24/1983,5,0,3,5,13
10/25/1983,8,0,9,7,24
10/26/1983,9,0,7,11,27
10/27/1983,6,0,8,3,17
10/28/1983,6,0,9,1,16
10/29/1983,6,0,10,1,17
10/30/1983,5,0,3,4,12
10/31/1983,4,0,4,5,13
11/1/1983,7,0,2,10,19
11/2/1983,8,0,8,0,16
11/3/1983,5,0,5,10,20
11/4/1983,7,0,9,4,20
11/5/1983,12,0,8,6,26
11/6/1983,11,0,6,10,27
11/7/1983,6,0,5,2,13
11/8/1983,4,0,4,5,13
11/9/1983,12,0,4,11,27
11/10/1983,4,0,4,0,8
11/11/1983,8,0,4,11,23
11/12/1983,8,0,4,11,23
11/13/1983,10,0,5,0,15
11/14/1983,7,0,3,0,10
11/15/1983,8,0,6,5,19
11/16/1983,4,0,4,3,11
11/17/1983,7,0,4,9,20
11/18/1983,8,0,9,2,19
11/19/1983,12,0,4,1,17
11/20/1983,10,0,2,1,13
11/21/1983,10,0,5,0,15
11/22/1983,4,0,5,7,16
11/23/1983,5,0,5,8,18
11/24/1983,6,0,9,11,26
11/25/1983,12,0,7,0,19
11/26/1983,5,0,10,4,19
11/27/1983,9,0,4,8,21
11/28/1983,9,0,7,4,20
11/29/1983,8,0,8,9,25
11/30/1983,7,0,2,6,15
12/1/1983,9,0,9,7,25
12/2/1983,9,0,8,5,22
12/3/1983,10,0,5,0,15
12/4/1983,9,0,5,9,23
12/5/1983,11,0,3,10,24
12/6/1983,4,0,10,9,23
12/7/1983,6,0,5,7,18
12/8/1983,12,0,8,8,28
12/9/1983,12,0,4,5,21
12/10/1983,4,0,8,6,18
12/11/1983,6,0,7,1,14
12/12/1983,10,0,3,8,21
12/13/1983,6,0,9,11,26
12/14/1983,10,0,2,2,14
12/15/1983,9,0,5,1,15
12/16/1983,8,0,2,6,16
12/17/1983,7,0,2,6,15
12/18/1983,12,0,3,3,18
12/19/1983,5,0,4,7,16
12/20/1983,12,0,4,9,25
12/21/1983,9,0,2,7,18
12/22/1983,6,0,4,11,21
12/23/1983,10,0,3,2,15
12/24/1983,6,0,3,10,19
12/25/1983,6,0,10,10,26
12/26/1983,9,0,7,2,18
12/27/1983,6,0,4,4,14
12/28/1983,5,0,10,10,25
12/29/1983,9,0,4,9,22
12/30/1983,7,0,7,9,23
12/31/1983,7,0,10,2,19
1/1/1984,12,0,6,3,21
1/2/1984,7,0,5,9,21
1/3/1984,7,0,3,10,20
1/4/1984,12,0,9,11,32
1/5/1984,9,0,6,1,16
1/6/1984,11,0,6,0,17
1/7/1984,12,0,2,11,25
1/8/1984,11,0,10,0,21
1/9/1984,4,0,8,9,21
1/10/1984,11,0,10,10,31
1/11/1984,4,0,7,8,19
1/12/1984,11,0,8,4,23
1/13/1984,7,0,10,10,27
1/14/1984,4,0,5,3,12
1/15/1984,4,0,3,5,12
1/16/1984,12,0,5,9,26
1/17/1984,11,0,7,6,24
1/18/1984,7,0,6,8,21
1/19/1984,11,0,9,1,21
1/20/1984,11,0,6,3,20
1/21/1984,11,0,6,6,23
1/22/1984,8,0,8,5,21
1/23/1984,9,0,10,1,20
1/24/1984,6,0,7,1,14
1/25/1984,7,0,2,9,18
1/26/1984,7,0,5,1,13
1/27/1984,5,0,2,5,12
1/28/1984,12,0,7,0,19
1/29/1984,6,0,2,2,10
1/30/1984,8,0,3,6,17
1/31/1984,7,0,9,7,23
2/1/1984,10,0,7,6,23
2/2/1984,4,0,2,6,12
2/3/1984,4,0,6,5,15
2/4/1984,12,0,4,8,24
2/5/1984,10,0,6,3,19
2/6/1984,12,0,8,7,27
2/7/1984,6,0,10,6,22
2/8/1984,7,0,10,4,21
2/9/1984,6,0,3,6,15
2/10/1984,11,0,4,10,25
2/11/1984,11,0,5,10,26
2/12/1984,8,0,9,6,23
2/13/1984,6,0,2,7,15
2/14/1984,11,0,8,1,20
2/15/1984,11,0,10,6,27
2/16/1984,9,0,4,2,15
2/17/1984,8,0,9,7,24
2/18/1984,4,0,8,11,23
2/19/1984,7,0,7,5,19
2/20/1984,8,0,8,6,22
2/21/1984,10,0,8,2,20
2/22/1984,7,0,5,11,23
2/23/1984,8,0,6,5,19
2/24/1984,6,0,2,3,11
2/25/1984,7,0,10,7,24
2/26/1984,6,0,4,11,21
2/27/1984,7,0,9,5,21
2/28/1984,8,0,6,3,17
2/29/1984,7,0,7,0,14
3/1/1984,6,0,8,6,20
3/2/1984,8,0,9,9,26
3/3/1984,9,0,7,5,21
3/4/1984,12,0,8,11,31
3/5/1984,10,0,5,1,16
3/6/1984,10,0,2,8,20
3/7/1984,10,0,5,0,15
3/8/1984,8,0,9,11,28
3/9/1984,11,0,4,9,24
3/10/1984,10,0,3,6,19
3/11/1984,6,0,4,8,18
3/12/1984,11,0,6,4,21
3/13/1984,9,0,9,7,25
3/14/1984,8,0,3,1,12
3/15/1984,10,0,2,5,17
3/16/1984,10,0,10,0,20
3/17/1984,9,0,8,7,24
3/18/1984,7,0,5,7,19
3/19/1984,4,0,9,2,15
3/20/1984,10,0,7,7,24
3/21/1984,10,0,7,11,28
3/22/1984,4,0,5,7,16
3/23/1984,12,0,7,4,23
3/24/1984,5,0,9,0,14
3/25/1984,5,0,9,7,21
3/26/1984,11,0,5,9,25
3/27/1984,10,0,4,4,18
3/28/1984,10,0,9,5,24
3/29/1984,10,0,2,0,12
3/30/1984,12,0,6,10,28
3/31/1984,7,0,2,0,9
4/1/1984,7,0,5,9,21
4/2/1984,6,0,4,9,19
4/3/1984,5,0,4,4,13
4/4/1984,7,0,5,9,21
4/5/1984,4,0,3,7,14
4/6/1984,5,0,4,5,14
4/7/1984,5,0,10,3,18
4/8/1984,8,0,9,1,18
4/9/1984,4,0,3,3,10
4/10/1984,5,0,5,8,18
4/11/1984,4,0,6,3,13
4/12/1984,9,0,10,11,30
4/13/1984,10,0,10,4,24
4/14/1984,7,0,9,6,22
4/15/1984,7,0,6,10,23
4/16/1984,6,0,3,6,15
4/17/1984,12,0,6,6,24
4/18/1984,6,0,5,4,15
4/19/1984,5,0,9,10,24
4/20/1984,8,0,7,0,15
4/21/1984,5,0,5,6,16
4/22/1984,11,0,5,10,26
4/23/1984,10,0,5,3,18
4/24/1984,4,0,10,5,19
4/25/1984,8,0,10,10,28
4/26/1984,12,0,4,0,16
4/27/1984,11,0,10,11,32
4/28/1984,11,0,7,1,19
4/29/1984,7,0,7,8,22
4/30/1984,9,0,8,4,21
5/1/1984,5,0,7,11,23
5/2/1984,8,0,2,9,19
5/3/1984,5,0,6,7,18
5/4/1984,10,0,9,10,29
5/5/1984,11,0,4,9,24
5/6/1984,9,0,2,8,19
5/7/1984,12,0,5,3,20
5/8/1984,12,0,2,9,23
5/9/1984,7,0,4,1,12
5/10/1984,8,0,6,2,16
5/11/1984,5,0,5,11,21
5/12/1984,5,0,2,4,11
5/13/1984,10,0,2,7,19
5/14/1984,11,0,6,9,26
5/15/1984,5,0,6,2,13
5/16/1984,10,0,8,4,22
5/17/1984,4,0,2,5,11
5/18/1984,12,0,5,3,20
5/19/1984,7,0,4,5,16
5/20/1984,7,0,2,1,10
5/21/1984,5,0,10,8,23
5/22/1984,10,0,2,11,23
5/23/1984,10,0,7,3,20
5/24/1984,8,0,3,5,16
5/25/1984,6,0,7,7,20
5/26/1984,7,0,10,9,26
5/27/1984,7,0,8,7,22
5/28/1984,4,0,8,9,21
5/29/1984,10,0,3,8,21
5/30/1984,12,0,10,2,24
5/31/1984,4,0,6,3,13
6/1/1984,10,0,2,9,21
6/2/1984,7,0,6,5,18
6/3/1984,4,0,10,8,22
6/4/1984,4,0,9,8,21
6/5/1984,7,0,9,3,19
6/6/1984,7,0,8,7,22
6/7/1984,10,0,5,2,17
6/8/1984,12,0,6,1,19
6/9/1984,6,0,10,1,17
6/10/1984,4,0,5,6,15
6/11/1984,10,0,8,11,29
6/12/1984,4,0,7,10,21
6/13/1984,4,0,2,11,17
6/14/1984,12,0,5,0,17
6/15/1984,8,0,9,6,23
6/16/1984,7,0,4,5,16
6/17/1984,6,0,10,9,25
6/18/1984,11,0,10,2,23
6/19/1984,10,0,2,5,17
6/20/1984,8,0,4,0,12
6/21/1984,12,0,2,10,24
6/22/1984,12,0,2,2,16
6/23/1984,6,0,4,9,19
6/24/1984,12,0,4,6,22
6/25/1984,5,0,9,1,15
6/26/1984,10,0,9,3,22
6/27/1984,11,0,5,3,19
6/28/1984,9,0,9,9,27
6/29/1984,9,0,3,3,15
6/30/1984,5,0,8,5,18
7/1/1984,7,0,9,7,23
7/2/1984,5,0,2,5,12
7/3/1984,5,0,3,2,10
7/4/1984,8,0,7,8,23
7/5/1984,8,0,8,2,18
7/6/1984,10,0,7,11,28
7/7/1984,4,0,10,2,16
7/8/1984,11,0,3,9,23
7/9/1984,9,0,6,8,23
7/10/1984,11,0,8,10,29
7/11/1984,8,0,9,0,17
7/12/1984,7,0,3,9,19
7/13/1984,10,0,10,9,29
7/14/1984,7,0,4,3,14
7/15/1984,10,0,4,4,18
7/16/1984,7,0,2,8,17
7/17/1984,4,0,10,1,15
7/18/1984,12,0,5,2,19
7/19/1984,8,0,8,3,19
7/20/1984,11,0,2,0,13
7/21/1984,7,0,9,6,22
7/22/1984,6,0,4,7,17
7/23/1984,5,0,3,2,10
7/24/1984,10,0,9,3,22
7/25/1984,11,0,7,4,22
7/26/1984,7,0,2,6,15
7/27/1984,5,0,6,7,18
7/28/1984,8,0,7,11,26
7/29/1984,7,0,9,8,24
7/30/1984,9,0,2,9,20
7/31/1984,5,0,4,3,12
8/1/1984,12,0,7,2,21
8/2/1984,10,0,6,6,22
8/3/1984,5,0,7,6,18
8/4/1984,12,0,6,2,20
8/5/1984,8,0,7,5,20
8/6/1984,11,0,4,2,17
8/7/1984,9,0,4,2,15
8/8/1984,10,0,6,2,18
8/9/1984,4,0,9,9,22
8/10/1984,10,0,6,5,21
8/11/1984,8,0,10,11,29
8/12/1984,11,0,5,2,18
8/13/1984,10,0,4,5,19
8/14/1984,6,0,10,5,21
8/15/1984,4,0,3,4,11
8/16/1984,9,0,7,2,18
8/17/1984,11,0,4,1,16
8/18/1984,11,0,9,2,22
8/19/1984,10,0,7,6,23
8/20/1984,7,0,8,9,24
8/21/1984,7,0,7,9,23
8/22/1984,11,0,7,9,27
8/23/1984,10,0,6,6,22
8/24/1984,9,0,6,5,20
8/25/1984,11,0,2,2,15
8/26/1984,6,0,2,1,9
8/27/1984,5,0,7,11,23
8/28/1984,11,0,2,3,16
8/29/1984,8,0,3,8,19
8/30/1984,10,0,4,7,21
8/31/1984,9,0,9,1,19
9/1/1984,5,0,6,8,19
9/2/1984,7,0,10,1,18
9/3/1984,12,0,8,6,26
9/4/1984,11,0,2,2,15
9/5/1984,4,0,3,9,16
9/6/1984,12,0,9,10,31
9/7/1984,7,0,8,0,15
9/8/1984,9,0,10,9,28
9/9/1984,7,0,4,5,16
9/10/1984,4,0,8,10,22
9/11/1984,4,0,4,2,10
9/12/1984,12,0,6,4,22
9/13/1984,12,0,9,1,22
9/14/1984,12,0,5,11,28
9/15/1984,12,0,5,8,25
9/16/1984,9,0,4,2,15
9/17/1984,12,0,9,7,28
9/18/1984,5,0,5,4,14
9/19/1984,8,0,3,8,19
9/20/1984,9,0,4,10,23
9/21/1984,4,0,4,10,18
9/22/1984,12,0,8,2,22
9/23/1984,12,0,3,10,25
9/24/1984,12,0,3,0,15
9/25/1984,5,0,5,5,15
9/26/1984,12,0,5,5,22
9/27/1984,9,0,10,3,22
9/28/1984,8,0,3,0,11
9/29/1984,9,0,6,4,19
9/30/1984,12,0,4,0,16
10/1/1984,5,0,7,2,14
10/2/1984,12,0,9,8,29
10/3/1984,6,0,10,3,19
10/4/1984,12,0,2,1,15
10/5/1984,11,0,7,1,19
10/6/1984,5,0,9,6,20
10/7/1984,8,0,5,10,23
10/8/1984,9,0,9,11,29
10/9/1984,8,0,3,5,16
10/10/1984,11,0,6,7,24
10/11/1984,10,0,2,7,19
10/12/1984,8,0,4,10,22
10/13/1984,7,0,4,9,20
10/14/1984,7,0,10,8,25
10/15/1984,4,0,7,0,11
10/16/1984,12,0,4,11,27
10/17/1984,11,0,5,11,27
10/18/1984,6,0,7,9,22
10/19/1984,4,0,7,10,21
10/20/1984,8,0,2,6,16
10/21/1984,11,0,10,7,28
10/22/1984,6,0,3,3,12
10/23/1984,6,0,8,11,25
10/24/1984,9,0,9,0,18
10/25/1984,9,0,3,10,22
10/26/1984,6,0,4,3,13
10/27/1984,9,0,10,11,30
10/28/1984,7,0,3,9,19
10/29/1984,10,0,7,0,17
10/30/1984,12,0,10,8,30
10/31/1984,5,0,3,2,10
11/1/1984,9,0,7,2,18
11/2/1984,12,0,5,7,24
11/3/1984,7,0,10,5,22
11/4/1984,5,0,10,10,25
11/5/1984,12,0,3,0,15
11/6/1984,7,0,2,7,16
11/7/1984,7,0,7,1,15
11/8/1984,11,0,4,1,16
11/9/1984,8,0,5,7,20
11/10/1984,8,0,7,10,25
11/11/1984,5,0,10,8,23
11/12/1984,5,0,4,3,12
11/13/1984,11,0,10,0,21
11/14/1984,7,0,8,4,19
11/15/1984,5,0,5,4,14
11/16/1984,4,0,10,6,20
11/17/1984,7,0,8,1,16
11/18/1984,10,0,4,0,14
11/19/1984,7,0,6,3,16
11/20/1984,9,0,7,3,19
11/21/1984,6,0,5,10,21
11/22/1984,10,0,6,6,22
11/23/1984,12,0,6,8,26
11/24/1984,7,0,4,4,15
11/25/1984,9,0,10,8,27
11/26/1984,10,0,5,6,21
11/27/1984,5,0,9,8,22
11/28/1984,6,0,2,4,12
11/29/1984,8,0,4,0,12
11/30/1984,12,0,6,4,22
12/1/1984,6,0,5,10,21
12/2/1984,11,0,10,0,21
12/3/1984,4,0,9,7,20
12/4/1984,10,0,3,4,17
12/5/1984,12,0,2,9,23
12/6/1984,4,0,7,2,13
12/7/1984,10,0,2,4,16
12/8/1984,9,0,8,3,20
12/9/1984,12,0,2,0,14
12/10/1984,10,0,7,10,27
12/11/1984,12,0,9,8,29
12/12/1984,12,0,4,9,25
12/13/1984,8,0,10,0,18
12/14/1984,10,0,5,0,15
12/15/1984,4,0,9,1,14
12/16/1984,10,0,4,5,19
12/17/1984,10,0,5,3,18
12/18/1984,10,0,8,10,28
12/19/1984,9,0,4,0,13
12/20/1984,7,0,8,8,23
12/21/1984,11,0,10,1,22
12/22/1984,9,0,8,6,23
12/23/1984,6,0,2,4,12
12/24/1984,5,0,10,11,26
12/25/1984,7,0,9,4,20
12/26/1984,10,0,4,4,18
12/27/1984,9,0,4,5,18
12/28/1984,6,0,9,7,22
12/29/1984,7,0,3,8,18
12/30/1984,12,0,8,3,23
12/31/1984,6,0,4,3,13
1/1/1985,8,0,6,0,14
1/2/1985,10,0,10,2,22
1/3/1985,10,0,5,6,21
1/4/1985,5,0,2,7,14
1/5/1985,11,0,8,10,29
1/6/1985,5,0,3,8,16
1/7/1985,10,0,8,3,21
1/8/1985,11,0,5,9,25
1/9/1985,4,0,3,5,12
1/10/1985,6,0,7,10,23
1/11/1985,5,0,10,4,19
1/12/1985,4,0,9,10,23
1/13/1985,8,0,2,4,14
1/14/1985,5,0,3,10,18
1/15/1985,8,0,3,4,15
1/16/1985,5,0,2,1,8
1/17/1985,11,0,7,1,19
1/18/1985,10,0,2,9,21
1/19/1985,12,0,5,9,26
1/20/1985,5,0,4,11,20
1/21/1985,9,0,2,0,11
1/22/1985,6,0,9,3,18
1/23/1985,12,0,7,0,19
1/24/1985,8,0,2,1,11
1/25/1985,8,0,7,3,18
1/26/1985,6,0,3,7,16
1/27/1985,11,0,10,8,29
1/28/1985,4,0,6,10,20
1/29/1985,4,0,3,4,11
1/30/1985,9,0,3,6,18
1/31/1985,7,0,3,0,10
2/1/1985,10,0,8,8,26
2/2/1985,4,0,6,8,18
2/3/1985,7,0,8,3,18
2/4/1985,11,0,9,4,24
2/5/1985,8,0,6,2,16
2/6/1985,11,0,8,5,24
2/7/1985,9,0,10,3,22
2/8/1985,9,0,7,9,25
2/9/1985,4,0,4,6,14
2/10/1985,5,0,3,1,9
2/11/1985,10,0,6,5,21
2/12/1985,5,0,2,0,7
2/13/1985,5,0,9,10,24
2/14/1985,10,0,3,11,24
2/15/1985,12,0,9,2,23
2/16/1985,10,0,10,10,30
2/17/1985,12,0,3,2,17
2/18/1985,8,0,2,10,20
2/19/1985,4,0,8,1,13
2/20/1985,10,0,5,3,18
2/21/1985,9,0,3,10,22
2/22/1985,8,0,6,10,24
2/23/1985,12,0,9,6,27
2/24/1985,9,0,5,7,21
2/25/1985,7,0,10,5,22
2/26/1985,12,0,6,0,18
2/27/1985,10,0,4,5,19
2/28/1985,11,0,4,5,20
3/1/1985,11,0,7,6,24
3/2/1985,4,0,2,6,12
3/3/1985,4,0,2,10,16
3/4/1985,11,0,2,2,15
3/5/1985,10,0,6,3,19
3/6/1985,6,0,3,4,13
3/7/1985,4,0,5,7,16
3/8/1985,5,0,8,6,19
3/9/1985,7,0,9,6,22
3/10/1985,9,0,10,10,29
3/11/1985,4,0,6,3,13
3/12/1985,7,0,10,2,19
3/13/1985,10,0,6,1,17
3/14/1985,8,0,5,10,23
3/15/1985,10,0,10,3,23
3/16/1985,8,0,9,1,18
3/17/1985,12,0,5,7,24
3/18/1985,8,0,2,9,19
3/19/1985,5,0,9,10,24
3/20/1985,12,0,5,4,21
3/21/1985,11,0,6,3,20
3/22/1985,4,0,3,2,9
3/23/1985,8,0,2,1,11
3/24/1985,5,0,2,3,10
3/25/1985,7,0,2,8,17
3/26/1985,9,0,6,7,22
3/27/1985,5,0,10,9,24
3/28/1985,10,0,5,11,26
3/29/1985,12,0,10,11,33
3/30/1985,8,0,2,7,17
3/31/1985,9,0,9,9,27
4/1/1985,12,0,3,8,23
4/2/1985,9,0,10,11,30
4/3/1985,9,0,9,5,23
4/4/1985,4,0,6,10,20
4/5/1985,7,0,8,1,16
4/6/1985,4,0,2,0,6
4/7/1985,6,0,10,2,18
4/8/1985,10,0,3,11,24
4/9/1985,10,0,10,3,23
4/10/1985,10,0,7,4,21
4/11/1985,7,0,4,11,22
4/12/1985,8,0,6,3,17
4/13/1985,10,0,5,5,20
4/14/1985,11,0,2,8,21
4/15/1985,7,0,9,4,20
4/16/1985,8,0,8,4,20
4/17/1985,6,0,6,7,19
4/18/1985,7,0,10,3,20
4/19/1985,11,0,6,3,20
4/20/1985,7,0,9,8,24
4/21/1985,11,0,3,10,24
4/22/1985,5,0,4,2,11
4/23/1985,10,0,2,8,20
4/24/1985,8,0,3,9,20
4/25/1985,7,0,8,1,16
4/26/1985,7,0,9,1,17
4/27/1985,7,0,9,0,16
4/28/1985,9,0,10,8,27
4/29/1985,9,0,5,11,25
4/30/1985,6,0,10,1,17
5/1/1985,7,0,7,7,21
5/2/1985,10,0,7,0,17
5/3/1985,10,0,4,8,22
5/4/1985,8,0,2,7,17
5/5/1985,9,0,7,3,19
5/6/1985,7,0,6,0,13
5/7/1985,6,0,9,7,22
5/8/1985,7,0,2,6,15
5/9/1985,5,0,10,9,24
5/10/1985,11,0,9,1,21
5/11/1985,12,0,2,3,17
5/12/1985,10,0,3,1,14
5/13/1985,4,0,10,6,20
5/14/1985,5,0,8,9,22
5/15/1985,9,0,2,0,11
5/16/1985,12,0,2,3,17
5/17/1985,4,0,6,7,17
5/18/1985,8,0,8,2,18
5/19/1985,12,0,7,7,26
5/20/1985,6,0,2,11,19
5/21/1985,8,0,5,7,20
5/22/1985,8,0,6,3,17
5/23/1985,6,0,7,6,19
5/24/1985,9,0,8,8,25
5/25/1985,11,0,6,2,19
5/26/1985,9,0,10,10,29
5/27/1985,9,0,6,11,26
5/28/1985,9,0,4,0,13
5/29/1985,7,0,7,10,24
5/30/1985,10,0,6,3,19
5/31/1985,11,0,6,3,20
6/1/1985,4,0,3,6,13
6/2/1985,11,0,8,7,26
6/3/1985,9,0,8,0,17
6/4/1985,9,0,7,9,25
6/5/1985,5,0,6,0,11
6/6/1985,4,0,2,11,17
6/7/1985,9,0,2,10,21
6/8/1985,4,0,7,5,16
6/9/1985,11,0,7,9,27
6/10/1985,12,0,6,4,22
6/11/1985,12,0,9,1,22
6/12/1985,6,0,10,10,26
6/13/1985,10,0,8,9,27
6/14/1985,10,0,5,4,19
6/15/1985,9,0,10,0,19
6/16/1985,5,0,8,6,19
6/17/1985,10,0,3,11,24
6/18/1985,8,0,3,5,16
6/19/1985,7,0,5,1,13
6/20/1985,11,0,10,6,27
6/21/1985,4,0,8,11,23
6/22/1985,4,0,5,7,16
6/23/1985,10,0,9,0,19
6/24/1985,7,0,9,5,21
6/25/1985,9,0,7,0,16
6/26/1985,6,0,5,6,17
6/27/1985,12,0,9,6,27
6/28/1985,6,0,5,6,17
6/29/1985,4,0,4,0,8
6/30/1985,8,0,6,9,23
7/1/1985,4,0,7,3,14
7/2/1985,10,0,6,11,27
7/3/1985,8,0,2,5,15
7/4/1985,5,0,5,1,11
7/5/1985,6,0,4,3,13
7/6/1985,11,0,3,8,22
7/7/1985,9,0,4,0,13
7/8/1985,8,0,4,0,12
7/9/1985,5,0,2,9,16
7/10/1985,4,0,7,5,16
7/11/1985,6,0,5,11,22
7/12/1985,6,0,8,0,14
7/13/1985,8,0,4,8,20
7/14/1985,11,0,4,2,17
7/15/1985,7,0,9,10,26
7/16/1985,11,0,7,3,21
7/17/1985,8,0,2,3,13
7/18/1985,4,0,3,5,12
7/19/1985,4,0,5,9,18
7/20/1985,8,0,3,5,16
7/21/1985,12,0,6,3,21
7/22/1985,12,0,10,3,25
7/23/1985,10,0,8,10,28
7/24/1985,9,0,9,5,23
7/25/1985,9,0,5,3,17
7/26/1985,7,0,2,4,13
7/27/1985,8,0,2,6,16
7/28/1985,9,0,2,7,18
7/29/1985,4,0,10,11,25
7/30/1985,10,0,9,5,24
7/31/1985,10,0,4,0,14
8/1/1985,12,0,6,9,27
8/2/1985,11,0,10,10,31
8/3/1985,12,0,3,7,22
8/4/1985,10,0,2,6,18
8/5/1985,8,0,2,2,12
8/6/1985,7,0,7,11,25
8/7/1985,4,0,4,0,8
8/8/1985,4,0,5,2,11
8/9/1985,9,0,7,6,22
8/10/1985,8,0,3,5,16
8/11/1985,7,0,8,4,19
8/12/1985,12,0,5,7,24
8/13/1985,6,0,3,4,13
8/14/1985,5,0,8,2,15
8/15/1985,7,0,10,6,23
8/16/1985,5,0,4,1,10
8/17/1985,12,0,4,11,27
8/18/1985,6,0,4,2,12
8/19/1985,5,0,8,10,23
8/20/1985,5,0,8,5,18
8/21/1985,11,0,8,6,25
8/22/1985,4,0,4,8,16
8/23/1985,10,0,2,0,12
8/24/1985,8,0,5,5,18
8/25/1985,11,0,2,7,20
8/26/1985,4,0,7,2,13
8/27/1985,7,0,7,5,19
8/28/1985,4,0,8,10,22
8/29/1985,5,0,9,10,24
8/30/1985,10,0,5,4,19
8/31/1985,10,0,6,5,21
9/1/1985,11,0,6,2,19
9/2/1985,9,0,8,4,21
9/3/1985,4,0,5,5,14
9/4/1985,7,0,2,0,9
9/5/1985,8,0,8,0,16
9/6/1985,12,0,4,5,21
9/7/1985,5,0,7,0,12
9/8/1985,12,0,5,1,18
9/9/1985,8,0,5,4,17
9/10/1985,5,0,6,5,16
9/11/1985,10,0,3,3,16
9/12/1985,7,0,10,8,25
9/13/1985,11,0,9,8,28
9/14/1985,12,0,2,7,21
9/15/1985,12,0,4,9,25
9/16/1985,11,0,4,8,23
9/17/1985,9,0,6,3,18
9/18/1985,5,0,4,5,14
9/19/1985,11,0,3,10,24
9/20/1985,9,0,2,5,16
9/21/1985,8,0,7,9,24
9/22/1985,5,0,7,7,19
9/23/1985,5,0,4,0,9
9/24/1985,10,0,2,8,20
9/25/1985,11,0,3,4,18
9/26/1985,4,0,5,8,17
9/27/1985,7,0,4,11,22
9/28/1985,12,0,2,2,16
9/29/1985,8,0,9,10,27
9/30/1985,8,0,7,1,16
10/1/1985,12,0,9,8,29
10/2/1985,10,0,6,2,18
10/3/1985,10,0,5,7,22
10/4/1985,7,0,5,3,15
10/5/1985,8,0,5,2,15
10/6/1985,8,0,4,2,14
10/7/1985,12,0,3,5,20
10/8/1985,9,0,6,5,20
10/9/1985,4,0,5,4,13
10/10/1985,6,0,7,6,19
10/11/1985,7,0,3,3,13
10/12/1985,12,0,2,10,24
10/13/1985,8,0,9,2,19
10/14/1985,7,0,9,5,21
10/15/1985,6,0,5,6,17
10/16/1985,5,0,9,9,23
10/17/1985,7,0,4,3,14
10/18/1985,12,0,6,7,25
10/19/1985,5,0,9,11,25
10/20/1985,5,0,6,5,16
10/21/1985,6,0,7,11,24
10/22/1985,6,0,2,3,11
10/23/1985,9,0,2,1,12
10/24/1985,11,0,7,2,20
10/25/1985,8,0,7,5,20
10/26/1985,12,0,3,2,17
10/27/1985,4,0,8,9,21
10/28/1985,5,0,8,2,15
10/29/1985,12,0,3,6,21
10/30/1985,5,0,8,0,13
10/31/1985,4,0,8,10,22
11/1/1985,12,0,6,10,28
11/2/1985,10,0,9,4,23
11/3/1985,12,0,10,0,22
11/4/1985,6,0,2,1,9
11/5/1985,8,0,10,0,18
11/6/1985,10,0,3,3,16
11/7/1985,12,0,10,11,33
11/8/1985,5,0,2,4,11
11/9/1985,12,0,8,0,20
11/10/1985,12,0,8,4,24
11/11/1985,8,0,5,0,13
11/12/1985,12,0,8,7,27
11/13/1985,8,0,10,10,28
11/14/1985,7,0,5,3,15
11/15/1985,7,0,10,5,22
11/16/1985,8,0,8,6,22
11/17/1985,9,0,7,2,18
11/18/1985,6,0,4,0,10
11/19/1985,6,0,3,1,10
11/20/1985,8,0,2,8,18
11/21/1985,4,0,9,2,15
11/22/1985,9,0,4,4,17
11/23/1985,6,0,3,6,15
11/24/1985,10,0,9,3,22
11/25/1985,10,0,8,7,25
11/26/1985,4,0,5,4,13
11/27/1985,5,0,8,10,23
11/28/1985,10,0,6,4,20
11/29/1985,10,0,8,6,24
11/30/1985,7,0,5,0,12
12/1/1985,12,0,9,11,32
12/2/1985,11,0,9,11,31
12/3/1985,9,0,2,7,18
12/4/1985,10,0,4,1,15
12/5/1985,5,0,7,6,18
12/6/1985,4,0,3,0,7
12/7/1985,5,0,9,3,17
12/8/1985,9,0,3,8,20
12/9/1985,10,0,6,11,27
12/10/1985,6,0,9,11,26
12/11/1985,8,0,2,1,11
12/12/1985,11,0,7,5,23
12/13/1985,7,0,6,8,21
12/14/1985,4,0,10,0,14
12/15/1985,9,0,9,2,20
12/16/1985,9,0,10,7,26
12/17/1985,6,0,2,0,8
12/18/1985,5,0,3,7,15
12/19/1985,7,0,9,8,24
12/20/1985,4,0,5,0,9
12/21/1985,6,0,8,7,21
12/22/1985,9,0,8,8,25
12/23/1985,10,0,10,6,26
12/24/1985,7,0,8,1,16
12/25/1985,4,0,2,2,8
12/26/1985,4,0,2,5,11
12/27/1985,5,0,7,8,20
12/28/1985,4,0,7,2,13
12/29/1985,11,0,9,2,22
12/30/1985,4,0,2,3,9
12/31/1985,9,0,7,0,16
1/1/1986,10,0,3,0,13
1/2/1986,9,0,3,7,19
1/3/1986,6,0,6,2,14
1/4/1986,6,0,5,6,17
1/5/1986,5,0,6,6,17
1/6/1986,4,0,7,3,14
1/7/1986,7,0,10,0,17
1/8/1986,12,0,2,7,21
1/9/1986,11,0,7,6,24
1/10/1986,6,0,5,7,18
1/11/1986,9,0,10,7,26
1/12/1986,12,0,8,0,20
1/13/1986,6,0,5,8,19
1/14/1986,10,0,9,8,27
1/15/1986,7,0,4,3,14
1/16/1986,8,0,2,1,11
1/17/1986,12,0,7,10,29
1/18/1986,6,0,6,1,13
1/19/1986,9,0,4,10,23
1/20/1986,10,0,8,6,24
1/21/1986,9,0,9,5,23
1/22/1986,9,0,4,2,15
1/23/1986,9,0,3,0,12
1/24/1986,6,0,9,6,21
1/25/1986,4,0,6,0,10
1/26/1986,5,0,2,2,9
1/27/1986,12,0,6,11,29
1/28/1986,5,0,7,1,13
1/29/1986,6,0,9,11,26
1/30/1986,8,0,4,2,14
1/31/1986,8,0,5,0,13
2/1/1986,7,0,4,8,19
2/2/1986,5,0,3,0,8
2/3/1986,4,0,5,0,9
2/4/1986,10,0,9,1,20
2/5/1986,6,0,9,5,20
2/6/1986,5,0,2,2,9
2/7/1986,7,0,10,4,21
2/8/1986,11,0,9,1,21
2/9/1986,6,0,7,10,23
2/10/1986,7,0,7,7,21
2/11/1986,8,0,5,10,23
2/12/1986,9,0,9,8,26
2/13/1986,5,0,4,7,16
2/14/1986,4,0,6,6,16
2/15/1986,9,0,2,0,11
2/16/1986,4,0,5,11,20
2/17/1986,12,0,6,7,25
2/18/1986,5,0,5,0,10
2/19/1986,12,0,6,8,26
2/20/1986,5,0,4,4,13
2/21/1986,5,0,10,4,19
2/22/1986,7,0,9,2,18
2/23/1986,8,0,5,6,19
2/24/1986,10,0,8,1,19
2/25/1986,10,0,8,0,18
2/26/1986,11,0,9,0,20
2/27/1986,10,0,3,6,19
2/28/1986,4,0,10,5,19
3/1/1986,12,0,7,7,26
3/2/1986,5,0,10,5,20
3/3/1986,9,0,2,9,20
3/4/1986,4,0,3,1,8
3/5/1986,7,0,3,1,11
3/6/1986,9,0,2,1,12
3/7/1986,11,0,2,4,17
3/8/1986,12,0,9,0,21
3/9/1986,12,0,2,3,17
3/10/1986,7,0,7,3,17
3/11/1986,5,0,7,9,21
3/12/1986,5,0,6,6,17
3/13/1986,8,0,10,0,18
3/14/1986,5,0,5,4,14
3/15/1986,7,0,8,8,23
3/16/1986,11,0,4,6,21
3/17/1986,10,0,4,4,18
3/18/1986,7,0,9,3,19
3/19/1986,12,0,4,4,20
3/20/1986,7,0,7,2,16
3/21/1986,6,0,3,9,18
3/22/1986,10,0,7,2,19
3/23/1986,7,0,7,6,20
3/24/1986,9,0,5,8,22
3/25/1986,11,0,9,11,31
3/26/1986,9,0,9,4,22
3/27/1986,10,0,3,3,16
3/28/1986,8,0,7,11,26
3/29/1986,11,0,5,4,20
3/30/1986,7,0,8,2,17
3/31/1986,11,0,10,0,21
4/1/1986,6,0,10,8,24
4/2/1986,4,0,10,8,22
4/3/1986,6,0,7,5,18
4/4/1986,7,0,9,7,23
4/5/1986,6,0,2,3,11
4/6/1986,7,0,7,5,19
4/7/1986,5,0,8,7,20
4/8/1986,5,0,3,0,8
4/9/1986,12,0,6,0,18
4/10/1986,11,0,10,8,29
4/11/1986,6,0,6,2,14
4/12/1986,5,0,2,1,8
4/13/1986,5,0,9,3,17
4/14/1986,5,0,3,7,15
4/15/1986,7,0,5,0,12
4/16/1986,10,0,3,1,14
4/17/1986,5,0,4,4,13
4/18/1986,10,0,2,7,19
4/19/1986,9,0,7,10,26
4/20/1986,6,0,6,4,16
4/21/1986,12,0,8,8,28
4/22/1986,9,0,10,5,24
4/23/1986,7,0,3,1,11
4/24/1986,6,0,5,4,15
4/25/1986,6,0,10,8,24
4/26/1986,4,0,10,3,17
4/27/1986,4,0,5,8,17
4/28/1986,11,0,7,0,18
4/29/1986,11,0,2,1,14
4/30/1986,6,0,7,7,20
5/1/1986,6,0,7,11,24
5/2/1986,4,0,8,1,13
5/3/1986,6,0,6,1,13
5/4/1986,10,0,10,8,28
5/5/1986,8,0,10,9,27
5/6/1986,8,0,4,3,15
5/7/1986,5,0,9,10,24
5/8/1986,4,0,6,4,14
5/9/1986,12,0,4,10,26
5/10/1986,10,0,9,11,30
5/11/1986,9,0,4,4,17
5/12/1986,9,0,2,3,14
5/13/1986,4,0,2,1,7
5/14/1986,4,0,10,6,20
5/15/1986,7,0,5,3,15
5/16/1986,7,0,7,2,16
5/17/1986,10,0,10,10,30
5/18/1986,5,0,4,4,13
5/19/1986,7,0,7,6,20
5/20/1986,7,0,9,6,22
5/21/1986,11,0,7,10,28
5/22/1986,4,0,8,1,13
5/23/1986,9,0,8,2,19
5/24/1986,12,0,2,0,14
5/25/1986,12,0,7,3,22
5/26/1986,11,0,10,9,30
5/27/1986,11,0,4,0,15
5/28/1986,9,0,2,11,22
5/29/1986,10,0,5,2,17
5/30/1986,6,0,3,6,15
5/31/1986,12,0,2,8,22
6/1/1986,12,0,8,0,20
6/2/1986,8,0,9,1,18
6/3/1986,12,0,4,8,24
6/4/1986,9,0,4,7,20
6/5/1986,4,0,10,8,22
6/6/1986,4,0,4,10,18
6/7/1986,4,0,4,8,16
6/8/1986,11,0,6,10,27
6/9/1986,11,0,7,11,29
6/10/1986,7,0,3,3,13
6/11/1986,10,0,9,3,22
6/12/1986,5,0,4,3,12
6/13/1986,8,0,3,8,19
6/14/1986,12,0,6,3,21
6/15/1986,10,0,7,8,25
6/16/1986,6,0,7,11,24
6/17/1986,7,0,4,11,22
6/18/1986,8,0,10,5,23
6/19/1986,9,0,4,5,18
6/20/1986,10,0,7,9,26
6/21/1986,12,0,7,3,22
6/22/1986,4,0,6,6,16
6/23/1986,8,0,5,6,19
6/24/1986,6,0,8,3,17
6/25/1986,11,0,4,11,26
6/26/1986,8,0,9,4,21
6/27/1986,7,0,4,0,11
6/28/1986,9,0,7,2,18
6/29/1986,10,0,3,1,14
6/30/1986,4,0,8,9,21
7/1/1986,8,0,9,7,24
7/2/1986,10,0,6,8,24
7/3/1986,10,0,6,2,18
7/4/1986,4,0,2,10,16
7/5/1986,8,0,6,6,20
7/6/1986,8,0,10,0,18
7/7/1986,11,0,6,10,27
7/8/1986,8,0,3,7,18
7/9/1986,6,0,8,8,22
7/10/1986,7,0,4,2,13
7/11/1986,5,0,4,9,18
7/12/1986,8,0,6,8,22
7/13/1986,7,0,4,3,14
7/14/1986,4,0,9,5,18
7/15/1986,8,0,10,7,25
7/16/1986,6,0,3,8,17
7/17/1986,5,0,6,9,20
7/18/1986,5,0,9,0,14
7/19/1986,11,0,3,4,18
7/20/1986,4,0,4,7,15
7/21/1986,9,0,9,9,27
7/22/1986,5,0,7,0,12
7/23/1986,9,0,4,3,16
7/24/1986,8,0,3,1,12
7/25/1986,12,0,9,11,32
7/26/1986,8,0,6,6,20
7/27/1986,12,0,3,3,18
7/28/1986,10,0,5,6,21
7/29/1986,9,0,5,0,14
7/30/1986,4,0,3,9,16
7/31/1986,11,0,4,5,20
8/1/1986,7,0,5,7,19
8/2/1986,9,0,7,4,20
8/3/1986,6,0,10,5,21
8/4/1986,8,0,3,3,14
8/5/1986,11,0,2,1,14
8/6/1986,11,0,10,6,27
8/7/1986,6,0,9,6,21
8/8/1986,8,0,10,5,23
8/9/1986,4,0,9,1,14
8/10/1986,5,0,9,1,15
8/11/1986,10,0,10,8,28
8/12/1986,9,0,9,6,24
8/13/1986,12,0,9,3,24
8/14/1986,12,0,9,11,32
8/15/1986,11,0,8,7,26
8/16/1986,4,0,8,11,23
8/17/1986,4,0,2,5,11
8/18/1986,10,0,3,10,23
8/19/1986,9,0,4,9,22
8/20/1986,4,0,6,7,17
8/21/1986,9,0,5,1,15
8/22/1986,4,0,6,1,11
8/23/1986,10,0,8,10,28
8/24/1986,9,0,5,4,18
8/25/1986,9,0,7,0,16
8/26/1986,8,0,4,8,20
8/27/1986,12,0,3,1,16
8/28/1986,4,0,8,9,21
8/29/1986,6,0,2,9,17
8/30/1986,4,0,9,9,22
8/31/1986,6,0,4,6,16
9/1/1986,11,0,4,4,19
9/2/1986,11,0,6,3,20
9/3/1986,11,0,9,0,20
9/4/1986,9,0,4,6,19
9/5/1986,8,0,4,6,18
9/6/1986,4,0,4,0,8
9/7/1986,10,0,6,0,16
9/8/1986,11,0,6,0,17
9/9/1986,8,0,7,2,17
9/10/1986,9,0,10,9,28
9/11/1986,11,0,2,4,17
9/12/1986,11,0,10,3,24
9/13/1986,10,0,5,9,24
9/14/1986,4,0,10,1,15
9/15/1986,12,0,9,8,29
9/16/1986,10,0,7,8,25
9/17/1986,7,0,4,8,19
9/18/1986,8,0,6,0,14
9/19/1986,5,0,5,1,11
9/20/1986,6,0,4,11,21
9/21/1986,12,0,4,0,16
9/22/1986,4,0,3,10,17
9/23/1986,12,0,2,5,19
9/24/1986,8,0,3,9,20
9/25/1986,5,0,7,11,23
9/26/1986,10,0,8,0,18
9/27/1986,8,0,9,4,21
9/28/1986,9,0,5,9,23
9/29/1986,12,0,10,5,27
9/30/1986,4,0,3,2,9
10/1/1986,6,0,9,0,15
10/2/1986,8,0,10,5,23
10/3/1986,4,0,5,1,10
10/4/1986,8,0,5,2,15
10/5/1986,12,0,2,6,20
10/6/1986,5,0,3,10,18
10/7/1986,9,0,10,3,22
10/8/1986,6,0,9,6,21
10/9/1986,12,0,2,1,15
10/10/1986,11,0,5,1,17
10/11/1986,5,0,9,9,23
10/12/1986,11,0,10,5,26
10/13/1986,6,0,6,8,20
10/14/1986,6,0,4,4,14
10/15/1986,11,0,9,4,24
10/16/1986,12,0,3,7,22
10/17/1986,6,0,4,6,16
10/18/1986,9,0,2,4,15
10/19/1986,12,0,2,5,19
10/20/1986,5,0,9,0,14
10/21/1986,7,0,9,6,22
10/22/1986,8,0,6,8,22
10/23/1986,11,0,9,3,23
10/24/1986,12,0,4,9,25
10/25/1986,4,0,4,8,16
10/26/1986,8,0,2,3,13
10/27/1986,6,0,3,5,14
10/28/1986,7,0,10,5,22
10/29/1986,10,0,8,5,23
10/30/1986,4,0,4,0,8
10/31/1986,5,0,3,3,11
11/1/1986,7,0,6,11,24
11/2/1986,5,0,2,6,13
11/3/1986,8,0,2,5,15
11/4/1986,12,0,9,10,31
11/5/1986,6,0,10,10,26
11/6/1986,10,0,9,1,20
11/7/1986,11,0,9,2,22
11/8/1986,7,0,8,8,23
11/9/1986,4,0,7,3,14
11/10/1986,12,0,9,8,29
11/11/1986,12,0,2,10,24
11/12/1986,10,0,6,6,22
11/13/1986,8,0,3,7,18
11/14/1986,4,0,5,5,14
11/15/1986,6,0,2,8,16
11/16/1986,5,0,6,4,15
11/17/1986,8,0,9,1,18
11/18/1986,7,0,10,11,28
11/19/1986,12,0,8,9,29
11/20/1986,9,0,4,3,16
11/21/1986,9,0,8,10,27
11/22/1986,9,0,9,3,21
11/23/1986,9,0,5,1,15
11/24/1986,6,0,8,11,25
11/25/1986,7,0,8,3,18
11/26/1986,9,0,10,11,30
11/27/1986,12,0,2,6,20
11/28/1986,5,0,3,9,17
11/29/1986,7,0,2,1,10
11/30/1986,5,0,2,9,16
12/1/1986,10,0,2,7,19
12/2/1986,6,0,10,3,19
12/3/1986,11,0,6,1,18
12/4/1986,9,0,6,6,21
12/5/1986,4,0,4,0,8
12/6/1986,9,0,2,3,14
12/7/1986,7,0,8,11,26
12/8/1986,10,0,10,9,29
12/9/1986,8,0,5,8,21
12/10/1986,8,0,5,1,14
12/11/1986,6,0,6,9,21
12/12/1986,7,0,7,0,14
12/13/1986,12,0,5,5,22
12/14/1986,8,0,8,9,25
12/15/1986,4,0,9,2,15
12/16/1986,10,0,8,2,20
12/17/1986,9,0,9,4,22
12/18/1986,6,0,7,0,13
12/19/1986,11,0,5,4,20
12/20/1986,10,0,2,7,19
12/21/1986,7,0,6,5,18
12/22/1986,12,0,8,1,21
12/23/1986,8,0,6,9,23
12/24/1986,8,0,8,11,27
12/25/1986,10,0,8,3,21
12/26/1986,5,0,6,6,17
12/27/1986,10,0,6,8,24
12/28/1986,9,0,5,0,14
12/29/1986,12,0,2,10,24
12/30/1986,7,0,7,4,18
12/31/1986,5,0,6,3,14
1/1/1987,6,0,4,3,13
1/2/1987,4,0,6,6,16
1/3/1987,5,0,8,2,15
1/4/1987,6,0,5,6,17
1/5/1987,11,0,2,2,15
1/6/1987,4,0,6,2,12
1/7/1987,9,0,9,9,27
1/8/1987,7,0,5,8,20
1/9/1987,5,0,6,6,17
1/10/1987,8,0,2,3,13
1/11/1987,9,0,4,1,14
1/12/1987,10,0,6,7,23
1/13/1987,10,0,10,11,31
1/14/1987,11,0,5,1,17
1/15/1987,12,0,10,8,30
1/16/1987,9,0,4,0,13
1/17/1987,6,0,9,10,25
1/18/1987,7,0,6,5,18
1/19/1987,4,0,6,0,10
1/20/1987,5,0,4,8,17
1/21/1987,7,0,2,6,15
1/22/1987,10,0,2,6,18
1/23/1987,5,0,8,3,16
1/24/1987,6,0,9,6,21
1/25/1987,9,0,5,11,25
1/26/1987,9,0,7,6,22
1/27/1987,6,0,9,2,17
1/28/1987,10,0,7,3,20
1/29/1987,4,0,9,8,21
1/30/1987,11,0,8,5,24
1/31/1987,8,0,10,9,27
2/1/1987,4,0,2,0,6
2/2/1987,9,0,9,3,21
2/3/1987,4,0,10,10,24
2/4/1987,7,0,8,2,17
2/5/1987,5,0,9,6,20
2/6/1987,8,0,9,10,27
2/7/1987,10,0,8,1,19
2/8/1987,12,0,8,3,23
2/9/1987,11,0,2,11,24
2/10/1987,4,0,6,1,11
2/11/1987,8,0,4,2,14
2/12/1987,11,0,7,9,27
2/13/1987,11,0,6,7,24
2/14/1987,4,0,10,4,18
2/15/1987,6,0,2,1,9
2/16/1987,10,0,9,9,28
2/17/1987,8,0,6,1,15
2/18/1987,9,0,3,7,19
2/19/1987,9,0,9,6,24
2/20/1987,8,0,8,5,21
2/21/1987,8,0,4,5,17
2/22/1987,10,0,6,7,23
2/23/1987,10,0,4,6,20
2/24/1987,10,0,10,7,27
2/25/1987,7,0,8,11,26
2/26/1987,4,0,5,4,13
2/27/1987,7,0,8,2,17
2/28/1987,11,0,5,9,25
3/1/1987,8,0,8,11,27
3/2/1987,9,0,3,8,20
3/3/1987,11,0,7,11,29
3/4/1987,5,0,6,6,17
3/5/1987,10,0,9,5,24
3/6/1987,5,0,5,4,14
3/7/1987,5,0,9,4,18
3/8/1987,7,0,3,8,18
3/9/1987,5,0,6,0,11
3/10/1987,9,0,7,2,18
3/11/1987,7,0,5,1,13
3/12/1987,4,0,7,9,20
3/13/1987,10,0,9,1,20
3/14/1987,8,0,9,4,21
3/15/1987,12,0,5,1,18
3/16/1987,11,0,5,6,22
3/17/1987,10,0,7,10,27
3/18/1987,12,0,4,2,18
3/19/1987,11,0,7,0,18
3/20/1987,7,0,8,1,16
3/21/1987,10,0,9,6,25
3/22/1987,10,0,5,6,21
3/23/1987,11,0,3,2,16
3/24/1987,8,0,3,5,16
3/25/1987,6,0,7,4,17
3/26/1987,9,0,8,6,23
3/27/1987,11,0,2,2,15
3/28/1987,9,0,9,8,26
3/29/1987,4,0,9,9,22
3/30/1987,6,0,6,10,22
3/31/1987,11,0,4,11,26
4/1/1987,9,0,7,4,20
4/2/1987,10,0,6,1,17
4/3/1987,12,0,10,11,33
4/4/1987,9,0,6,7,22
4/5/1987,10,0,3,9,22
4/6/1987,7,0,2,5,14
4/7/1987,8,0,9,7,24
4/8/1987,5,0,5,4,14
4/9/1987,8,0,8,1,17
4/10/1987,7,0,10,7,24
4/11/1987,8,0,8,6,22
4/12/1987,10,0,4,6,20
4/13/1987,6,0,10,4,20
4/14/1987,5,0,10,0,15
4/15/1987,6,0,6,4,16
4/16/1987,7,0,8,6,21
4/17/1987,12,0,10,10,32
4/18/1987,10,0,9,10,29
4/19/1987,8,0,2,9,19
4/20/1987,5,0,4,6,15
4/21/1987,8,0,8,5,21
4/22/1987,6,0,10,8,24
4/23/1987,12,0,8,4,24
4/24/1987,5,0,2,6,13
4/25/1987,6,0,7,7,20
4/26/1987,11,0,2,8,21
4/27/1987,8,0,3,5,16
4/28/1987,6,0,5,6,17
4/29/1987,8,0,4,10,22
4/30/1987,6,0,8,4,18
5/1/1987,8,0,3,9,20
5/2/1987,5,0,5,10,20
5/3/1987,4,0,2,2,8
5/4/1987,7,0,5,7,19
5/5/1987,11,0,2,5,18
5/6/1987,12,0,4,10,26
5/7/1987,5,0,4,10,19
5/8/1987,8,0,10,7,25
5/9/1987,12,0,7,8,27
5/10/1987,8,0,10,11,29
5/11/1987,4,0,3,4,11
5/12/1987,4,0,6,11,21
5/13/1987,7,0,10,5,22
5/14/1987,6,0,10,5,21
5/15/1987,12,0,5,8,25
5/16/1987,7,0,6,4,17
5/17/1987,4,0,7,9,20
5/18/1987,4,0,8,4,16
5/19/1987,7,0,2,11,20
5/20/1987,8,0,2,5,15
5/21/1987,10,0,5,1,16
5/22/1987,5,0,4,0,9
5/23/1987,9,0,8,9,26
5/24/1987,12,0,2,0,14
5/25/1987,8,0,10,2,20
5/26/1987,7,0,7,7,21
5/27/1987,7,0,6,2,15
5/28/1987,5,0,10,11,26
5/29/1987,4,0,8,9,21
5/30/1987,10,0,7,1,18
5/31/1987,11,0,10,0,21
6/1/1987,12,0,7,7,26
6/2/1987,10,0,7,10,27
6/3/1987,5,0,7,3,15
6/4/1987,4,0,4,1,9
6/5/1987,7,0,9,6,22
6/6/1987,9,0,9,9,27
6/7/1987,6,0,10,2,18
6/8/1987,7,0,6,5,18
6/9/1987,11,0,3,3,17
6/10/1987,9,0,9,11,29
6/11/1987,5,0,7,0,12
6/12/1987,12,0,4,3,19
6/13/1987,9,0,2,6,17
6/14/1987,10,0,5,11,26
6/15/1987,5,0,2,0,7
6/16/1987,9,0,8,7,24
6/17/1987,12,0,7,0,19
6/18/1987,10,0,10,0,20
6/19/1987,4,0,2,7,13
6/20/1987,10,0,5,8,23
6/21/1987,8,0,5,2,15
6/22/1987,5,0,2,3,10
6/23/1987,7,0,7,8,22
6/24/1987,6,0,2,1,9
6/25/1987,10,0,7,0,17
6/26/1987,11,0,5,11,27
6/27/1987,8,0,5,2,15
6/28/1987,6,0,6,3,15
6/29/1987,4,0,4,4,12
6/30/1987,12,0,8,3,23
7/1/1987,12,0,4,5,21
7/2/1987,4,0,5,5,14
7/3/1987,7,0,10,9,26
7/4/1987,6,0,7,6,19
7/5/1987,12,0,6,8,26
7/6/1987,4,0,10,10,24
7/7/1987,9,0,7,7,23
7/8/1987,4,0,8,7,19
7/9/1987,9,0,4,3,16
7/10/1987,5,0,2,3,10
7/11/1987,6,0,10,10,26
7/12/1987,5,0,2,6,13
7/13/1987,11,0,6,5,22
7/14/1987,9,0,10,10,29
7/15/1987,7,0,7,9,23
7/16/1987,11,0,3,4,18
7/17/1987,10,0,4,2,16
7/18/1987,11,0,5,9,25
7/19/1987,6,0,9,10,25
7/20/1987,10,0,10,8,28
7/21/1987,7,0,5,9,21
7/22/1987,5,0,6,9,20
7/23/1987,8,0,3,8,19
7/24/1987,8,0,4,9,21
7/25/1987,9,0,3,3,15
7/26/1987,7,0,9,6,22
7/27/1987,12,0,8,1,21
7/28/1987,9,0,8,2,19
7/29/1987,5,0,7,1,13
7/30/1987,7,0,2,11,20
7/31/1987,4,0,8,3,15
8/1/1987,11,0,3,1,15
8/2/1987,9,0,6,6,21
8/3/1987,8,0,10,8,26
8/4/1987,8,0,10,10,28
8/5/1987,6,0,3,10,19
8/6/1987,10,0,5,3,18
8/7/1987,9,0,5,9,23
8/8/1987,8,0,3,9,20
8/9/1987,9,0,6,0,15
8/10/1987,11,0,2,4,17
8/11/1987,4,0,9,9,22
8/12/1987,10,0,5,2,17
8/13/1987,8,0,3,11,22
8/14/1987,7,0,2,2,11
8/15/1987,7,0,6,7,20
8/16/1987,4,0,4,9,17
8/17/1987,10,0,4,8,22
8/18/1987,4,0,10,7,21
8/19/1987,12,0,10,7,29
8/20/1987,4,0,7,7,18
8/21/1987,11,0,7,9,27
8/22/1987,10,0,3,2,15
8/23/1987,12,0,8,7,27
8/24/1987,8,0,9,11,28
8/25/1987,4,0,9,10,23
8/26/1987,9,0,9,5,23
8/27/1987,9,0,10,6,25
8/28/1987,7,0,9,5,21
8/29/1987,7,0,10,1,18
8/30/1987,7,0,8,9,24
8/31/1987,12,0,7,9,28
9/1/1987,7,0,5,7,19
9/2/1987,11,0,2,11,24
9/3/1987,9,0,8,6,23
9/4/1987,10,0,7,8,25
9/5/1987,10,0,10,4,24
9/6/1987,8,0,4,8,20
9/7/1987,10,0,7,7,24
9/8/1987,7,0,2,9,18
9/9/1987,6,0,10,10,26
9/10/1987,5,0,10,0,15
9/11/1987,6,0,8,3,17
9/12/1987,5,0,6,11,22
9/13/1987,12,0,6,0,18
9/14/1987,9,0,10,3,22
9/15/1987,12,0,5,3,20
9/16/1987,4,0,7,0,11
9/17/1987,8,0,6,2,16
9/18/1987,12,0,3,1,16
9/19/1987,11,0,4,4,19
9/20/1987,5,0,5,5,15
9/21/1987,4,0,4,7,15
9/22/1987,4,0,6,4,14
9/23/1987,12,0,10,0,22
9/24/1987,6,0,4,11,21
9/25/1987,5,0,8,9,22
9/26/1987,5,0,7,3,15
9/27/1987,6,0,10,3,19
9/28/1987,4,0,4,7,15
9/29/1987,6,0,2,10,18
9/30/1987,9,0,7,7,23
10/1/1987,8,0,9,3,20
10/2/1987,11,0,2,8,21
10/3/1987,9,0,2,6,17
10/4/1987,4,0,3,8,15
10/5/1987,7,0,10,5,22
10/6/1987,12,0,2,8,22
10/7/1987,7,0,7,11,25
10/8/1987,7,0,4,2,13
10/9/1987,7,0,3,11,21
10/10/1987,8,0,3,7,18
10/11/1987,10,0,9,0,19
10/12/1987,10,0,7,8,25
10/13/1987,11,0,6,5,22
10/14/1987,4,0,8,2,14
10/15/1987,12,0,3,11,26
10/16/1987,11,0,10,0,21
10/17/1987,11,0,5,10,26
10/18/1987,5,0,3,1,9
10/19/1987,8,0,2,4,14
10/20/1987,8,0,9,5,22
10/21/1987,11,0,6,1,18
10/22/1987,7,0,3,8,18
10/23/1987,11,0,8,0,19
10/24/1987,8,0,3,0,11
10/25/1987,7,0,7,2,16
10/26/1987,11,0,10,11,32
10/27/1987,8,0,8,7,23
10/28/1987,9,0,4,9,22
10/29/1987,5,0,6,11,22
10/30/1987,5,0,9,2,16
10/31/1987,8,0,2,2,12
11/1/1987,4,0,7,8,19
11/2/1987,8,0,7,6,21
11/3/1987,11,0,7,4,22
11/4/1987,5,0,2,4,11
11/5/1987,5,0,4,1,10
11/6/1987,12,0,2,9,23
11/7/1987,11,0,8,4,23
11/8/1987,11,0,2,3,16
11/9/1987,11,0,9,8,28
11/10/1987,9,0,6,4,19
11/11/1987,11,0,2,0,13
11/12/1987,6,0,2,1,9
11/13/1987,10,0,5,1,16
11/14/1987,8,0,4,11,23
11/15/1987,5,0,8,3,16
11/16/1987,9,0,3,0,12
11/17/1987,8,0,4,0,12
11/18/1987,11,0,4,1,16
11/19/1987,8,0,8,2,18
11/20/1987,10,0,10,6,26
11/21/1987,5,0,7,4,16
11/22/1987,11,0,6,5,22
11/23/1987,12,0,5,10,27
11/24/1987,9,0,6,4,19
11/25/1987,4,0,7,7,18
11/26/1987,8,0,3,5,16
11/27/1987,5,0,8,0,13
11/28/1987,10,0,10,6,26
11/29/1987,6,0,8,2,16
11/30/1987,12,0,6,9,27
12/1/1987,6,0,2,10,18
12/2/1987,7,0,9,11,27
12/3/1987,4,0,2,7,13
12/4/1987,9,0,9,0,18
12/5/1987,7,0,2,6,15
12/6/1987,9,0,8,8,25
12/7/1987,6,0,6,8,20
12/8/1987,8,0,4,7,19
12/9/1987,12,0,10,4,26
12/10/1987,7,0,6,7,20
12/11/1987,8,0,9,5,22
12/12/1987,9,0,10,8,27
12/13/1987,5,0,6,1,12
12/14/1987,12,0,9,6,27
12/15/1987,5,0,2,9,16
12/16/1987,10,0,6,3,19
12/17/1987,10,0,9,11,30
12/18/1987,5,0,5,5,15
12/19/1987,11,0,3,0,14
12/20/1987,5,0,9,3,17
12/21/1987,12,0,7,4,23
12/22/1987,4,0,10,11,25
12/23/1987,6,0,3,4,13
12/24/1987,9,0,9,4,22
12/25/1987,10,0,8,5,23
12/26/1987,5,0,3,11,19
12/27/1987,8,0,4,11,23
12/28/1987,5,0,4,8,17
12/29/1987,5,0,2,10,17
12/30/1987,4,0,7,6,17
12/31/1987,5,0,5,3,13
1/1/1988,10,0,3,6,19
1/2/1988,5,0,7,0,12
1/3/1988,10,0,3,2,15
1/4/1988,5,0,6,10,21
1/5/1988,11,0,5,6,22
1/6/1988,12,0,9,6,27
1/7/1988,11,0,6,9,26
1/8/1988,9,0,2,9,20
1/9/1988,4,0,3,5,12
1/10/1988,12,0,7,0,19
1/11/1988,7,0,8,7,22
1/12/1988,10,0,8,11,29
1/13/1988,6,0,2,2,10
1/14/1988,8,0,2,6,16
1/15/1988,6,0,6,4,16
1/16/1988,10,0,6,4,20
1/17/1988,5,0,7,3,15
1/18/1988,9,0,5,10,24
1/19/1988,12,0,7,11,30
1/20/1988,12,0,4,8,24
1/21/1988,4,0,6,5,15
1/22/1988,7,0,6,9,22
1/23/1988,9,0,3,11,23
1/24/1988,8,0,3,5,16
1/25/1988,11,0,5,10,26
1/26/1988,6,0,2,2,10
1/27/1988,11,0,7,6,24
1/28/1988,7,0,7,2,16
1/29/1988,6,0,2,1,9
1/30/1988,4,0,5,8,17
1/31/1988,10,0,2,0,12
2/1/1988,4,0,10,2,16
2/2/1988,8,0,4,9,21
2/3/1988,9,0,10,10,29
2/4/1988,4,0,9,8,21
2/5/1988,9,0,4,8,21
2/6/1988,8,0,5,5,18
2/7/1988,12,0,7,8,27
2/8/1988,12,0,7,11,30
2/9/1988,5,0,5,0,10
2/10/1988,12,0,3,0,15
2/11/1988,4,0,7,3,14
2/12/1988,7,0,3,2,12
2/13/1988,4,0,5,10,19
2/14/1988,4,0,4,8,16
2/15/1988,11,0,4,8,23
2/16/1988,12,0,6,0,18
2/17/1988,11,0,10,9,30
2/18/1988,11,0,7,9,27
2/19/1988,7,0,3,4,14
2/20/1988,9,0,3,11,23
2/21/1988,4,0,5,8,17
2/22/1988,6,0,7,0,13
2/23/1988,7,0,8,1,16
2/24/1988,8,0,10,0,18
2/25/1988,10,0,2,5,17
2/26/1988,5,0,4,5,14
2/27/1988,8,0,6,5,19
2/28/1988,9,0,8,7,24
2/29/1988,8,0,9,2,19
3/1/1988,9,0,7,1,17
3/2/1988,8,0,4,4,16
3/3/1988,10,0,8,8,26
3/4/1988,9,0,3,1,13
3/5/1988,12,0,8,4,24
3/6/1988,4,0,4,6,14
3/7/1988,6,0,7,6,19
3/8/1988,6,0,4,8,18
3/9/1988,11,0,4,6,21
3/10/1988,6,0,7,5,18
3/11/1988,9,0,6,10,25
3/12/1988,11,0,9,11,31
3/13/1988,11,0,6,9,26
3/14/1988,5,0,3,0,8
3/15/1988,8,0,10,5,23
3/16/1988,5,0,10,0,15
3/17/1988,11,0,5,10,26
3/18/1988,9,0,4,7,20
3/19/1988,6,0,9,8,23
3/20/1988,9,0,9,2,20
3/21/1988,4,0,9,6,19
3/22/1988,10,0,5,1,16
3/23/1988,8,0,2,1,11
3/24/1988,11,0,9,4,24
3/25/1988,6,0,9,4,19
3/26/1988,9,0,5,2,16
3/27/1988,11,0,5,2,18
3/28/1988,6,0,6,3,15
3/29/1988,11,0,7,6,24
3/30/1988,5,0,10,8,23
3/31/1988,8,0,4,1,13
4/1/1988,6,0,3,11,20
4/2/1988,6,0,3,2,11
4/3/1988,9,0,6,1,16
4/4/1988,5,0,2,4,11
4/5/1988,12,0,2,1,15
4/6/1988,12,0,10,8,30
4/7/1988,9,0,2,2,13
4/8/1988,8,0,3,7,18
4/9/1988,12,0,9,10,31
4/10/1988,9,0,4,0,13
4/11/1988,4,0,2,10,16
4/12/1988,11,0,4,1,16
4/13/1988,6,0,2,6,14
4/14/1988,12,0,10,9,31
4/15/1988,12,0,10,3,25
4/16/1988,7,0,8,1,16
4/17/1988,12,0,2,3,17
4/18/1988,8,0,2,4,14
4/19/1988,4,0,8,0,12
4/20/1988,9,0,3,0,12
4/21/1988,7,0,9,5,21
4/22/1988,9,0,6,3,18
4/23/1988,11,0,7,10,28
4/24/1988,4,0,7,1,12
4/25/1988,11,0,2,4,17
4/26/1988,6,0,5,0,11
4/27/1988,5,0,6,5,16
4/28/1988,7,0,6,2,15
4/29/1988,10,0,2,5,17
4/30/1988,4,0,7,5,16
5/1/1988,5,0,10,9,24
5/2/1988,9,0,10,4,23
5/3/1988,4,0,5,2,11
5/4/1988,8,0,6,6,20
5/5/1988,4,0,2,4,10
5/6/1988,12,0,4,8,24
5/7/1988,6,0,6,5,17
5/8/1988,10,0,6,3,19
5/9/1988,6,0,8,9,23
5/10/1988,4,0,10,2,16
5/11/1988,12,0,2,10,24
5/12/1988,10,0,4,10,24
5/13/1988,6,0,10,2,18
5/14/1988,6,0,7,11,24
5/15/1988,4,0,3,6,13
5/16/1988,8,0,2,7,17
5/17/1988,5,0,6,5,16
5/18/1988,4,0,2,4,10
5/19/1988,9,0,8,0,17
5/20/1988,10,0,6,1,17
5/21/1988,6,0,6,4,16
5/22/1988,9,0,4,4,17
5/23/1988,4,0,7,6,17
5/24/1988,11,0,6,3,20
5/25/1988,12,0,3,0,15
5/26/1988,7,0,7,9,23
5/27/1988,4,0,6,2,12
5/28/1988,4,0,10,1,15
5/29/1988,4,0,8,11,23
5/30/1988,10,0,10,10,30
5/31/1988,11,0,2,6,19
6/1/1988,8,0,10,1,19
6/2/1988,10,0,7,9,26
6/3/1988,10,0,5,6,21
6/4/1988,11,0,8,0,19
6/5/1988,12,0,2,1,15
6/6/1988,12,0,9,5,26
6/7/1988,12,0,7,2,21
6/8/1988,8,0,3,7,18
6/9/1988,12,0,9,1,22
6/10/1988,4,0,3,2,9
6/11/1988,9,0,2,6,17
6/12/1988,9,0,8,3,20
6/13/1988,6,0,3,5,14
6/14/1988,8,0,4,3,15
6/15/1988,11,0,4,10,25
6/16/1988,8,0,8,2,18
6/17/1988,5,0,8,3,16
6/18/1988,9,0,6,3,18
6/19/1988,11,0,8,0,19
6/20/1988,9,0,8,6,23
6/21/1988,11,0,7,1,19
6/22/1988,9,0,2,8,19
6/23/1988,6,0,5,9,20
6/24/1988,8,0,10,11,29
6/25/1988,7,0,5,4,16
6/26/1988,7,0,7,5,19
6/27/1988,7,0,2,1,10
6/28/1988,12,0,2,3,17
6/29/1988,9,0,4,4,17
6/30/1988,8,0,8,11,27
7/1/1988,9,0,7,0,16
7/2/1988,10,0,8,3,21
7/3/1988,6,0,9,11,26
7/4/1988,8,0,7,4,19
7/5/1988,8,0,2,3,13
7/6/1988,5,0,10,5,20
7/7/1988,12,0,5,0,17
7/8/1988,12,0,5,4,21
7/9/1988,8,0,5,9,22
7/10/1988,8,0,4,7,19
7/11/1988,10,0,4,0,14
7/12/1988,4,0,4,1,9
7/13/1988,11,0,10,6,27
7/14/1988,9,0,6,11,26
7/15/1988,10,0,10,4,24
7/16/1988,5,0,6,3,14
7/17/1988,11,0,6,1,18
7/18/1988,5,0,5,6,16
7/19/1988,8,0,8,9,25
7/20/1988,12,0,4,2,18
7/21/1988,9,0,4,8,21
7/22/1988,5,0,8,7,20
7/23/1988,12,0,4,2,18
7/24/1988,6,0,10,6,22
7/25/1988,8,0,9,7,24
7/26/1988,7,0,7,1,15
7/27/1988,4,0,10,3,17
7/28/1988,9,0,4,10,23
7/29/1988,10,0,2,8,20
7/30/1988,8,0,6,6,20
7/31/1988,5,0,7,2,14
8/1/1988,4,0,9,8,21
8/2/1988,6,0,3,11,20
8/3/1988,12,0,6,9,27
8/4/1988,10,0,8,7,25
8/5/1988,12,0,7,6,25
8/6/1988,8,0,9,1,18
8/7/1988,6,0,10,3,19
8/8/1988,5,0,6,10,21
8/9/1988,11,0,5,0,16
8/10/1988,6,0,10,8,24
8/11/1988,12,0,2,4,18
8/12/1988,4,0,7,0,11
8/13/1988,12,0,7,3,22
8/14/1988,7,0,4,4,15
8/15/1988,9,0,10,7,26
8/16/1988,8,0,9,8,25
8/17/1988,4,0,5,2,11
8/18/1988,7,0,3,5,15
8/19/1988,5,0,2,2,9
8/20/1988,11,0,10,7,28
8/21/1988,12,0,7,10,29
8/22/1988,12,0,6,3,21
8/23/1988,10,0,5,11,26
8/24/1988,6,0,6,8,20
8/25/1988,4,0,9,5,18
8/26/1988,4,0,6,11,21
8/27/1988,5,0,9,3,17
8/28/1988,7,0,3,6,16
8/29/1988,9,0,7,3,19
8/30/1988,12,0,2,1,15
8/31/1988,4,0,9,7,20
9/1/1988,10,0,4,7,21
9/2/1988,11,0,9,10,30
9/3/1988,4,0,3,4,11
9/4/1988,12,0,2,0,14
9/5/1988,10,0,4,7,21
9/6/1988,12,0,7,8,27
9/7/1988,4,0,7,10,21
9/8/1988,6,0,2,3,11
9/9/1988,10,0,7,8,25
9/10/1988,8,0,10,1,19
9/11/1988,6,0,6,2,14
9/12/1988,6,0,10,4,20
9/13/1988,9,0,2,10,21
9/14/1988,6,0,5,11,22
9/15/1988,7,0,5,0,12
9/16/1988,8,0,5,10,23
9/17/1988,9,0,3,1,13
9/18/1988,7,0,9,5,21
9/19/1988,8,0,9,3,20
9/20/1988,6,0,10,9,25
9/21/1988,9,0,3,7,19
9/22/1988,4,0,5,5,14
9/23/1988,4,0,3,10,17
9/24/1988,6,0,8,5,19
9/25/1988,12,0,9,3,24
9/26/1988,9,0,10,8,27
9/27/1988,4,0,3,0,7
9/28/1988,4,0,3,2,9
9/29/1988,7,0,8,10,25
9/30/1988,5,0,9,8,22
10/1/1988,5,0,9,3,17
10/2/1988,7,0,7,10,24
10/3/1988,7,0,5,7,19
10/4/1988,10,0,2,11,23
10/5/1988,11,0,7,1,19
10/6/1988,10,0,8,9,27
10/7/1988,4,0,6,10,20
10/8/1988,5,0,3,7,15
10/9/1988,6,0,6,4,16
10/10/1988,6,0,5,7,18
10/11/1988,6,0,3,9,18
10/12/1988,6,0,8,5,19
10/13/1988,5,0,4,5,14
10/14/1988,8,0,7,6,21
10/15/1988,6,0,3,5,14
10/16/1988,6,0,6,7,19
10/17/1988,6,0,3,4,13
10/18/1988,12,0,8,5,25
10/19/1988,7,0,9,1,17
10/20/1988,4,0,8,6,18
10/21/1988,6,0,8,6,20
10/22/1988,10,0,5,1,16
10/23/1988,10,0,3,3,16
10/24/1988,6,0,9,1,16
10/25/1988,10,0,9,8,27
10/26/1988,4,0,10,11,25
10/27/1988,7,0,10,5,22
10/28/1988,8,0,9,9,26
10/29/1988,10,0,6,4,20
10/30/1988,11,0,10,11,32
10/31/1988,7,0,10,0,17
11/1/1988,5,0,3,9,17
11/2/1988,11,0,6,5,22
11/3/1988,4,0,3,11,18
11/4/1988,5,0,6,2,13
11/5/1988,10,0,4,5,19
11/6/1988,4,0,3,7,14
11/7/1988,8,0,10,5,23
11/8/1988,6,0,6,8,20
11/9/1988,7,0,5,9,21
11/10/1988,11,0,8,11,30
11/11/1988,10,0,5,4,19
11/12/1988,9,0,10,5,24
11/13/1988,10,0,2,9,21
11/14/1988,5,0,7,8,20
11/15/1988,12,0,10,1,23
11/16/1988,8,0,2,7,17
11/17/1988,9,0,2,1,12
11/18/1988,10,0,9,10,29
11/19/1988,8,0,6,11,25
11/20/1988,4,0,10,0,14
11/21/1988,10,0,5,3,18
11/22/1988,5,0,9,0,14
11/23/1988,5,0,2,3,10
11/24/1988,11,0,8,11,30
11/25/1988,10,0,7,10,27
11/26/1988,4,0,7,6,17
11/27/1988,12,0,4,3,19
11/28/1988,4,0,4,11,19
11/29/1988,7,0,9,11,27
11/30/1988,5,0,2,2,9
12/1/1988,12,0,9,4,25
12/2/1988,9,0,10,6,25
12/3/1988,12,0,7,9,28
12/4/1988,12,0,8,9,29
12/5/1988,7,0,5,8,20
12/6/1988,7,0,9,7,23
12/7/1988,5,0,7,0,12
12/8/1988,12,0,4,2,18
12/9/1988,9,0,3,6,18
12/10/1988,6,0,8,8,22
12/11/1988,5,0,3,3,11
12/12/1988,4,0,7,6,17
12/13/1988,11,0,10,7,28
12/14/1988,10,0,7,4,21
12/15/1988,5,0,2,7,14
12/16/1988,7,0,5,5,17
12/17/1988,7,0,2,0,9
12/18/1988,12,0,4,1,17
12/19/1988,12,0,9,9,30
12/20/1988,8,0,4,4,16
12/21/1988,9,0,10,4,23
12/22/1988,11,0,5,9,25
12/23/1988,8,0,2,10,20
12/24/1988,4,0,7,9,20
12/25/1988,10,0,6,3,19
12/26/1988,4,0,5,5,14
12/27/1988,12,0,9,10,31
12/28/1988,7,0,3,1,11
12/29/1988,9,0,3,3,15
12/30/1988,9,0,10,6,25
12/31/1988,7,0,6,11,24
1/1/1989,8,0,10,2,20
1/2/1989,10,0,5,8,23
1/3/1989,9,0,2,8,19
1/4/1989,5,0,2,10,17
1/5/1989,12,0,4,2,18
1/6/1989,11,0,4,2,17
1/7/1989,8,0,7,1,16
1/8/1989,5,0,7,4,16
1/9/1989,5,0,2,10,17
1/10/1989,8,0,4,1,13
1/11/1989,6,0,7,9,22
1/12/1989,7,0,9,5,21
1/13/1989,5,0,2,5,12
1/14/1989,9,0,6,11,26
1/15/1989,12,0,9,3,24
1/16/1989,9,0,2,7,18
1/17/1989,10,0,3,4,17
1/18/1989,12,0,4,6,22
1/19/1989,12,0,7,8,27
1/20/1989,12,0,2,9,23
1/21/1989,9,0,6,5,20
1/22/1989,12,0,7,9,28
1/23/1989,6,0,6,10,22
1/24/1989,12,0,4,6,22
1/25/1989,4,0,7,0,11
1/26/1989,8,0,3,6,17
1/27/1989,10,0,8,6,24
1/28/1989,7,0,7,9,23
1/29/1989,6,0,5,4,15
1/30/1989,7,0,5,11,23
1/31/1989,4,0,4,5,13
2/1/1989,7,0,7,11,25
2/2/1989,9,0,9,3,21
2/3/1989,10,0,6,4,20
2/4/1989,5,0,8,1,14
2/5/1989,10,0,5,5,20
2/6/1989,5,0,4,7,16
2/7/1989,12,0,8,9,29
2/8/1989,10,0,3,2,15
2/9/1989,7,0,8,4,19
2/10/1989,7,0,7,2,16
2/11/1989,10,0,5,2,17
2/12/1989,5,0,3,4,12
2/13/1989,6,0,10,1,17
2/14/1989,5,0,9,0,14
2/15/1989,4,0,10,0,14
2/16/1989,4,0,5,3,12
2/17/1989,12,0,9,4,25
2/18/1989,10,0,2,4,16
2/19/1989,10,0,8,3,21
2/20/1989,8,0,5,10,23
2/21/1989,4,0,7,0,11
2/22/1989,10,0,4,9,23
2/23/1989,4,0,3,5,12
2/24/1989,5,0,3,7,15
2/25/1989,10,0,8,7,25
2/26/1989,12,0,6,8,26
2/27/1989,5,0,10,10,25
2/28/1989,11,0,8,3,22
3/1/1989,6,0,7,0,13
3/2/1989,11,0,9,11,31
3/3/1989,9,0,5,2,16
3/4/1989,12,0,4,5,21
3/5/1989,11,0,10,6,27
3/6/1989,8,0,4,8,20
3/7/1989,5,0,4,1,10
3/8/1989,12,0,8,6,26
3/9/1989,9,0,9,9,27
3/10/1989,11,0,2,8,21
3/11/1989,7,0,2,3,12
3/12/1989,4,0,2,7,13
3/13/1989,6,0,4,3,13
3/14/1989,12,0,6,11,29
3/15/1989,10,0,5,0,15
3/16/1989,4,0,5,4,13
3/17/1989,7,0,6,0,13
3/18/1989,11,0,4,4,19
3/19/1989,10,0,5,3,18
3/20/1989,8,0,7,0,15
3/21/1989,12,0,9,6,27
3/22/1989,10,0,9,5,24
3/23/1989,5,0,9,8,22
3/24/1989,6,0,10,10,26
3/25/1989,7,0,6,1,14
3/26/1989,5,0,5,3,13
3/27/1989,5,0,5,8,18
3/28/1989,8,0,3,1,12
3/29/1989,5,0,7,3,15
3/30/1989,7,0,5,11,23
3/31/1989,4,0,4,0,8
4/1/1989,8,0,9,1,18
4/2/1989,8,0,5,1,14
4/3/1989,8,0,10,7,25
4/4/1989,12,0,4,3,19
4/5/1989,5,0,3,6,14
4/6/1989,8,0,4,3,15
4/7/1989,11,0,8,3,22
4/8/1989,10,0,5,1,16
4/9/1989,9,0,3,9,21
4/10/1989,4,0,6,3,13
4/11/1989,11,0,6,10,27
4/12/1989,10,0,7,11,28
4/13/1989,12,0,7,1,20
4/14/1989,8,0,6,6,20
4/15/1989,11,0,9,9,29
4/16/1989,9,0,5,6,20
4/17/1989,9,0,3,11,23
4/18/1989,7,0,7,10,24
4/19/1989,11,0,4,4,19
4/20/1989,9,0,3,9,21
4/21/1989,9,0,8,4,21
4/22/1989,9,0,4,7,20
4/23/1989,8,0,8,3,19
4/24/1989,9,0,6,10,25
4/25/1989,5,0,9,9,23
4/26/1989,10,0,4,7,21
4/27/1989,5,0,6,7,18
4/28/1989,5,0,6,11,22
4/29/1989,6,0,8,4,18
4/30/1989,11,0,6,11,28
5/1/1989,11,0,6,6,23
5/2/1989,12,0,4,0,16
5/3/1989,11,0,5,8,24
5/4/1989,11,0,6,10,27
5/5/1989,4,0,5,3,12
5/6/1989,10,0,10,5,25
5/7/1989,6,0,9,5,20
5/8/1989,11,0,8,2,21
5/9/1989,6,0,9,2,17
5/10/1989,9,0,8,5,22
5/11/1989,8,0,4,8,20
5/12/1989,10,0,7,11,28
5/13/1989,8,0,9,8,25
5/14/1989,6,0,4,1,11
5/15/1989,8,0,2,2,12
5/16/1989,9,0,7,4,20
5/17/1989,7,0,9,10,26
5/18/1989,9,0,10,3,22
5/19/1989,7,0,9,5,21
5/20/1989,8,0,2,0,10
5/21/1989,10,0,9,5,24
5/22/1989,12,0,6,7,25
5/23/1989,10,0,9,5,24
5/24/1989,12,0,9,6,27
5/25/1989,10,0,10,6,26
5/26/1989,11,0,10,9,30
5/27/1989,5,0,9,5,19
5/28/1989,4,0,2,6,12
5/29/1989,5,0,10,8,23
5/30/1989,7,0,5,0,12
5/31/1989,10,0,9,4,23
6/1/1989,7,0,3,4,14
6/2/1989,12,0,3,8,23
6/3/1989,6,0,2,7,15
6/4/1989,11,0,3,10,24
6/5/1989,9,0,10,9,28
6/6/1989,9,0,9,5,23
6/7/1989,9,0,4,10,23
6/8/1989,4,0,6,4,14
6/9/1989,7,0,7,2,16
6/10/1989,10,0,8,2,20
6/11/1989,11,0,4,1,16
6/12/1989,4,0,9,4,17
6/13/1989,8,0,5,9,22
6/14/1989,10,0,4,6,20
6/15/1989,5,0,2,4,11
6/16/1989,10,0,2,2,14
6/17/1989,12,0,10,11,33
6/18/1989,12,0,4,0,16
6/19/1989,11,0,4,5,20
6/20/1989,6,0,6,5,17
6/21/1989,11,0,2,5,18
6/22/1989,7,0,6,4,17
6/23/1989,6,0,5,10,21
6/24/1989,10,0,6,0,16
6/25/1989,5,0,6,2,13
6/26/1989,7,0,10,3,20
6/27/1989,11,0,6,4,21
6/28/1989,10,0,6,2,18
6/29/1989,6,0,2,5,13
6/30/1989,11,0,10,10,31
7/1/1989,4,0,3,5,12
7/2/1989,8,0,8,11,27
7/3/1989,5,0,6,4,15
7/4/1989,9,0,2,3,14
7/5/1989,9,0,5,11,25
7/6/1989,8,0,5,7,20
7/7/1989,5,0,4,8,17
7/8/1989,8,0,8,9,25
7/9/1989,6,0,2,2,10
7/10/1989,9,0,8,7,24
7/11/1989,7,0,4,2,13
7/12/1989,8,0,8,1,17
7/13/1989,8,0,8,2,18
7/14/1989,5,0,5,11,21
7/15/1989,4,0,8,1,13
7/16/1989,7,0,6,4,17
7/17/1989,9,0,5,1,15
7/18/1989,5,0,8,2,15
7/19/1989,5,0,3,11,19
7/20/1989,8,0,9,6,23
7/21/1989,8,0,9,4,21
7/22/1989,10,0,7,6,23
7/23/1989,12,0,4,0,16
7/24/1989,5,0,3,4,12
7/25/1989,9,0,4,11,24
7/26/1989,8,0,6,3,17
7/27/1989,5,0,2,6,13
7/28/1989,10,0,4,1,15
7/29/1989,5,0,9,1,15
7/30/1989,7,0,6,2,15
7/31/1989,10,0,4,10,24
8/1/1989,11,0,10,4,25
8/2/1989,10,0,3,1,14
8/3/1989,9,0,6,8,23
8/4/1989,7,0,9,6,22
8/5/1989,7,0,7,3,17
8/6/1989,7,0,3,1,11
8/7/1989,7,0,10,5,22
8/8/1989,11,0,2,10,23
8/9/1989,9,0,5,10,24
8/10/1989,12,0,9,5,26
8/11/1989,8,0,7,8,23
8/12/1989,7,0,2,0,9
8/13/1989,4,0,5,6,15
8/14/1989,5,0,7,0,12
8/15/1989,6,0,5,10,21
8/16/1989,7,0,5,6,18
8/17/1989,4,0,5,4,13
8/18/1989,9,0,8,3,20
8/19/1989,8,0,4,3,15
8/20/1989,11,0,4,0,15
8/21/1989,5,0,9,7,21
8/22/1989,12,0,2,11,25
8/23/1989,12,0,7,2,21
8/24/1989,7,0,9,11,27
8/25/1989,7,0,7,11,25
8/26/1989,10,0,3,11,24
8/27/1989,12,0,8,3,23
8/28/1989,9,0,9,6,24
8/29/1989,12,0,10,2,24
8/30/1989,12,0,3,4,19
8/31/1989,9,0,9,10,28
9/1/1989,8,0,10,0,18
9/2/1989,5,0,2,11,18
9/3/1989,9,0,3,10,22
9/4/1989,7,0,5,7,19
9/5/1989,9,0,4,2,15
9/6/1989,5,0,6,5,16
9/7/1989,6,0,8,3,17
9/8/1989,10,0,7,0,17
9/9/1989,7,0,3,11,21
9/10/1989,9,0,7,0,16
9/11/1989,8,0,3,2,13
9/12/1989,7,0,8,5,20
9/13/1989,6,0,9,4,19
9/14/1989,12,0,7,9,28
9/15/1989,11,0,7,5,23
9/16/1989,9,0,6,11,26
9/17/1989,9,0,7,11,27
9/18/1989,11,0,6,4,21
9/19/1989,12,0,5,2,19
9/20/1989,12,0,8,9,29
9/21/1989,10,0,10,1,21
9/22/1989,8,0,10,9,27
9/23/1989,5,0,7,2,14
9/24/1989,7,0,3,4,14
9/25/1989,10,0,10,8,28
9/26/1989,10,0,3,6,19
9/27/1989,7,0,10,4,21
9/28/1989,4,0,10,8,22
9/29/1989,12,0,10,10,32
9/30/1989,12,0,5,2,19
10/1/1989,9,0,9,11,29
10/2/1989,7,0,6,9,22
10/3/1989,10,0,9,11,30
10/4/1989,7,0,10,11,28
10/5/1989,8,0,3,10,21
10/6/1989,10,0,10,8,28
10/7/1989,6,0,2,0,8
10/8/1989,10,0,5,1,16
10/9/1989,8,0,9,3,20
10/10/1989,11,0,9,2,22
10/11/1989,11,0,8,5,24
10/12/1989,11,0,3,3,17
10/13/1989,9,0,6,8,23
10/14/1989,12,0,4,11,27
10/15/1989,7,0,5,0,12
10/16/1989,11,0,8,5,24
10/17/1989,11,0,4,5,20
10/18/1989,9,0,7,1,17
10/19/1989,9,0,5,11,25
10/20/1989,12,0,7,5,24
10/21/1989,4,0,10,8,22
10/22/1989,9,0,6,9,24
10/23/1989,4,0,5,4,13
10/24/1989,7,0,8,8,23
10/25/1989,6,0,2,6,14
10/26/1989,6,0,10,9,25
10/27/1989,5,0,9,1,15
10/28/1989,7,0,9,9,25
10/29/1989,12,0,10,8,30
10/30/1989,12,0,9,7,28
10/31/1989,6,0,6,9,21
11/1/1989,5,0,6,9,20
11/2/1989,8,0,7,10,25
11/3/1989,6,0,8,8,22
11/4/1989,11,0,8,4,23
11/5/1989,9,0,4,10,23
11/6/1989,6,0,10,0,16
11/7/1989,12,0,3,7,22
11/8/1989,10,0,6,4,20
11/9/1989,4,0,5,0,9
11/10/1989,10,0,10,10,30
11/11/1989,8,0,4,11,23
11/12/1989,11,0,6,3,20
11/13/1989,7,0,7,9,23
11/14/1989,9,0,10,4,23
11/15/1989,11,0,6,1,18
11/16/1989,12,0,4,6,22
11/17/1989,7,0,4,0,11
11/18/1989,10,0,8,8,26
11/19/1989,12,0,6,1,19
11/20/1989,11,0,10,9,30
11/21/1989,4,0,10,9,23
11/22/1989,5,0,10,6,21
11/23/1989,9,0,9,11,29
11/24/1989,6,0,4,7,17
11/25/1989,9,0,9,6,24
11/26/1989,10,0,10,8,28
11/27/1989,4,0,4,9,17
11/28/1989,6,0,7,0,13
11/29/1989,9,0,4,9,22
11/30/1989,4,0,4,9,17
12/1/1989,10,0,10,9,29
12/2/1989,4,0,7,11,22
12/3/1989,11,0,3,0,14
12/4/1989,6,0,5,9,20
12/5/1989,4,0,9,0,13
12/6/1989,4,0,3,2,9
12/7/1989,4,0,10,6,20
12/8/1989,7,0,10,4,21
12/9/1989,11,0,2,0,13
12/10/1989,5,0,4,2,11
12/11/1989,4,0,7,6,17
12/12/1989,5,0,10,1,16
12/13/1989,4,0,4,0,8
12/14/1989,6,0,2,10,18
12/15/1989,11,0,7,2,20
12/16/1989,11,0,7,10,28
12/17/1989,6,0,6,11,23
12/18/1989,9,0,9,0,18
12/19/1989,5,0,4,5,14
12/20/1989,4,0,9,6,19
12/21/1989,10,0,7,3,20
12/22/1989,8,0,8,10,26
12/23/1989,12,0,8,1,21
12/24/1989,4,0,4,0,8
12/25/1989,9,0,9,4,22
12/26/1989,9,0,4,9,22
12/27/1989,12,0,2,7,21
12/28/1989,11,0,4,3,18
12/29/1989,10,0,4,11,25
12/30/1989,6,0,9,3,18
12/31/1989,6,0,2,2,10
1/1/1990,9,0,6,5,20
1/2/1990,11,0,4,4,19
1/3/1990,7,0,5,0,12
1/4/1990,12,0,9,7,28
1/5/1990,5,0,10,9,24
1/6/1990,11,0,9,8,28
1/7/1990,6,0,9,9,24
1/8/1990,11,0,9,9,29
1/9/1990,6,0,7,0,13
1/10/1990,7,0,4,10,21
1/11/1990,11,0,7,1,19
1/12/1990,11,0,6,11,28
1/13/1990,12,0,2,9,23
1/14/1990,9,0,9,10,28
1/15/1990,12,0,10,6,28
1/16/1990,9,0,9,4,22
1/17/1990,6,0,4,9,19
1/18/1990,7,0,9,10,26
1/19/1990,9,0,4,6,19
1/20/1990,10,0,7,1,18
1/21/1990,7,0,3,7,17
1/22/1990,8,0,6,7,21
1/23/1990,12,0,4,5,21
1/24/1990,9,0,4,7,20
1/25/1990,7,0,7,2,16
1/26/1990,12,0,2,10,24
1/27/1990,9,0,9,3,21
1/28/1990,8,0,5,8,21
1/29/1990,7,0,6,9,22
1/30/1990,12,0,3,5,20
1/31/1990,8,0,8,0,16
2/1/1990,6,0,9,6,21
2/2/1990,9,0,4,6,19
2/3/1990,9,0,7,7,23
2/4/1990,7,0,3,0,10
2/5/1990,6,0,8,1,15
2/6/1990,10,0,2,2,14
2/7/1990,4,0,2,1,7
2/8/1990,4,0,2,4,10
2/9/1990,6,0,9,11,26
2/10/1990,10,0,4,3,17
2/11/1990,7,0,8,11,26
2/12/1990,5,0,4,5,14
2/13/1990,11,0,10,6,27
2/14/1990,4,0,9,3,16
2/15/1990,7,0,2,10,19
2/16/1990,7,0,10,9,26
2/17/1990,9,0,8,2,19
2/18/1990,11,0,9,2,22
2/19/1990,4,0,9,4,17
2/20/1990,9,0,8,6,23
2/21/1990,10,0,8,2,20
2/22/1990,9,0,5,2,16
2/23/1990,12,0,9,2,23
2/24/1990,9,0,9,3,21
2/25/1990,12,0,10,6,28
2/26/1990,6,0,2,9,17
2/27/1990,5,0,2,4,11
2/28/1990,9,0,3,11,23
3/1/1990,9,0,9,4,22
3/2/1990,8,0,6,8,22
3/3/1990,4,0,5,2,11
3/4/1990,10,0,10,6,26
3/5/1990,10,0,3,8,21
3/6/1990,7,0,10,4,21
3/7/1990,4,0,3,2,9
3/8/1990,8,0,4,8,20
3/9/1990,12,0,3,0,15
3/10/1990,9,0,9,10,28
3/11/1990,7,0,9,0,16
3/12/1990,7,0,2,10,19
3/13/1990,5,0,10,6,21
3/14/1990,11,0,4,2,17
3/15/1990,9,0,7,7,23
3/16/1990,4,0,8,11,23
3/17/1990,4,0,5,8,17
3/18/1990,8,0,4,7,19
3/19/1990,9,0,9,6,24
3/20/1990,6,0,7,8,21
3/21/1990,8,0,7,9,24
3/22/1990,11,0,4,8,23
3/23/1990,9,0,5,9,23
3/24/1990,10,0,4,7,21
3/25/1990,10,0,6,8,24
3/26/1990,7,0,3,7,17
3/27/1990,5,0,5,2,12
3/28/1990,6,0,9,6,21
3/29/1990,9,0,9,3,21
3/30/1990,12,0,8,2,22
3/31/1990,11,0,2,8,21
4/1/1990,9,0,3,10,22
4/2/1990,8,0,2,1,11
4/3/1990,11,0,7,4,22
4/4/1990,7,0,6,9,22
4/5/1990,4,0,5,7,16
4/6/1990,9,0,10,0,19
4/7/1990,10,0,9,1,20
4/8/1990,12,0,6,7,25
4/9/1990,8,0,6,0,14
4/10/1990,8,0,8,10,26
4/11/1990,5,0,4,4,13
4/12/1990,6,0,5,0,11
4/13/1990,7,0,8,10,25
4/14/1990,7,0,10,0,17
4/15/1990,9,0,5,4,18
4/16/1990,11,0,4,11,26
4/17/1990,5,0,6,9,20
4/18/1990,7,0,2,2,11
4/19/1990,5,0,3,7,15
4/20/1990,12,0,8,4,24
4/21/1990,4,0,2,6,12
4/22/1990,7,0,6,8,21
4/23/1990,7,0,7,4,18
4/24/1990,9,0,5,10,24
4/25/1990,4,0,4,11,19
4/26/1990,7,0,5,8,20
4/27/1990,9,0,2,0,11
4/28/1990,7,0,7,3,17
4/29/1990,7,0,3,10,20
4/30/1990,4,0,9,7,20
5/1/1990,8,0,3,7,18
5/2/1990,7,0,10,7,24
5/3/1990,10,0,10,9,29
5/4/1990,5,0,4,1,10
5/5/1990,11,0,6,7,24
5/6/1990,5,0,3,4,12
5/7/1990,11,0,3,9,23
5/8/1990,4,0,5,10,19
5/9/1990,9,0,6,2,17
5/10/1990,5,0,7,9,21
5/11/1990,10,0,4,5,19
5/12/1990,8,0,7,3,18
5/13/1990,12,0,4,1,17
5/14/1990,4,0,2,4,10
5/15/1990,4,0,7,1,12
5/16/1990,5,0,10,11,26
5/17/1990,8,0,4,3,15
5/18/1990,12,0,5,10,27
5/19/1990,10,0,5,1,16
5/20/1990,4,0,2,3,9
5/21/1990,7,0,9,2,18
5/22/1990,6,0,5,4,15
5/23/1990,12,0,10,6,28
5/24/1990,11,0,4,1,16
5/25/1990,10,0,5,6,21
5/26/1990,5,0,5,4,14
5/27/1990,9,0,2,7,18
5/28/1990,4,0,10,2,16
5/29/1990,7,0,5,2,14
5/30/1990,6,0,8,8,22
5/31/1990,9,0,5,4,18
6/1/1990,11,0,8,1,20
6/2/1990,12,0,4,1,17
6/3/1990,7,0,7,0,14
6/4/1990,5,0,9,3,17
6/5/1990,5,0,5,0,10
6/6/1990,12,0,9,3,24
6/7/1990,7,0,8,10,25
6/8/1990,5,0,9,8,22
6/9/1990,9,0,7,6,22
6/10/1990,12,0,7,3,22
6/11/1990,11,0,2,11,24
6/12/1990,7,0,3,8,18
6/13/1990,12,0,2,11,25
6/14/1990,5,0,3,2,10
6/15/1990,11,0,4,0,15
6/16/1990,10,0,7,5,22
6/17/1990,6,0,9,7,22
6/18/1990,10,0,10,10,30
6/19/1990,6,0,5,2,13
6/20/1990,4,0,2,3,9
6/21/1990,4,0,3,3,10
6/22/1990,7,0,4,4,15
6/23/1990,4,0,10,6,20
6/24/1990,6,0,6,7,19
6/25/1990,9,0,9,9,27
6/26/1990,6,0,2,4,12
6/27/1990,9,0,8,7,24
6/28/1990,10,0,4,4,18
6/29/1990,9,0,7,3,19
6/30/1990,8,0,8,0,16
7/1/1990,9,0,10,10,29
7/2/1990,9,0,5,4,18
7/3/1990,8,0,3,8,19
7/4/1990,4,0,5,2,11
7/5/1990,8,0,6,11,25
7/6/1990,11,0,3,6,20
7/7/1990,6,0,5,8,19
7/8/1990,7,0,9,7,23
7/9/1990,12,0,7,4,23
7/10/1990,6,0,2,1,9
7/11/1990,10,0,8,8,26
7/12/1990,7,0,7,2,16
7/13/1990,4,0,9,5,18
7/14/1990,10,0,3,1,14
7/15/1990,11,0,2,5,18
7/16/1990,11,0,10,2,23
7/17/1990,5,0,2,8,15
7/18/1990,10,0,2,8,20
7/19/1990,6,0,2,1,9
7/20/1990,6,0,3,5,14
7/21/1990,4,0,7,8,19
7/22/1990,11,0,3,0,14
7/23/1990,8,0,4,0,12
7/24/1990,8,0,2,1,11
7/25/1990,6,0,2,2,10
7/26/1990,5,0,9,5,19
7/27/1990,7,0,6,3,16
7/28/1990,6,0,7,2,15
7/29/1990,4,0,9,6,19
7/30/1990,10,0,2,5,17
7/31/1990,10,0,10,8,28
8/1/1990,9,0,9,10,28
8/2/1990,6,0,8,2,16
8/3/1990,11,0,8,10,29
8/4/1990,9,0,7,3,19
8/5/1990,6,0,4,2,12
8/6/1990,9,0,4,11,24
8/7/1990,11,0,7,5,23
8/8/1990,10,0,2,11,23
8/9/1990,7,0,9,1,17
8/10/1990,11,0,5,7,23
8/11/1990,7,0,7,0,14
8/12/1990,9,0,6,8,23
8/13/1990,8,0,7,10,25
8/14/1990,9,0,6,2,17
8/15/1990,9,0,6,7,22
8/16/1990,5,0,5,2,12
8/17/1990,4,0,9,6,19
8/18/1990,6,0,8,7,21
8/19/1990,9,0,5,7,21
8/20/1990,8,0,6,10,24
8/21/1990,10,0,4,10,24
8/22/1990,4,0,4,0,8
8/23/1990,12,0,10,10,32
8/24/1990,9,0,2,3,14
8/25/1990,7,0,2,7,16
8/26/1990,6,0,8,0,14
8/27/1990,7,0,3,8,18
8/28/1990,8,0,5,7,20
8/29/1990,9,0,5,9,23
8/30/1990,6,0,4,0,10
8/31/1990,8,0,8,6,22
9/1/1990,10,0,2,4,16
9/2/1990,10,0,3,1,14
9/3/1990,8,0,2,6,16
9/4/1990,6,0,8,2,16
9/5/1990,10,0,2,2,14
9/6/1990,5,0,6,6,17
9/7/1990,5,0,7,9,21
9/8/1990,12,0,8,8,28
9/9/1990,4,0,6,9,19
9/10/1990,9,0,5,1,15
9/11/1990,5,0,6,10,21
9/12/1990,12,0,6,6,24
9/13/1990,9,0,10,9,28
9/14/1990,6,0,5,6,17
9/15/1990,8,0,6,7,21
9/16/1990,10,0,2,1,13
9/17/1990,5,0,8,3,16
9/18/1990,5,0,8,0,13
9/19/1990,4,0,5,2,11
9/20/1990,9,0,5,7,21
9/21/1990,12,0,5,4,21
9/22/1990,4,0,10,1,15
9/23/1990,10,0,5,6,21
9/24/1990,12,0,7,1,20
9/25/1990,4,0,6,10,20
9/26/1990,11,0,10,9,30
9/27/1990,6,0,5,7,18
9/28/1990,4,0,4,5,13
9/29/1990,7,0,8,4,19
9/30/1990,9,0,6,3,18
10/1/1990,4,0,4,0,8
10/2/1990,7,0,6,4,17
10/3/1990,11,0,7,1,19
10/4/1990,7,0,9,9,25
10/5/1990,11,0,5,10,26
10/6/1990,12,0,4,6,22
10/7/1990,6,0,5,6,17
10/8/1990,11,0,7,8,26
10/9/1990,12,0,6,9,27
10/10/1990,8,0,7,11,26
10/11/1990,6,0,4,6,16
10/12/1990,5,0,5,3,13
10/13/1990,5,0,5,6,16
10/14/1990,11,0,4,5,20
10/15/1990,7,0,8,0,15
10/16/1990,10,0,2,5,17
10/17/1990,4,0,4,1,9
10/18/1990,9,0,6,2,17
10/19/1990,8,0,4,2,14
10/20/1990,8,0,8,2,18
10/21/1990,5,0,4,1,10
10/22/1990,8,0,2,9,19
10/23/1990,5,0,9,9,23
10/24/1990,8,0,10,8,26
10/25/1990,7,0,4,8,19
10/26/1990,8,0,4,9,21
10/27/1990,9,0,10,7,26
10/28/1990,5,0,10,8,23
10/29/1990,12,0,10,11,33
10/30/1990,4,0,8,10,22
10/31/1990,10,0,3,0,13
11/1/1990,7,0,2,2,11
11/2/1990,5,0,9,3,17
11/3/1990,5,0,2,3,10
11/4/1990,7,0,4,7,18
11/5/1990,7,0,3,0,10
11/6/1990,12,0,6,5,23
11/7/1990,6,0,7,3,16
11/8/1990,12,0,4,7,23
11/9/1990,5,0,5,11,21
11/10/1990,7,0,2,7,16
11/11/1990,12,0,8,1,21
11/12/1990,10,0,2,11,23
11/13/1990,7,0,2,11,20
11/14/1990,5,0,7,5,17
11/15/1990,7,0,8,2,17
11/16/1990,11,0,3,0,14
11/17/1990,12,0,7,1,20
11/18/1990,10,0,10,3,23
11/19/1990,10,0,7,5,22
11/20/1990,12,0,8,3,23
11/21/1990,6,0,10,3,19
11/22/1990,4,0,4,3,11
11/23/1990,6,0,2,4,12
11/24/1990,6,0,8,6,20
11/25/1990,6,0,4,4,14
11/26/1990,8,0,3,7,18
11/27/1990,6,0,9,1,16
11/28/1990,6,0,7,0,13
11/29/1990,4,0,4,6,14
11/30/1990,9,0,6,0,15
12/1/1990,5,0,3,2,10
12/2/1990,5,0,10,9,24
12/3/1990,6,0,2,0,8
12/4/1990,5,0,4,10,19
12/5/1990,8,0,9,4,21
12/6/1990,7,0,2,2,11
12/7/1990,6,0,5,8,19
12/8/1990,7,0,10,5,22
12/9/1990,5,0,9,6,20
12/10/1990,12,0,2,0,14
12/11/1990,11,0,6,9,26
12/12/1990,5,0,7,2,14
12/13/1990,5,0,9,11,25
12/14/1990,9,0,4,2,15
12/15/1990,10,0,2,10,22
12/16/1990,12,0,10,10,32
12/17/1990,4,0,4,7,15
12/18/1990,11,0,6,10,27
12/19/1990,9,0,8,2,19
12/20/1990,8,0,7,2,17
12/21/1990,12,0,10,11,33
12/22/1990,9,0,4,11,24
12/23/1990,9,0,2,10,21
12/24/1990,8,0,3,11,22
12/25/1990,10,0,6,6,22
12/26/1990,9,0,5,1,15
12/27/1990,10,0,8,7,25
12/28/1990,10,0,10,7,27
12/29/1990,12,0,9,10,31
12/30/1990,8,0,6,9,23
12/31/1990,4,0,4,5,13
1/1/1991,9,0,5,10,24
1/2/1991,9,0,9,10,28
1/3/1991,10,0,9,7,26
1/4/1991,9,0,10,0,19
1/5/1991,10,0,7,11,28
1/6/1991,4,0,4,6,14
1/7/1991,12,0,6,8,26
1/8/1991,7,0,10,2,19
1/9/1991,7,0,3,0,10
1/10/1991,9,0,5,1,15
1/11/1991,11,0,9,10,30
1/12/1991,4,0,9,11,24
1/13/1991,7,0,9,8,24
1/14/1991,6,0,4,8,18
1/15/1991,10,0,8,9,27
1/16/1991,10,0,6,1,17
1/17/1991,7,0,3,8,18
1/18/1991,12,0,8,5,25
1/19/1991,4,0,9,9,22
1/20/1991,9,0,2,4,15
1/21/1991,10,0,2,5,17
1/22/1991,6,0,8,1,15
1/23/1991,7,0,7,2,16
1/24/1991,7,0,6,8,21
1/25/1991,11,0,8,8,27
1/26/1991,10,0,8,0,18
1/27/1991,5,0,9,0,14
1/28/1991,5,0,3,6,14
1/29/1991,8,0,7,2,17
1/30/1991,10,0,8,9,27
1/31/1991,12,0,8,0,20
2/1/1991,12,0,5,9,26
2/2/1991,5,0,4,9,18
2/3/1991,7,0,7,8,22
2/4/1991,12,0,3,10,25
2/5/1991,5,0,4,3,12
2/6/1991,5,0,3,6,14
2/7/1991,5,0,8,10,23
2/8/1991,11,0,4,2,17
2/9/1991,7,0,9,1,17
2/10/1991,10,0,3,7,20
2/11/1991,5,0,9,11,25
2/12/1991,12,0,10,8,30
2/13/1991,4,0,6,8,18
2/14/1991,6,0,8,9,23
2/15/1991,11,0,9,8,28
2/16/1991,9,0,10,1,20
2/17/1991,7,0,8,11,26
2/18/1991,9,0,10,6,25
2/19/1991,10,0,3,0,13
2/20/1991,5,0,9,7,21
2/21/1991,12,0,9,6,27
2/22/1991,9,0,9,1,19
2/23/1991,7,0,8,6,21
2/24/1991,9,0,8,7,24
2/25/1991,4,0,5,7,16
2/26/1991,7,0,7,3,17
2/27/1991,4,0,3,9,16
2/28/1991,5,0,4,9,18
3/1/1991,7,0,4,7,18
3/2/1991,7,0,6,10,23
3/3/1991,11,0,4,1,16
3/4/1991,10,0,2,5,17
3/5/1991,10,0,2,10,22
3/6/1991,8,0,2,1,11
3/7/1991,5,0,6,1,12
3/8/1991,8,0,10,6,24
3/9/1991,8,0,6,7,21
3/10/1991,6,0,4,6,16
3/11/1991,7,0,4,1,12
3/12/1991,10,0,2,9,21
3/13/1991,4,0,7,1,12
3/14/1991,7,0,8,8,23
3/15/1991,7,0,3,4,14
3/16/1991,5,0,9,9,23
3/17/1991,6,0,4,8,18
3/18/1991,11,0,9,9,29
3/19/1991,12,0,9,8,29
3/20/1991,11,0,2,8,21
3/21/1991,11,0,2,1,14
3/22/1991,8,0,2,7,17
3/23/1991,6,0,9,9,24
3/24/1991,10,0,6,5,21
3/25/1991,8,0,8,8,24
3/26/1991,8,0,3,3,14
3/27/1991,12,0,5,1,18
3/28/1991,8,0,4,2,14
3/29/1991,4,0,4,2,10
3/30/1991,11,0,9,1,21
3/31/1991,10,0,9,8,27
4/1/1991,9,0,4,8,21
4/2/1991,12,0,7,11,30
4/3/1991,4,0,6,8,18
4/4/1991,9,0,6,10,25
4/5/1991,9,0,6,9,24
4/6/1991,10,0,2,10,22
4/7/1991,6,0,3,8,17
4/8/1991,10,0,2,3,15
4/9/1991,8,0,8,9,25
4/10/1991,11,0,7,0,18
4/11/1991,9,0,3,6,18
4/12/1991,12,0,2,1,15
4/13/1991,6,0,6,1,13
4/14/1991,5,0,9,1,15
4/15/1991,4,0,6,10,20
4/16/1991,12,0,9,9,30
4/17/1991,9,0,10,0,19
4/18/1991,10,0,5,8,23
4/19/1991,5,0,2,8,15
4/20/1991,12,0,10,8,30
4/21/1991,9,0,2,4,15
4/22/1991,5,0,9,7,21
4/23/1991,9,0,9,7,25
4/24/1991,12,0,2,2,16
4/25/1991,9,0,7,0,16
4/26/1991,5,0,9,8,22
4/27/1991,11,0,10,8,29
4/28/1991,12,0,4,1,17
4/29/1991,6,0,5,10,21
4/30/1991,10,0,2,10,22
5/1/1991,8,0,3,11,22
5/2/1991,7,0,8,4,19
5/3/1991,5,0,10,10,25
5/4/1991,8,0,7,1,16
5/5/1991,6,0,8,11,25
5/6/1991,6,0,2,1,9
5/7/1991,6,0,7,7,20
5/8/1991,8,0,9,7,24
5/9/1991,6,0,2,8,16
5/10/1991,7,0,9,10,26
5/11/1991,9,0,4,10,23
5/12/1991,6,0,2,9,17
5/13/1991,11,0,4,4,19
5/14/1991,7,0,8,0,15
5/15/1991,12,0,9,3,24
5/16/1991,9,0,10,6,25
5/17/1991,4,0,10,6,20
5/18/1991,9,0,8,6,23
5/19/1991,10,0,5,0,15
5/20/1991,6,0,7,0,13
5/21/1991,8,0,8,5,21
5/22/1991,11,0,7,5,23
5/23/1991,11,0,7,0,18
5/24/1991,10,0,7,5,22
5/25/1991,10,0,5,3,18
5/26/1991,11,0,6,6,23
5/27/1991,7,0,5,0,12
5/28/1991,12,0,10,5,27
5/29/1991,10,0,6,3,19
5/30/1991,8,0,6,9,23
5/31/1991,7,0,2,7,16
6/1/1991,11,0,7,2,20
6/2/1991,6,0,8,4,18
6/3/1991,6,0,3,4,13
6/4/1991,10,0,9,11,30
6/5/1991,5,0,5,3,13
6/6/1991,6,0,4,2,12
6/7/1991,7,0,9,5,21
6/8/1991,5,0,10,0,15
6/9/1991,7,0,2,11,20
6/10/1991,12,0,10,6,28
6/11/1991,11,0,6,10,27
6/12/1991,12,0,9,4,25
6/13/1991,12,0,3,3,18
6/14/1991,5,0,4,4,13
6/15/1991,12,0,6,4,22
6/16/1991,7,0,7,0,14
6/17/1991,5,0,6,4,15
6/18/1991,5,0,4,9,18
6/19/1991,7,0,10,8,25
6/20/1991,6,0,5,9,20
6/21/1991,12,0,8,4,24
6/22/1991,9,0,6,11,26
6/23/1991,12,0,5,9,26
6/24/1991,4,0,2,5,11
6/25/1991,7,0,2,11,20
6/26/1991,5,0,10,4,19
6/27/1991,7,0,5,1,13
6/28/1991,7,0,4,10,21
6/29/1991,9,0,4,0,13
6/30/1991,10,0,5,3,18
7/1/1991,7,0,6,8,21
7/2/1991,5,0,6,2,13
7/3/1991,6,0,6,7,19
7/4/1991,10,0,10,10,30
7/5/1991,11,0,7,9,27
7/6/1991,7,0,9,10,26
7/7/1991,8,0,7,1,16
7/8/1991,4,0,7,10,21
7/9/1991,8,0,10,10,28
7/10/1991,12,0,10,10,32
7/11/1991,10,0,3,0,13
7/12/1991,4,0,10,7,21
7/13/1991,10,0,2,11,23
7/14/1991,11,0,4,7,22
7/15/1991,8,0,10,7,25
7/16/1991,4,0,3,8,15
7/17/1991,12,0,8,0,20
7/18/1991,9,0,3,1,13
7/19/1991,10,0,9,0,19
7/20/1991,12,0,8,9,29
7/21/1991,9,0,2,11,22
7/22/1991,5,0,7,7,19
7/23/1991,5,0,10,8,23
7/24/1991,8,0,4,5,17
7/25/1991,9,0,10,11,30
7/26/1991,11,0,3,0,14
7/27/1991,9,0,6,5,20
7/28/1991,11,0,5,9,25
7/29/1991,12,0,9,8,29
7/30/1991,7,0,5,8,20
7/31/1991,8,0,9,8,25
8/1/1991,6,0,3,1,10
8/2/1991,8,0,5,10,23
8/3/1991,4,0,8,7,19
8/4/1991,4,0,2,11,17
8/5/1991,12,0,8,5,25
8/6/1991,10,0,3,5,18
8/7/1991,5,0,4,5,14
8/8/1991,6,0,3,8,17
8/9/1991,6,0,10,2,18
8/10/1991,10,0,6,6,22
8/11/1991,11,0,6,0,17
8/12/1991,6,0,3,7,16
8/13/1991,5,0,5,0,10
8/14/1991,4,0,2,9,15
8/15/1991,8,0,2,3,13
8/16/1991,10,0,4,9,23
8/17/1991,5,0,8,4,17
8/18/1991,4,0,2,10,16
8/19/1991,10,0,2,0,12
8/20/1991,6,0,9,4,19
8/21/1991,4,0,2,9,15
8/22/1991,5,0,4,5,14
8/23/1991,8,0,8,1,17
8/24/1991,4,0,4,11,19
8/25/1991,12,0,5,4,21
8/26/1991,4,0,5,3,12
8/27/1991,10,0,2,4,16
8/28/1991,4,0,8,1,13
8/29/1991,10,0,3,5,18
8/30/1991,4,0,3,1,8
8/31/1991,9,0,4,7,20
9/1/1991,8,0,10,2,20
9/2/1991,10,0,3,4,17
9/3/1991,10,0,9,8,27
9/4/1991,9,0,6,9,24
9/5/1991,6,0,7,4,17
9/6/1991,5,0,5,8,18
9/7/1991,5,0,10,11,26
9/8/1991,11,0,3,8,22
9/9/1991,7,0,8,6,21
9/10/1991,8,0,3,11,22
9/11/1991,5,0,8,2,15
9/12/1991,8,0,8,1,17
9/13/1991,12,0,2,1,15
9/14/1991,9,0,3,10,22
9/15/1991,4,0,5,0,9
9/16/1991,7,0,9,3,19
9/17/1991,8,0,7,6,21
9/18/1991,6,0,4,9,19
9/19/1991,12,0,9,10,31
9/20/1991,7,0,4,1,12
9/21/1991,6,0,7,6,19
9/22/1991,11,0,7,5,23
9/23/1991,9,0,2,7,18
9/24/1991,6,0,7,2,15
9/25/1991,10,0,3,10,23
9/26/1991,9,0,4,4,17
9/27/1991,7,0,9,5,21
9/28/1991,12,0,6,9,27
9/29/1991,5,0,4,2,11
9/30/1991,8,0,4,5,17
10/1/1991,7,0,3,10,20
10/2/1991,10,0,5,9,24
10/3/1991,7,0,10,5,22
10/4/1991,4,0,3,4,11
10/5/1991,11,0,6,11,28
10/6/1991,11,0,7,7,25
10/7/1991,9,0,3,5,17
10/8/1991,7,0,2,5,14
10/9/1991,7,0,2,6,15
10/10/1991,10,0,9,11,30
10/11/1991,6,0,2,6,14
10/12/1991,7,0,6,3,16
10/13/1991,11,0,9,0,20
10/14/1991,9,0,8,6,23
10/15/1991,9,0,9,1,19
10/16/1991,8,0,6,0,14
10/17/1991,9,0,6,0,15
10/18/1991,11,0,8,9,28
10/19/1991,10,0,2,6,18
10/20/1991,6,0,4,1,11
10/21/1991,5,0,2,1,8
10/22/1991,8,0,3,1,12
10/23/1991,5,0,8,3,16
10/24/1991,5,0,6,3,14
10/25/1991,4,0,7,4,15
10/26/1991,12,0,7,11,30
10/27/1991,8,0,6,1,15
10/28/1991,12,0,4,4,20
10/29/1991,8,0,7,1,16
10/30/1991,11,0,7,5,23
10/31/1991,12,0,8,5,25
11/1/1991,11,0,2,1,14
11/2/1991,8,0,6,5,19
11/3/1991,11,0,4,1,16
11/4/1991,9,0,2,5,16
11/5/1991,6,0,3,2,11
11/6/1991,11,0,2,10,23
11/7/1991,6,0,7,6,19
11/8/1991,7,0,9,6,22
11/9/1991,7,0,6,10,23
11/10/1991,11,0,2,5,18
11/11/1991,9,0,10,0,19
11/12/1991,4,0,3,1,8
11/13/1991,5,0,7,1,13
11/14/1991,6,0,10,2,18
11/15/1991,4,0,3,3,10
11/16/1991,5,0,4,0,9
11/17/1991,8,0,3,10,21
11/18/1991,11,0,8,9,28
11/19/1991,7,0,3,5,15
11/20/1991,12,0,4,3,19
11/21/1991,10,0,9,4,23
11/22/1991,7,0,8,8,23
11/23/1991,9,0,5,4,18
11/24/1991,10,0,9,4,23
11/25/1991,4,0,8,10,22
11/26/1991,11,0,4,5,20
11/27/1991,10,0,6,10,26
11/28/1991,5,0,4,11,20
11/29/1991,9,0,3,0,12
11/30/1991,6,0,3,8,17
12/1/1991,6,0,9,7,22
12/2/1991,10,0,4,0,14
12/3/1991,10,0,4,6,20
12/4/1991,8,0,4,1,13
12/5/1991,7,0,7,6,20
12/6/1991,4,0,10,11,25
12/7/1991,6,0,5,8,19
12/8/1991,7,0,6,3,16
12/9/1991,11,0,3,11,25
12/10/1991,9,0,5,10,24
12/11/1991,4,0,6,1,11
12/12/1991,12,0,7,1,20
12/13/1991,11,0,4,5,20
12/14/1991,6,0,9,6,21
12/15/1991,5,0,9,6,20
12/16/1991,8,0,9,9,26
12/17/1991,8,0,4,6,18
12/18/1991,12,0,3,2,17
12/19/1991,7,0,4,7,18
12/20/1991,6,0,5,6,17
12/21/1991,6,0,2,4,12
12/22/1991,10,0,8,5,23
12/23/1991,5,0,7,11,23
12/24/1991,5,0,2,7,14
12/25/1991,5,0,10,9,24
12/26/1991,7,0,6,2,15
12/27/1991,12,0,10,4,26
12/28/1991,4,0,4,8,16
12/29/1991,12,0,2,5,19
12/30/1991,8,0,10,10,28
12/31/1991,12,0,4,4,20
1/1/1992,9,0,8,11,28
1/2/1992,4,0,2,3,9
1/3/1992,4,0,6,7,17
1/4/1992,12,0,10,0,22
1/5/1992,8,0,5,2,15
1/6/1992,6,0,10,5,21
1/7/1992,5,0,9,6,20
1/8/1992,11,0,10,8,29
1/9/1992,7,0,9,3,19
1/10/1992,9,0,2,3,14
1/11/1992,11,0,2,0,13
1/12/1992,12,0,3,4,19
1/13/1992,4,0,6,9,19
1/14/1992,6,0,3,10,19
1/15/1992,8,0,9,7,24
1/16/1992,4,0,2,1,7
1/17/1992,5,0,6,5,16
1/18/1992,8,0,2,8,18
1/19/1992,10,0,8,3,21
1/20/1992,12,0,4,11,27
1/21/1992,11,0,4,7,22
1/22/1992,8,0,8,0,16
1/23/1992,8,0,10,0,18
1/24/1992,6,0,7,9,22
1/25/1992,9,0,3,0,12
1/26/1992,12,0,8,8,28
1/27/1992,12,0,9,11,32
1/28/1992,12,0,6,0,18
1/29/1992,9,0,2,0,11
1/30/1992,11,0,6,11,28
1/31/1992,4,0,8,9,21
2/1/1992,10,0,9,2,21
2/2/1992,11,0,10,6,27
2/3/1992,9,0,4,4,17
2/4/1992,7,0,7,1,15
2/5/1992,12,0,8,4,24
2/6/1992,5,0,4,6,15
2/7/1992,5,0,8,3,16
2/8/1992,6,0,3,6,15
2/9/1992,12,0,10,10,32
2/10/1992,11,0,4,4,19
2/11/1992,5,0,10,11,26
2/12/1992,9,0,8,6,23
2/13/1992,10,0,2,6,18
2/14/1992,10,0,7,10,27
2/15/1992,6,0,8,10,24
2/16/1992,12,0,7,5,24
2/17/1992,7,0,10,3,20
2/18/1992,11,0,5,8,24
2/19/1992,8,0,8,8,24
2/20/1992,8,0,4,9,21
2/21/1992,9,0,10,9,28
2/22/1992,8,0,7,2,17
2/23/1992,11,0,3,4,18
2/24/1992,5,0,9,0,14
2/25/1992,8,0,5,5,18
2/26/1992,7,0,4,2,13
2/27/1992,9,0,4,9,22
2/28/1992,6,0,2,0,8
2/29/1992,9,0,9,7,25
3/1/1992,8,0,5,6,19
3/2/1992,10,0,6,7,23
3/3/1992,4,0,2,11,17
3/4/1992,7,0,9,5,21
3/5/1992,11,0,8,7,26
3/6/1992,8,0,4,8,20
3/7/1992,9,0,5,1,15
3/8/1992,4,0,3,0,7
3/9/1992,8,0,5,11,24
3/10/1992,9,0,4,9,22
3/11/1992,5,0,3,8,16
3/12/1992,9,0,7,3,19
3/13/1992,8,0,2,10,20
3/14/1992,10,0,7,11,28
3/15/1992,7,0,5,3,15
3/16/1992,9,0,2,6,17
3/17/1992,6,0,9,2,17
3/18/1992,5,0,9,3,17
3/19/1992,11,0,6,2,19
3/20/1992,8,0,5,6,19
3/21/1992,4,0,4,10,18
3/22/1992,10,0,2,11,23
3/23/1992,11,0,8,8,27
3/24/1992,4,0,10,7,21
3/25/1992,5,0,3,0,8
3/26/1992,7,0,8,3,18
3/27/1992,10,0,7,9,26
3/28/1992,9,0,4,0,13
3/29/1992,10,0,9,5,24
3/30/1992,12,0,2,10,24
3/31/1992,11,0,5,8,24
4/1/1992,6,0,10,6,22
4/2/1992,11,0,4,3,18
4/3/1992,9,0,6,7,22
4/4/1992,7,0,2,4,13
4/5/1992,8,0,6,1,15
4/6/1992,8,0,8,11,27
4/7/1992,5,0,2,5,12
4/8/1992,12,0,3,1,16
4/9/1992,12,0,6,2,20
4/10/1992,8,0,2,3,13
4/11/1992,6,0,10,8,24
4/12/1992,12,0,4,2,18
4/13/1992,9,0,4,6,19
4/14/1992,11,0,2,6,19
4/15/1992,11,0,2,2,15
4/16/1992,12,0,5,0,17
4/17/1992,6,0,6,2,14
4/18/1992,11,0,7,8,26
4/19/1992,5,0,5,8,18
4/20/1992,10,0,10,4,24
4/21/1992,12,0,4,8,24
4/22/1992,10,0,5,11,26
4/23/1992,7,0,4,11,22
4/24/1992,10,0,4,8,22
4/25/1992,12,0,4,5,21
4/26/1992,6,0,4,3,13
4/27/1992,9,0,4,1,14
4/28/1992,9,0,4,5,18
4/29/1992,10,0,3,11,24
4/30/1992,12,0,6,5,23
5/1/1992,6,0,3,10,19
5/2/1992,7,0,4,10,21
5/3/1992,6,0,7,10,23
5/4/1992,6,0,6,8,20
5/5/1992,5,0,5,2,12
5/6/1992,9,0,10,8,27
5/7/1992,10,0,10,5,25
5/8/1992,8,0,9,1,18
5/9/1992,9,0,3,0,12
5/10/1992,4,0,10,9,23
5/11/1992,10,0,7,3,20
5/12/1992,6,0,8,0,14
5/13/1992,10,0,4,10,24
5/14/1992,6,0,2,0,8
5/15/1992,6,0,7,9,22
5/16/1992,10,0,9,9,28
5/17/1992,10,0,9,4,23
5/18/1992,6,0,9,3,18
5/19/1992,11,0,4,3,18
5/20/1992,10,0,6,1,17
5/21/1992,7,0,7,4,18
5/22/1992,10,0,10,0,20
5/23/1992,9,0,4,9,22
5/24/1992,9,0,4,4,17
5/25/1992,12,0,10,7,29
5/26/1992,11,0,10,8,29
5/27/1992,10,0,3,0,13
5/28/1992,7,0,8,1,16
5/29/1992,5,0,2,11,18
5/30/1992,12,0,8,2,22
5/31/1992,8,0,4,5,17
6/1/1992,11,0,7,6,24
6/2/1992,4,0,4,9,17
6/3/1992,10,0,10,9,29
6/4/1992,11,0,8,8,27
6/5/1992,7,0,4,10,21
6/6/1992,9,0,5,1,15
6/7/1992,10,0,8,7,25
6/8/1992,11,0,7,8,26
6/9/1992,11,0,9,9,29
6/10/1992,6,0,2,5,13
6/11/1992,4,0,9,3,16
6/12/1992,6,0,8,3,17
6/13/1992,6,0,6,0,12
6/14/1992,6,0,7,2,15
6/15/1992,6,0,5,5,16
6/16/1992,5,0,7,1,13
6/17/1992,6,0,8,9,23
6/18/1992,5,0,8,6,19
6/19/1992,6,0,6,6,18
6/20/1992,4,0,7,9,20
6/21/1992,5,0,2,11,18
6/22/1992,9,0,2,5,16
6/23/1992,12,0,10,7,29
6/24/1992,11,0,3,1,15
6/25/1992,4,0,10,3,17
6/26/1992,12,0,10,5,27
6/27/1992,4,0,7,10,21
6/28/1992,12,0,3,11,26
6/29/1992,4,0,8,3,15
6/30/1992,11,0,5,7,23
7/1/1992,7,0,6,8,21
7/2/1992,6,0,10,3,19
7/3/1992,12,0,7,4,23
7/4/1992,11,0,10,6,27
7/5/1992,9,0,3,10,22
7/6/1992,9,0,3,0,12
7/7/1992,7,0,4,1,12
7/8/1992,7,0,10,9,26
7/9/1992,4,0,4,7,15
7/10/1992,11,0,9,6,26
7/11/1992,12,0,10,6,28
7/12/1992,10,0,8,8,26
7/13/1992,6,0,2,9,17
7/14/1992,6,0,5,8,19
7/15/1992,7,0,2,6,15
7/16/1992,9,0,10,0,19
7/17/1992,11,0,7,8,26
7/18/1992,4,0,10,4,18
7/19/1992,6,0,3,9,18
7/20/1992,8,0,3,3,14
7/21/1992,4,0,8,3,15
7/22/1992,9,0,6,10,25
7/23/1992,4,0,5,7,16
7/24/1992,8,0,3,5,16
7/25/1992,7,0,3,6,16
7/26/1992,12,0,4,3,19
7/27/1992,8,0,10,4,22
7/28/1992,4,0,6,5,15
7/29/1992,12,0,5,10,27
7/30/1992,9,0,9,4,22
7/31/1992,6,0,10,11,27
8/1/1992,12,0,9,5,26
8/2/1992,4,0,7,0,11
8/3/1992,4,0,10,0,14
8/4/1992,8,0,4,3,15
8/5/1992,10,0,9,8,27
8/6/1992,10,0,6,9,25
8/7/1992,4,0,3,3,10
8/8/1992,10,0,10,7,27
8/9/1992,8,0,2,6,16
8/10/1992,12,0,10,4,26
8/11/1992,8,0,4,5,17
8/12/1992,6,0,2,2,10
8/13/1992,9,0,2,9,20
8/14/1992,11,0,5,3,19
8/15/1992,5,0,4,6,15
8/16/1992,8,0,5,9,22
8/17/1992,6,0,8,8,22
8/18/1992,10,0,10,6,26
8/19/1992,5,0,6,4,15
8/20/1992,8,0,9,10,27
8/21/1992,9,0,2,11,22
8/22/1992,11,0,10,9,30
8/23/1992,10,0,2,6,18
8/24/1992,7,0,5,9,21
8/25/1992,4,0,8,5,17
8/26/1992,7,0,4,4,15
8/27/1992,10,0,5,3,18
8/28/1992,11,0,9,4,24
8/29/1992,7,0,8,9,24
8/30/1992,5,0,5,10,20
8/31/1992,11,0,2,4,17
9/1/1992,11,0,10,10,31
9/2/1992,4,0,3,6,13
9/3/1992,9,0,9,10,28
9/4/1992,7,0,2,9,18
9/5/1992,7,0,2,4,13
9/6/1992,11,0,9,11,31
9/7/1992,8,0,10,1,19
9/8/1992,10,0,5,8,23
9/9/1992,11,0,9,4,24
9/10/1992,10,0,8,8,26
9/11/1992,9,0,2,6,17
9/12/1992,4,0,9,9,22
9/13/1992,8,0,3,4,15
9/14/1992,7,0,9,9,25
9/15/1992,9,0,4,0,13
9/16/1992,8,0,8,2,18
9/17/1992,9,0,3,3,15
9/18/1992,10,0,9,1,20
9/19/1992,6,0,6,0,12
9/20/1992,7,0,4,6,17
9/21/1992,12,0,5,10,27
9/22/1992,6,0,10,3,19
9/23/1992,10,0,10,10,30
9/24/1992,12,0,9,6,27
9/25/1992,6,0,8,11,25
9/26/1992,8,0,7,1,16
9/27/1992,7,0,7,11,25
9/28/1992,10,0,4,4,18
9/29/1992,11,0,8,9,28
9/30/1992,4,0,6,1,11
10/1/1992,12,0,5,8,25
10/2/1992,6,0,3,1,10
10/3/1992,7,0,3,2,12
10/4/1992,8,0,9,6,23
10/5/1992,11,0,10,11,32
10/6/1992,9,0,8,0,17
10/7/1992,6,0,10,8,24
10/8/1992,12,0,10,9,31
10/9/1992,11,0,5,10,26
10/10/1992,11,0,9,5,25
10/11/1992,7,0,5,9,21
10/12/1992,9,0,7,0,16
10/13/1992,7,0,3,5,15
10/14/1992,7,0,9,1,17
10/15/1992,4,0,9,1,14
10/16/1992,5,0,3,8,16
10/17/1992,10,0,2,10,22
10/18/1992,4,0,9,10,23
10/19/1992,11,0,6,10,27
10/20/1992,12,0,3,6,21
10/21/1992,9,0,10,5,24
10/22/1992,10,0,8,6,24
10/23/1992,9,0,2,5,16
10/24/1992,9,0,7,1,17
10/25/1992,8,0,3,9,20
10/26/1992,11,0,9,1,21
10/27/1992,6,0,5,10,21
10/28/1992,10,0,3,7,20
10/29/1992,12,0,4,2,18
10/30/1992,9,0,10,1,20
10/31/1992,11,0,3,5,19
11/1/1992,4,0,8,3,15
11/2/1992,4,0,8,4,16
11/3/1992,9,0,8,1,18
11/4/1992,11,0,7,3,21
11/5/1992,5,0,4,5,14
11/6/1992,7,0,5,1,13
11/7/1992,8,0,4,5,17
11/8/1992,4,0,9,5,18
11/9/1992,9,0,8,9,26
11/10/1992,12,0,7,9,28
11/11/1992,5,0,9,11,25
11/12/1992,9,0,5,10,24
11/13/1992,6,0,4,4,14
11/14/1992,11,0,10,7,28
11/15/1992,7,0,5,7,19
11/16/1992,4,0,4,7,15
11/17/1992,11,0,2,2,15
11/18/1992,7,0,10,11,28
11/19/1992,4,0,3,5,12
11/20/1992,5,0,5,0,10
11/21/1992,10,0,2,8,20
11/22/1992,12,0,2,0,14
11/23/1992,7,0,3,8,18
11/24/1992,8,0,3,4,15
11/25/1992,10,0,8,3,21
11/26/1992,11,0,7,1,19
11/27/1992,8,0,9,8,25
11/28/1992,7,0,8,7,22
11/29/1992,10,0,8,6,24
11/30/1992,4,0,2,3,9
12/1/1992,5,0,10,5,20
12/2/1992,5,0,5,8,18
12/3/1992,6,0,9,2,17
12/4/1992,8,0,6,1,15
12/5/1992,7,0,6,11,24
12/6/1992,8,0,10,6,24
12/7/1992,7,0,2,7,16
12/8/1992,12,0,4,11,27
12/9/1992,8,0,5,2,15
12/10/1992,11,0,8,8,27
12/11/1992,6,0,9,11,26
12/12/1992,12,0,6,6,24
12/13/1992,5,0,2,2,9
12/14/1992,7,0,4,11,22
12/15/1992,8,0,6,6,20
12/16/1992,11,0,3,10,24
12/17/1992,4,0,4,4,12
12/18/1992,12,0,5,7,24
12/19/1992,8,0,2,4,14
12/20/1992,5,0,7,1,13
12/21/1992,10,0,4,9,23
12/22/1992,9,0,9,10,28
12/23/1992,8,0,2,3,13
12/24/1992,4,0,9,6,19
12/25/1992,12,0,9,4,25
12/26/1992,11,0,7,1,19
12/27/1992,11,0,4,11,26
12/28/1992,11,0,2,1,14
12/29/1992,6,0,4,4,14
12/30/1992,6,0,6,10,22
12/31/1992,9,0,9,5,23
1/1/1993,7,0,4,7,18
1/2/1993,12,0,5,1,18
1/3/1993,9,0,8,0,17
1/4/1993,11,0,6,7,24
1/5/1993,6,0,10,6,22
1/6/1993,10,0,6,6,22
1/7/1993,11,0,10,8,29
1/8/1993,12,0,3,8,23
1/9/1993,11,0,9,2,22
1/10/1993,10,0,8,0,18
1/11/1993,12,0,7,9,28
1/12/1993,4,0,2,5,11
1/13/1993,5,0,10,0,15
1/14/1993,12,0,2,6,20
1/15/1993,4,0,8,7,19
1/16/1993,6,0,4,2,12
1/17/1993,12,0,5,8,25
1/18/1993,8,0,4,10,22
1/19/1993,5,0,9,9,23
1/20/1993,8,0,2,9,19
1/21/1993,6,0,2,0,8
1/22/1993,12,0,4,1,17
1/23/1993,9,0,4,6,19
1/24/1993,9,0,4,6,19
1/25/1993,12,0,5,1,18
1/26/1993,6,0,3,6,15
1/27/1993,4,0,8,6,18
1/28/1993,11,0,7,1,19
1/29/1993,5,0,8,4,17
1/30/1993,6,0,8,7,21
1/31/1993,5,0,9,4,18
2/1/1993,6,0,9,4,19
2/2/1993,6,0,7,5,18
2/3/1993,12,0,4,6,22
2/4/1993,12,0,8,9,29
2/5/1993,7,0,3,5,15
2/6/1993,11,0,9,5,25
2/7/1993,11,0,2,2,15
2/8/1993,12,0,6,10,28
2/9/1993,6,0,9,11,26
2/10/1993,9,0,7,6,22
2/11/1993,8,0,6,11,25
2/12/1993,8,0,4,1,13
2/13/1993,4,0,4,7,15
2/14/1993,6,0,4,3,13
2/15/1993,7,0,8,11,26
2/16/1993,9,0,7,6,22
2/17/1993,10,0,2,11,23
2/18/1993,10,0,8,11,29
2/19/1993,7,0,9,4,20
2/20/1993,9,0,8,6,23
2/21/1993,12,0,2,11,25
2/22/1993,6,0,8,3,17
2/23/1993,4,0,6,5,15
2/24/1993,5,0,9,2,16
2/25/1993,12,0,10,11,33
2/26/1993,10,0,10,3,23
2/27/1993,4,0,6,2,12
2/28/1993,6,0,10,9,25
3/1/1993,10,0,10,3,23
3/2/1993,7,0,8,3,18
3/3/1993,8,0,7,11,26
3/4/1993,5,0,8,9,22
3/5/1993,9,0,5,10,24
3/6/1993,11,0,6,7,24
3/7/1993,12,0,6,2,20
3/8/1993,9,0,7,7,23
3/9/1993,5,0,5,7,17
3/10/1993,6,0,2,4,12
3/11/1993,11,0,4,5,20
3/12/1993,11,0,9,8,28
3/13/1993,11,0,5,8,24
3/14/1993,5,0,4,5,14
3/15/1993,4,0,8,9,21
3/16/1993,6,0,2,5,13
3/17/1993,5,0,10,0,15
3/18/1993,9,0,10,3,22
3/19/1993,6,0,5,6,17
3/20/1993,10,0,7,11,28
3/21/1993,8,0,5,2,15
3/22/1993,6,0,8,4,18
3/23/1993,4,0,10,10,24
3/24/1993,11,0,7,8,26
3/25/1993,6,0,2,7,15
3/26/1993,10,0,7,2,19
3/27/1993,8,0,4,1,13
3/28/1993,12,0,8,1,21
3/29/1993,8,0,8,2,18
3/30/1993,10,0,8,4,22
3/31/1993,8,0,8,7,23
4/1/1993,10,0,10,6,26
4/2/1993,8,0,4,7,19
4/3/1993,9,0,9,6,24
4/4/1993,7,0,9,2,18
4/5/1993,4,0,3,3,10
4/6/1993,8,0,8,8,24
4/7/1993,4,0,9,5,18
4/8/1993,8,0,2,2,12
4/9/1993,10,0,8,1,19
4/10/1993,7,0,4,3,14
4/11/1993,11,0,2,3,16
4/12/1993,10,0,8,3,21
4/13/1993,10,0,3,1,14
4/14/1993,4,0,6,10,20
4/15/1993,12,0,7,3,22
4/16/1993,7,0,8,6,21
4/17/1993,11,0,3,5,19
4/18/1993,11,0,4,9,24
4/19/1993,8,0,4,9,21
4/20/1993,10,0,10,6,26
4/21/1993,11,0,3,4,18
4/22/1993,6,0,4,4,14
4/23/1993,6,0,7,0,13
4/24/1993,8,0,5,1,14
4/25/1993,10,0,3,3,16
4/26/1993,6,0,2,4,12
4/27/1993,6,0,8,9,23
4/28/1993,7,0,7,9,23
4/29/1993,4,0,6,8,18
4/30/1993,6,0,9,10,25
5/1/1993,8,0,8,4,20
5/2/1993,12,0,9,0,21
5/3/1993,7,0,10,0,17
5/4/1993,4,0,6,5,15
5/5/1993,6,0,7,0,13
5/6/1993,9,0,5,0,14
5/7/1993,10,0,5,2,17
5/8/1993,7,0,8,1,16
5/9/1993,10,0,6,3,19
5/10/1993,11,0,8,7,26
5/11/1993,12,0,10,7,29
5/12/1993,5,0,8,0,13
5/13/1993,5,0,2,0,7
5/14/1993,6,0,10,6,22
5/15/1993,4,0,5,8,17
5/16/1993,7,0,7,3,17
5/17/1993,9,0,3,7,19
5/18/1993,9,0,4,0,13
5/19/1993,8,0,6,11,25
5/20/1993,6,0,10,10,26
5/21/1993,7,0,9,4,20
5/22/1993,11,0,8,3,22
5/23/1993,11,0,9,2,22
5/24/1993,12,0,3,2,17
5/25/1993,10,0,4,10,24
5/26/1993,12,0,3,8,23
5/27/1993,12,0,7,11,30
5/28/1993,12,0,4,11,27
5/29/1993,8,0,6,5,19
5/30/1993,9,0,8,6,23
5/31/1993,5,0,8,0,13
6/1/1993,4,0,8,6,18
6/2/1993,5,0,8,1,14
6/3/1993,7,0,4,11,22
6/4/1993,7,0,10,4,21
6/5/1993,6,0,6,7,19
6/6/1993,4,0,6,6,16
6/7/1993,9,0,3,7,19
6/8/1993,11,0,10,4,25
6/9/1993,6,0,3,9,18
6/10/1993,8,0,5,8,21
6/11/1993,8,0,9,0,17
6/12/1993,9,0,2,0,11
6/13/1993,12,0,2,11,25
6/14/1993,8,0,2,9,19
6/15/1993,8,0,7,0,15
6/16/1993,10,0,9,3,22
6/17/1993,6,0,10,10,26
6/18/1993,11,0,3,1,15
6/19/1993,12,0,2,6,20
6/20/1993,4,0,6,4,14
6/21/1993,10,0,3,1,14
6/22/1993,5,0,4,7,16
6/23/1993,4,0,5,3,12
6/24/1993,4,0,3,7,14
6/25/1993,12,0,4,0,16
6/26/1993,8,0,2,4,14
6/27/1993,12,0,3,7,22
6/28/1993,11,0,9,1,21
6/29/1993,7,0,4,5,16
6/30/1993,5,0,5,0,10
7/1/1993,8,0,7,8,23
7/2/1993,8,0,3,6,17
7/3/1993,6,0,7,10,23
7/4/1993,4,0,2,0,6
7/5/1993,8,0,2,9,19
7/6/1993,7,0,6,3,16
7/7/1993,6,0,9,4,19
7/8/1993,12,0,4,8,24
7/9/1993,10,0,6,3,19
7/10/1993,4,0,9,1,14
7/11/1993,9,0,3,2,14
7/12/1993,8,0,8,6,22
7/13/1993,10,0,6,8,24
7/14/1993,12,0,3,6,21
7/15/1993,6,0,4,4,14
7/16/1993,4,0,2,9,15
7/17/1993,4,0,5,11,20
7/18/1993,9,0,9,6,24
7/19/1993,7,0,2,3,12
7/20/1993,9,0,2,9,20
7/21/1993,6,0,4,6,16
7/22/1993,11,0,2,11,24
7/23/1993,12,0,3,7,22
7/24/1993,5,0,9,8,22
7/25/1993,7,0,9,8,24
7/26/1993,4,0,5,7,16
7/27/1993,7,0,3,2,12
7/28/1993,4,0,4,4,12
7/29/1993,11,0,8,1,20
7/30/1993,6,0,10,4,20
7/31/1993,6,0,3,6,15
8/1/1993,11,0,6,4,21
8/2/1993,7,0,5,5,17
8/3/1993,9,0,3,3,15
8/4/1993,5,0,2,11,18
8/5/1993,5,0,8,5,18
8/6/1993,9,0,8,0,17
8/7/1993,9,0,3,6,18
8/8/1993,6,0,8,4,18
8/9/1993,5,0,6,11,22
8/10/1993,8,0,5,10,23
8/11/1993,4,0,7,3,14
8/12/1993,12,0,4,10,26
8/13/1993,12,0,3,3,18
8/14/1993,6,0,9,11,26
8/15/1993,6,0,3,4,13
8/16/1993,7,0,5,5,17
8/17/1993,4,0,7,7,18
8/18/1993,6,0,3,7,16
8/19/1993,7,0,4,0,11
8/20/1993,5,0,3,5,13
8/21/1993,5,0,7,9,21
8/22/1993,4,0,2,11,17
8/23/1993,5,0,10,9,24
8/24/1993,4,0,3,4,11
8/25/1993,9,0,8,1,18
8/26/1993,9,0,3,11,23
8/27/1993,10,0,5,0,15
8/28/1993,6,0,6,3,15
8/29/1993,11,0,9,10,30
8/30/1993,12,0,8,9,29
8/31/1993,10,0,4,8,22
9/1/1993,4,0,6,3,13
9/2/1993,5,0,7,4,16
9/3/1993,10,0,10,6,26
9/4/1993,5,0,3,0,8
9/5/1993,7,0,10,8,25
9/6/1993,10,0,5,6,21
9/7/1993,8,0,8,6,22
9/8/1993,5,0,4,1,10
9/9/1993,10,0,7,1,18
9/10/1993,6,0,7,7,20
9/11/1993,6,0,9,10,25
9/12/1993,8,0,4,8,20
9/13/1993,6,0,5,7,18
9/14/1993,11,0,7,1,19
9/15/1993,11,0,7,11,29
9/16/1993,7,0,5,10,22
9/17/1993,5,0,9,2,16
9/18/1993,11,0,8,7,26
9/19/1993,6,0,5,4,15
9/20/1993,7,0,4,0,11
9/21/1993,7,0,8,11,26
9/22/1993,10,0,7,6,23
9/23/1993,7,0,8,0,15
9/24/1993,10,0,6,3,19
9/25/1993,8,0,5,1,14
9/26/1993,5,0,2,6,13
9/27/1993,9,0,5,11,25
9/28/1993,11,0,7,0,18
9/29/1993,8,0,5,4,17
9/30/1993,4,0,4,0,8
10/1/1993,9,0,3,4,16
10/2/1993,8,0,2,4,14
10/3/1993,10,0,6,10,26
10/4/1993,8,0,8,11,27
10/5/1993,11,0,10,7,28
10/6/1993,7,0,5,6,18
10/7/1993,7,0,5,2,14
10/8/1993,12,0,4,1,17
10/9/1993,9,0,3,11,23
10/10/1993,5,0,8,10,23
10/11/1993,11,0,3,9,23
10/12/1993,7,0,2,9,18
10/13/1993,7,0,2,4,13
10/14/1993,9,0,10,5,24
10/15/1993,7,0,10,1,18
10/16/1993,5,0,6,6,17
10/17/1993,7,0,2,2,11
10/18/1993,6,0,8,5,19
10/19/1993,12,0,5,3,20
10/20/1993,9,0,3,3,15
10/21/1993,4,0,10,5,19
10/22/1993,6,0,6,9,21
10/23/1993,10,0,8,6,24
10/24/1993,10,0,2,4,16
10/25/1993,10,0,10,10,30
10/26/1993,12,0,10,5,27
10/27/1993,11,0,10,7,28
10/28/1993,5,0,5,7,17
10/29/1993,5,0,9,1,15
10/30/1993,10,0,3,7,20
10/31/1993,6,0,7,5,18
11/1/1993,11,0,4,7,22
11/2/1993,4,0,3,3,10
11/3/1993,8,0,4,2,14
11/4/1993,10,0,5,5,20
11/5/1993,11,0,10,5,26
11/6/1993,6,0,5,1,12
11/7/1993,12,0,7,5,24
11/8/1993,9,0,4,5,18
11/9/1993,7,0,2,11,20
11/10/1993,11,0,3,5,19
11/11/1993,7,0,2,2,11
11/12/1993,9,0,10,4,23
11/13/1993,9,0,8,1,18
11/14/1993,9,0,4,9,22
11/15/1993,10,0,4,2,16
11/16/1993,9,0,5,8,22
11/17/1993,12,0,5,5,22
11/18/1993,5,0,4,10,19
11/19/1993,7,0,9,7,23
11/20/1993,7,0,10,0,17
11/21/1993,7,0,9,9,25
11/22/1993,11,0,8,1,20
11/23/1993,5,0,7,8,20
11/24/1993,10,0,2,4,16
11/25/1993,11,0,7,11,29
11/26/1993,6,0,2,11,19
11/27/1993,6,0,6,11,23
11/28/1993,4,0,3,5,12
11/29/1993,8,0,7,2,17
11/30/1993,5,0,9,9,23
12/1/1993,6,0,3,11,20
12/2/1993,4,0,2,7,13
12/3/1993,11,0,10,9,30
12/4/1993,12,0,2,8,22
12/5/1993,8,0,2,1,11
12/6/1993,6,0,5,4,15
12/7/1993,6,0,3,11,20
12/8/1993,8,0,2,6,16
12/9/1993,11,0,8,11,30
12/10/1993,11,0,3,7,21
12/11/1993,6,0,10,11,27
12/12/1993,9,0,7,3,19
12/13/1993,6,0,4,2,12
12/14/1993,6,0,5,5,16
12/15/1993,4,0,5,1,10
12/16/1993,12,0,2,2,16
12/17/1993,9,0,8,7,24
12/18/1993,12,0,8,7,27
12/19/1993,6,0,3,1,10
12/20/1993,6,0,8,1,15
12/21/1993,9,0,7,9,25
12/22/1993,12,0,2,2,16
12/23/1993,8,0,8,1,17
12/24/1993,6,0,4,3,13
12/25/1993,5,0,8,0,13
12/26/1993,11,0,10,3,24
12/27/1993,7,0,6,3,16
12/28/1993,6,0,2,1,9
12/29/1993,9,0,7,7,23
12/30/1993,8,0,10,2,20
12/31/1993,8,0,10,4,22
1/1/1994,11,0,5,6,22
1/2/1994,8,0,6,11,25
1/3/1994,8,0,5,11,24
1/4/1994,4,0,2,5,11
1/5/1994,5,0,6,9,20
1/6/1994,10,0,3,8,21
1/7/1994,12,0,4,4,20
1/8/1994,7,0,4,6,17
1/9/1994,10,0,2,8,20
1/10/1994,9,0,7,6,22
1/11/1994,4,0,6,0,10
1/12/1994,5,0,3,6,14
1/13/1994,4,0,6,11,21
1/14/1994,8,0,5,5,18
1/15/1994,12,0,9,3,24
1/16/1994,11,0,9,1,21
1/17/1994,8,0,7,7,22
1/18/1994,4,0,7,1,12
1/19/1994,11,0,5,10,26
1/20/1994,11,0,2,11,24
1/21/1994,10,0,4,10,24
1/22/1994,4,0,8,5,17
1/23/1994,4,0,6,10,20
1/24/1994,4,0,7,1,12
1/25/1994,12,0,5,4,21
1/26/1994,7,0,3,11,21
1/27/1994,12,0,8,2,22
1/28/1994,6,0,4,9,19
1/29/1994,5,0,9,3,17
1/30/1994,9,0,5,10,24
1/31/1994,7,0,7,0,14
2/1/1994,11,0,6,5,22
2/2/1994,8,0,7,11,26
2/3/1994,5,0,3,6,14
2/4/1994,11,0,7,11,29
2/5/1994,11,0,2,6,19
2/6/1994,7,0,9,10,26
2/7/1994,6,0,2,5,13
2/8/1994,11,0,2,5,18
2/9/1994,11,0,3,8,22
2/10/1994,5,0,7,10,22
2/11/1994,12,0,2,0,14
2/12/1994,12,0,6,7,25
2/13/1994,12,0,6,0,18
2/14/1994,6,0,9,7,22
2/15/1994,6,0,8,4,18
2/16/1994,12,0,8,5,25
2/17/1994,4,0,7,2,13
2/18/1994,12,0,3,4,19
2/19/1994,10,0,3,3,16
2/20/1994,8,0,9,8,25
2/21/1994,10,0,4,6,20
2/22/1994,5,0,7,4,16
2/23/1994,11,0,10,1,22
2/24/1994,7,0,10,10,27
2/25/1994,9,0,2,10,21
2/26/1994,7,0,5,9,21
2/27/1994,7,0,9,2,18
2/28/1994,7,0,10,11,28
3/1/1994,6,0,10,6,22
3/2/1994,6,0,7,8,21
3/3/1994,6,0,10,3,19
3/4/1994,6,0,9,9,24
3/5/1994,10,0,7,5,22
3/6/1994,8,0,7,9,24
3/7/1994,10,0,10,4,24
3/8/1994,10,0,2,9,21
3/9/1994,8,0,7,8,23
3/10/1994,4,0,8,9,21
3/11/1994,5,0,5,3,13
3/12/1994,6,0,3,7,16
3/13/1994,12,0,7,9,28
3/14/1994,8,0,9,8,25
3/15/1994,8,0,4,6,18
3/16/1994,4,0,5,9,18
3/17/1994,7,0,7,8,22
3/18/1994,4,0,9,11,24
3/19/1994,7,0,7,7,21
3/20/1994,9,0,6,4,19
3/21/1994,10,0,4,6,20
3/22/1994,4,0,7,6,17
3/23/1994,7,0,7,4,18
3/24/1994,6,0,7,7,20
3/25/1994,4,0,3,4,11
3/26/1994,5,0,4,10,19
3/27/1994,5,0,9,10,24
3/28/1994,9,0,4,8,21
3/29/1994,12,0,6,3,21
3/30/1994,10,0,10,9,29
3/31/1994,8,0,8,11,27
4/1/1994,4,0,10,8,22
4/2/1994,5,0,2,0,7
4/3/1994,9,0,10,1,20
4/4/1994,4,0,6,11,21
4/5/1994,9,0,10,11,30
4/6/1994,5,0,2,6,13
4/7/1994,9,0,8,1,18
4/8/1994,4,0,8,10,22
4/9/1994,12,0,7,7,26
4/10/1994,9,0,3,9,21
4/11/1994,9,0,6,11,26
4/12/1994,10,0,3,1,14
4/13/1994,9,0,9,9,27
4/14/1994,7,0,8,1,16
4/15/1994,10,0,2,7,19
4/16/1994,6,0,7,2,15
4/17/1994,6,0,7,5,18
4/18/1994,11,0,9,3,23
4/19/1994,10,0,4,10,24
4/20/1994,7,0,3,11,21
4/21/1994,12,0,10,0,22
4/22/1994,12,0,10,9,31
4/23/1994,4,0,4,9,17
4/24/1994,11,0,8,5,24
4/25/1994,11,0,5,6,22
4/26/1994,4,0,9,4,17
4/27/1994,7,0,7,9,23
4/28/1994,11,0,8,8,27
4/29/1994,6,0,4,3,13
4/30/1994,12,0,10,8,30
5/1/1994,8,0,10,1,19
5/2/1994,8,0,8,8,24
5/3/1994,11,0,7,11,29
5/4/1994,11,0,6,11,28
5/5/1994,4,0,7,3,14
5/6/1994,8,0,6,0,14
5/7/1994,8,0,6,5,19
5/8/1994,5,0,9,11,25
5/9/1994,6,0,5,10,21
5/10/1994,6,0,3,11,20
5/11/1994,10,0,2,2,14
5/12/1994,8,0,5,0,13
5/13/1994,12,0,9,5,26
5/14/1994,9,0,3,11,23
5/15/1994,7,0,2,10,19
5/16/1994,5,0,8,4,17
5/17/1994,4,0,10,8,22
5/18/1994,12,0,8,7,27
5/19/1994,6,0,10,3,19
5/20/1994,12,0,6,3,21
5/21/1994,12,0,4,4,20
5/22/1994,9,0,6,0,15
5/23/1994,10,0,6,8,24
5/24/1994,6,0,6,7,19
5/25/1994,9,0,5,5,19
5/26/1994,4,0,5,1,10
5/27/1994,5,0,4,6,15
5/28/1994,8,0,5,5,18
5/29/1994,6,0,5,10,21
5/30/1994,6,0,7,10,23
5/31/1994,10,0,5,7,22
6/1/1994,5,0,2,2,9
6/2/1994,5,0,9,3,17
6/3/1994,11,0,5,9,25
6/4/1994,12,0,6,5,23
6/5/1994,7,0,6,10,23
6/6/1994,8,0,9,7,24
6/7/1994,11,0,8,11,30
6/8/1994,8,0,6,4,18
6/9/1994,9,0,4,2,15
6/10/1994,5,0,9,9,23
6/11/1994,10,0,9,8,27
6/12/1994,12,0,5,7,24
6/13/1994,6,0,7,6,19
6/14/1994,9,0,2,3,14
6/15/1994,9,0,3,11,23
6/16/1994,10,0,7,6,23
6/17/1994,11,0,5,0,16
6/18/1994,12,0,9,5,26
6/19/1994,8,0,2,10,20
6/20/1994,10,0,9,4,23
6/21/1994,11,0,10,7,28
6/22/1994,7,0,3,3,13
6/23/1994,7,0,10,9,26
6/24/1994,11,0,10,3,24
6/25/1994,12,0,4,9,25
6/26/1994,4,0,9,2,15
6/27/1994,7,0,4,3,14
6/28/1994,6,0,8,0,14
6/29/1994,11,0,4,6,21
6/30/1994,9,0,8,10,27
7/1/1994,10,0,8,9,27
7/2/1994,8,0,10,10,28
7/3/1994,4,0,4,6,14
7/4/1994,10,0,4,4,18
7/5/1994,11,0,4,8,23
7/6/1994,6,0,4,2,12
7/7/1994,12,0,5,1,18
7/8/1994,5,0,3,0,8
7/9/1994,6,0,4,4,14
7/10/1994,12,0,2,0,14
7/11/1994,6,0,2,5,13
7/12/1994,5,0,6,6,17
7/13/1994,7,0,2,9,18
7/14/1994,5,0,8,7,20
7/15/1994,4,0,10,4,18
7/16/1994,5,0,10,7,22
7/17/1994,4,0,3,7,14
7/18/1994,4,0,6,5,15
7/19/1994,12,0,6,11,29
7/20/1994,8,0,10,3,21
7/21/1994,9,0,9,9,27
7/22/1994,4,0,4,6,14
7/23/1994,8,0,2,1,11
7/24/1994,7,0,5,3,15
7/25/1994,9,0,2,11,22
7/26/1994,4,0,9,11,24
7/27/1994,8,0,6,8,22
7/28/1994,10,0,3,3,16
7/29/1994,10,0,8,10,28
7/30/1994,9,0,7,6,22
7/31/1994,7,0,9,8,24
8/1/1994,12,0,6,0,18
8/2/1994,4,0,4,1,9
8/3/1994,6,0,8,8,22
8/4/1994,12,0,4,5,21
8/5/1994,11,0,9,11,31
8/6/1994,7,0,5,4,16
8/7/1994,6,0,2,5,13
8/8/1994,4,0,6,10,20
8/9/1994,4,0,10,10,24
8/10/1994,7,0,5,9,21
8/11/1994,10,0,8,6,24
8/12/1994,7,0,6,2,15
8/13/1994,12,0,9,4,25
8/14/1994,8,0,7,10,25
8/15/1994,7,0,10,1,18
8/16/1994,10,0,10,7,27
8/17/1994,12,0,4,5,21
8/18/1994,7,0,8,4,19
8/19/1994,10,0,8,3,21
8/20/1994,8,0,10,4,22
8/21/1994,9,0,9,5,23
8/22/1994,5,0,5,2,12
8/23/1994,11,0,8,1,20
8/24/1994,8,0,2,9,19
8/25/1994,7,0,2,11,20
8/26/1994,9,0,3,2,14
8/27/1994,10,0,3,3,16
8/28/1994,10,0,2,0,12
8/29/1994,5,0,9,4,18
8/30/1994,8,0,2,1,11
8/31/1994,5,0,8,6,19
9/1/1994,8,0,9,6,23
9/2/1994,8,0,3,1,12
9/3/1994,11,0,7,11,29
9/4/1994,9,0,5,9,23
9/5/1994,4,0,10,0,14
9/6/1994,8,0,5,4,17
9/7/1994,6,0,7,7,20
9/8/1994,12,0,3,4,19
9/9/1994,10,0,6,8,24
9/10/1994,5,0,4,1,10
9/11/1994,7,0,7,5,19
9/12/1994,10,0,4,10,24
9/13/1994,4,0,6,10,20
9/14/1994,10,0,5,2,17
9/15/1994,5,0,2,5,12
9/16/1994,6,0,10,1,17
9/17/1994,8,0,2,6,16
9/18/1994,9,0,10,7,26
9/19/1994,10,0,6,7,23
9/20/1994,7,0,10,3,20
9/21/1994,9,0,9,6,24
9/22/1994,6,0,7,4,17
9/23/1994,8,0,4,1,13
9/24/1994,11,0,3,8,22
9/25/1994,9,0,4,2,15
9/26/1994,7,0,10,2,19
9/27/1994,11,0,5,1,17
9/28/1994,4,0,8,0,12
9/29/1994,8,0,9,8,25
9/30/1994,6,0,5,0,11
10/1/1994,11,0,2,3,16
10/2/1994,8,0,9,5,22
10/3/1994,4,0,10,6,20
10/4/1994,9,0,5,4,18
10/5/1994,11,0,4,5,20
10/6/1994,8,0,4,5,17
10/7/1994,6,0,6,1,13
10/8/1994,12,0,10,4,26
10/9/1994,8,0,4,8,20
10/10/1994,11,0,8,0,19
10/11/1994,5,0,2,0,7
10/12/1994,12,0,5,2,19
10/13/1994,4,0,2,8,14
10/14/1994,12,0,7,10,29
10/15/1994,6,0,8,11,25
10/16/1994,8,0,7,3,18
10/17/1994,11,0,4,6,21
10/18/1994,6,0,6,10,22
10/19/1994,12,0,7,2,21
10/20/1994,8,0,2,3,13
10/21/1994,10,0,9,4,23
10/22/1994,10,0,8,6,24
10/23/1994,10,0,5,4,19
10/24/1994,4,0,6,3,13
10/25/1994,5,0,2,2,9
10/26/1994,10,0,4,0,14
10/27/1994,7,0,5,1,13
10/28/1994,5,0,8,10,23
10/29/1994,12,0,10,0,22
10/30/1994,4,0,3,4,11
10/31/1994,8,0,5,6,19
11/1/1994,11,0,4,3,18
11/2/1994,9,0,6,2,17
11/3/1994,9,0,10,4,23
11/4/1994,5,0,3,1,9
11/5/1994,7,0,6,9,22
11/6/1994,11,0,5,8,24
11/7/1994,4,0,7,8,19
11/8/1994,6,0,3,2,11
11/9/1994,5,0,9,3,17
11/10/1994,9,0,5,5,19
11/11/1994,4,0,8,6,18
11/12/1994,6,0,5,8,19
11/13/1994,9,0,8,4,21
11/14/1994,9,0,3,7,19
11/15/1994,11,0,7,7,25
11/16/1994,9,0,8,3,20
11/17/1994,4,0,8,9,21
11/18/1994,6,0,5,10,21
11/19/1994,5,0,8,5,18
11/20/1994,11,0,2,6,19
11/21/1994,7,0,6,4,17
11/22/1994,4,0,3,1,8
11/23/1994,7,0,7,2,16
11/24/1994,8,0,8,8,24
11/25/1994,5,0,5,7,17
11/26/1994,7,0,8,3,18
11/27/1994,6,0,6,6,18
11/28/1994,11,0,8,8,27
11/29/1994,4,0,3,5,12
11/30/1994,11,0,3,6,20
12/1/1994,5,0,6,11,22
12/2/1994,11,0,6,9,26
12/3/1994,10,0,8,10,28
12/4/1994,10,0,7,11,28
12/5/1994,10,0,3,2,15
12/6/1994,6,0,5,3,14
12/7/1994,6,0,7,11,24
12/8/1994,10,0,3,7,20
12/9/1994,9,0,5,5,19
12/10/1994,9,0,8,8,25
12/11/1994,5,0,6,7,18
12/12/1994,11,0,8,11,30
12/13/1994,10,0,6,11,27
12/14/1994,10,0,2,6,18
12/15/1994,12,0,3,2,17
12/16/1994,7,0,6,5,18
12/17/1994,7,0,3,2,12
12/18/1994,5,0,10,0,15
12/19/1994,12,0,10,8,30
12/20/1994,10,0,10,8,28
12/21/1994,6,0,4,3,13
12/22/1994,7,0,10,11,28
12/23/1994,5,0,10,2,17
12/24/1994,8,0,5,2,15
12/25/1994,6,0,7,9,22
12/26/1994,9,0,4,2,15
12/27/1994,9,0,4,7,20
12/28/1994,8,0,8,10,26
12/29/1994,7,0,2,7,16
12/30/1994,5,0,9,9,23
12/31/1994,9,0,6,1,16
1/1/1995,11,0,4,9,24
1/2/1995,9,0,3,11,23
1/3/1995,9,0,2,11,22
1/4/1995,7,0,5,2,14
1/5/1995,7,0,10,7,24
1/6/1995,5,0,9,8,22
1/7/1995,10,0,9,1,20
1/8/1995,6,0,8,11,25
1/9/1995,7,0,6,9,22
1/10/1995,11,0,5,8,24
1/11/1995,8,0,3,4,15
1/12/1995,6,0,5,4,15
1/13/1995,4,0,4,0,8
1/14/1995,5,0,7,11,23
1/15/1995,4,0,4,0,8
1/16/1995,7,0,6,4,17
1/17/1995,4,0,7,9,20
1/18/1995,7,0,5,2,14
1/19/1995,12,0,7,1,20
1/20/1995,10,0,2,1,13
1/21/1995,11,0,8,8,27
1/22/1995,4,0,2,8,14
1/23/1995,8,0,2,10,20
1/24/1995,5,0,3,9,17
1/25/1995,4,0,3,10,17
1/26/1995,8,0,7,6,21
1/27/1995,8,0,10,0,18
1/28/1995,11,0,6,3,20
1/29/1995,5,0,10,0,15
1/30/1995,10,0,7,1,18
1/31/1995,12,0,6,9,27
2/1/1995,7,0,4,0,11
2/2/1995,7,0,5,11,23
2/3/1995,10,0,4,10,24
2/4/1995,11,0,7,1,19
2/5/1995,10,0,7,5,22
2/6/1995,7,0,10,7,24
2/7/1995,7,0,4,10,21
2/8/1995,8,0,6,6,20
2/9/1995,5,0,2,1,8
2/10/1995,12,0,2,2,16
2/11/1995,9,0,2,0,11
2/12/1995,6,0,8,7,21
2/13/1995,9,0,10,8,27
2/14/1995,10,0,5,9,24
2/15/1995,11,0,5,6,22
2/16/1995,5,0,10,0,15
2/17/1995,6,0,7,5,18
2/18/1995,4,0,2,5,11
2/19/1995,9,0,8,6,23
2/20/1995,8,0,4,0,12
2/21/1995,8,0,6,5,19
2/22/1995,8,0,9,4,21
2/23/1995,9,0,8,6,23
2/24/1995,12,0,4,10,26
2/25/1995,8,0,6,2,16
2/26/1995,6,0,2,0,8
2/27/1995,9,0,10,8,27
2/28/1995,7,0,3,6,16
3/1/1995,9,0,6,10,25
3/2/1995,9,0,9,0,18
3/3/1995,7,0,2,7,16
3/4/1995,9,0,4,5,18
3/5/1995,6,0,9,7,22
3/6/1995,11,0,2,9,22
3/7/1995,5,0,2,3,10
3/8/1995,11,0,2,6,19
3/9/1995,7,0,2,2,11
3/10/1995,11,0,7,7,25
3/11/1995,9,0,8,3,20
3/12/1995,7,0,6,11,24
3/13/1995,9,0,4,8,21
3/14/1995,12,0,5,5,22
3/15/1995,11,0,5,4,20
3/16/1995,8,0,4,11,23
3/17/1995,8,0,9,2,19
3/18/1995,6,0,10,8,24
3/19/1995,4,0,6,5,15
3/20/1995,8,0,3,3,14
3/21/1995,5,0,9,2,16
3/22/1995,12,0,8,9,29
3/23/1995,6,0,5,7,18
3/24/1995,11,0,4,4,19
3/25/1995,5,0,8,10,23
3/26/1995,12,0,3,5,20
3/27/1995,11,0,2,7,20
3/28/1995,7,0,7,7,21
3/29/1995,6,0,3,1,10
3/30/1995,12,0,9,8,29
3/31/1995,8,0,8,10,26
4/1/1995,12,0,9,8,29
4/2/1995,8,0,8,1,17
4/3/1995,5,0,5,6,16
4/4/1995,6,0,10,4,20
4/5/1995,12,0,2,5,19
4/6/1995,12,0,10,9,31
4/7/1995,11,0,6,0,17
4/8/1995,5,0,7,6,18
4/9/1995,7,0,4,5,16
4/10/1995,4,0,9,1,14
4/11/1995,9,0,9,4,22
4/12/1995,11,0,8,3,22
4/13/1995,4,0,8,9,21
4/14/1995,8,0,9,5,22
4/15/1995,9,0,2,2,13
4/16/1995,8,0,6,10,24
4/17/1995,6,0,4,2,12
4/18/1995,5,0,6,8,19
4/19/1995,7,0,5,6,18
4/20/1995,8,0,5,2,15
4/21/1995,9,0,5,2,16
4/22/1995,11,0,8,8,27
4/23/1995,12,0,5,7,24
4/24/1995,11,0,9,4,24
4/25/1995,11,0,10,10,31
4/26/1995,8,0,6,4,18
4/27/1995,11,0,3,5,19
4/28/1995,12,0,9,10,31
4/29/1995,8,0,2,7,17
4/30/1995,9,0,2,10,21
5/1/1995,8,0,6,8,22
5/2/1995,11,0,8,11,30
5/3/1995,10,0,5,4,19
5/4/1995,11,0,4,4,19
5/5/1995,6,0,4,10,20
5/6/1995,10,0,8,4,22
5/7/1995,10,0,6,4,20
5/8/1995,10,0,6,1,17
5/9/1995,4,0,4,5,13
5/10/1995,6,0,4,10,20
5/11/1995,9,0,5,1,15
5/12/1995,7,0,4,11,22
5/13/1995,6,0,7,2,15
5/14/1995,12,0,5,4,21
5/15/1995,5,0,3,1,9
5/16/1995,4,0,7,5,16
5/17/1995,5,0,6,10,21
5/18/1995,10,0,6,11,27
5/19/1995,7,0,5,9,21
5/20/1995,7,0,2,10,19
5/21/1995,10,0,10,9,29
5/22/1995,5,0,8,2,15
5/23/1995,9,0,4,3,16
5/24/1995,5,0,6,4,15
5/25/1995,10,0,10,6,26
5/26/1995,7,0,5,11,23
5/27/1995,11,0,3,10,24
5/28/1995,12,0,10,0,22
5/29/1995,11,0,6,0,17
5/30/1995,8,0,8,2,18
5/31/1995,7,0,5,2,14
6/1/1995,8,0,9,0,17
6/2/1995,11,0,4,10,25
6/3/1995,6,0,6,7,19
6/4/1995,8,0,10,6,24
6/5/1995,9,0,2,8,19
6/6/1995,11,0,6,8,25
6/7/1995,7,0,2,0,9
6/8/1995,11,0,8,0,19
6/9/1995,10,0,6,6,22
6/10/1995,8,0,5,9,22
6/11/1995,7,0,4,0,11
6/12/1995,4,0,9,7,20
6/13/1995,4,0,10,4,18
6/14/1995,11,0,9,3,23
6/15/1995,11,0,6,1,18
6/16/1995,5,0,7,3,15
6/17/1995,7,0,5,1,13
6/18/1995,5,0,7,9,21
6/19/1995,4,0,3,8,15
6/20/1995,5,0,9,4,18
6/21/1995,7,0,3,1,11
6/22/1995,11,0,10,9,30
6/23/1995,9,0,9,11,29
6/24/1995,4,0,5,2,11
6/25/1995,5,0,10,11,26
6/26/1995,10,0,5,6,21
6/27/1995,12,0,4,1,17
6/28/1995,8,0,10,2,20
6/29/1995,10,0,7,4,21
6/30/1995,12,0,9,11,32
7/1/1995,4,0,10,6,20
7/2/1995,7,0,2,9,18
7/3/1995,12,0,5,8,25
7/4/1995,9,0,3,5,17
7/5/1995,12,0,8,6,26
7/6/1995,12,0,2,2,16
7/7/1995,10,0,3,2,15
7/8/1995,5,0,5,7,17
7/9/1995,7,0,6,1,14
7/10/1995,5,0,3,10,18
7/11/1995,9,0,10,4,23
7/12/1995,8,0,2,1,11
7/13/1995,10,0,7,9,26
7/14/1995,12,0,3,4,19
7/15/1995,7,0,2,7,16
7/16/1995,12,0,5,0,17
7/17/1995,4,0,3,10,17
7/18/1995,5,0,6,8,19
7/19/1995,10,0,3,1,14
7/20/1995,12,0,10,5,27
7/21/1995,12,0,6,0,18
7/22/1995,11,0,3,11,25
7/23/1995,10,0,4,4,18
7/24/1995,6,0,2,8,16
7/25/1995,10,0,8,0,18
7/26/1995,6,0,3,6,15
7/27/1995,4,0,10,9,23
7/28/1995,12,0,3,2,17
7/29/1995,8,0,10,8,26
7/30/1995,7,0,3,2,12
7/31/1995,5,0,9,5,19
8/1/1995,10,0,2,8,20
8/2/1995,12,0,2,10,24
8/3/1995,12,0,7,0,19
8/4/1995,5,0,5,6,16
8/5/1995,4,0,9,5,18
8/6/1995,10,0,2,8,20
8/7/1995,5,0,8,2,15
8/8/1995,12,0,6,2,20
8/9/1995,9,0,6,7,22
8/10/1995,11,0,3,3,17
8/11/1995,4,0,10,9,23
8/12/1995,4,0,2,2,8
8/13/1995,10,0,2,3,15
8/14/1995,7,0,6,5,18
8/15/1995,9,0,2,6,17
8/16/1995,7,0,7,7,21
8/17/1995,9,0,8,5,22
8/18/1995,10,0,6,2,18
8/19/1995,4,0,10,2,16
8/20/1995,4,0,2,5,11
8/21/1995,11,0,7,6,24
8/22/1995,6,0,2,8,16
8/23/1995,9,0,8,9,26
8/24/1995,8,0,3,0,11
8/25/1995,11,0,4,0,15
8/26/1995,7,0,7,5,19
8/27/1995,12,0,8,2,22
8/28/1995,5,0,10,8,23
8/29/1995,11,0,10,2,23
8/30/1995,9,0,7,6,22
8/31/1995,7,0,6,9,22
9/1/1995,11,0,6,11,28
9/2/1995,8,0,3,1,12
9/3/1995,6,0,3,3,12
9/4/1995,6,0,4,3,13
9/5/1995,4,0,9,7,20
9/6/1995,6,0,10,8,24
9/7/1995,6,0,7,10,23
9/8/1995,9,0,9,1,19
9/9/1995,7,0,8,10,25
9/10/1995,12,0,2,11,25
9/11/1995,7,0,2,7,16
9/12/1995,6,0,8,3,17
9/13/1995,7,0,10,5,22
9/14/1995,6,0,7,4,17
9/15/1995,7,0,2,11,20
9/16/1995,9,0,5,11,25
9/17/1995,5,0,9,10,24
9/18/1995,4,0,9,7,20
9/19/1995,12,0,3,11,26
9/20/1995,5,0,7,0,12
9/21/1995,4,0,2,11,17
9/22/1995,10,0,2,3,15
9/23/1995,5,0,10,2,17
9/24/1995,5,0,3,1,9
9/25/1995,5,0,3,5,13
9/26/1995,7,0,5,1,13
9/27/1995,7,0,4,11,22
9/28/1995,6,0,6,11,23
9/29/1995,6,0,8,11,25
9/30/1995,9,0,8,4,21
10/1/1995,4,0,10,3,17
10/2/1995,4,0,2,6,12
10/3/1995,5,0,10,10,25
10/4/1995,4,0,8,1,13
10/5/1995,8,0,5,4,17
10/6/1995,5,0,5,11,21
10/7/1995,6,0,10,3,19
10/8/1995,8,0,7,5,20
10/9/1995,6,0,7,6,19
10/10/1995,7,0,9,5,21
10/11/1995,6,0,5,11,22
10/12/1995,5,0,7,3,15
10/13/1995,4,0,9,3,16
10/14/1995,4,0,8,8,20
10/15/1995,7,0,7,9,23
10/16/1995,10,0,4,1,15
10/17/1995,6,0,2,5,13
10/18/1995,12,0,5,9,26
10/19/1995,7,0,10,6,23
10/20/1995,7,0,4,2,13
10/21/1995,4,0,4,9,17
10/22/1995,4,0,10,11,25
10/23/1995,9,0,10,8,27
10/24/1995,12,0,6,6,24
10/25/1995,7,0,9,9,25
10/26/1995,7,0,9,1,17
10/27/1995,6,0,2,7,15
10/28/1995,9,0,4,3,16
10/29/1995,7,0,4,4,15
10/30/1995,4,0,7,7,18
10/31/1995,4,0,4,7,15
11/1/1995,6,0,5,4,15
11/2/1995,9,0,6,9,24
11/3/1995,8,0,2,10,20
11/4/1995,5,0,10,10,25
11/5/1995,7,0,10,3,20
11/6/1995,6,0,8,3,17
11/7/1995,6,0,6,7,19
11/8/1995,12,0,7,11,30
11/9/1995,11,0,3,6,20
11/10/1995,11,0,10,5,26
11/11/1995,9,0,10,4,23
11/12/1995,5,0,10,9,24
11/13/1995,9,0,7,7,23
11/14/1995,7,0,9,6,22
11/15/1995,7,0,7,7,21
11/16/1995,11,0,10,10,31
11/17/1995,12,0,10,10,32
11/18/1995,5,0,4,0,9
11/19/1995,5,0,5,2,12
11/20/1995,7,0,9,2,18
11/21/1995,12,0,9,4,25
11/22/1995,4,0,5,2,11
11/23/1995,4,0,10,4,18
11/24/1995,9,0,8,0,17
11/25/1995,9,0,6,0,15
11/26/1995,5,0,2,9,16
11/27/1995,11,0,7,1,19
11/28/1995,7,0,10,5,22
11/29/1995,8,0,6,0,14
11/30/1995,6,0,9,4,19
12/1/1995,7,0,2,1,10
12/2/1995,5,0,4,7,16
12/3/1995,9,0,4,4,17
12/4/1995,6,0,5,8,19
12/5/1995,12,0,3,8,23
12/6/1995,6,0,9,0,15
12/7/1995,9,0,2,0,11
12/8/1995,12,0,7,10,29
12/9/1995,11,0,9,0,20
12/10/1995,8,0,6,2,16
12/11/1995,12,0,6,1,19
12/12/1995,12,0,9,9,30
12/13/1995,9,0,6,2,17
12/14/1995,11,0,2,1,14
12/15/1995,9,0,5,3,17
12/16/1995,12,0,10,6,28
12/17/1995,12,0,3,0,15
12/18/1995,12,0,9,2,23
12/19/1995,10,0,6,0,16
12/20/1995,5,0,6,4,15
12/21/1995,11,0,8,0,19
12/22/1995,10,0,5,5,20
12/23/1995,8,0,3,4,15
12/24/1995,8,0,6,5,19
12/25/1995,5,0,10,2,17
12/26/1995,6,0,2,0,8
12/27/1995,7,0,10,2,19
12/28/1995,11,0,8,6,25
12/29/1995,11,0,6,8,25
12/30/1995,4,0,5,3,12
12/31/1995,6,0,10,7,23
1/1/1996,4,0,5,3,12
1/2/1996,4,0,2,7,13
1/3/1996,5,0,10,1,16
1/4/1996,4,0,9,7,20
1/5/1996,10,0,9,11,30
1/6/1996,11,0,5,11,27
1/7/1996,6,0,10,9,25
1/8/1996,8,0,3,7,18
1/9/1996,10,0,7,11,28
1/10/1996,4,0,6,7,17
1/11/1996,7,0,6,3,16
1/12/1996,6,0,8,10,24
1/13/1996,11,0,10,2,23
1/14/1996,10,0,9,6,25
1/15/1996,10,0,8,10,28
1/16/1996,8,0,7,5,20
1/17/1996,7,0,6,11,24
1/18/1996,8,0,7,6,21
1/19/1996,11,0,4,7,22
1/20/1996,8,0,5,2,15
1/21/1996,12,0,2,6,20
1/22/1996,11,0,8,6,25
1/23/1996,9,0,9,6,24
1/24/1996,12,0,2,9,23
1/25/1996,11,0,8,2,21
1/26/1996,8,0,2,4,14
1/27/1996,7,0,6,1,14
1/28/1996,5,0,5,11,21
1/29/1996,4,0,8,11,23
1/30/1996,11,0,7,1,19
1/31/1996,6,0,5,9,20
2/1/1996,12,0,6,0,18
2/2/1996,11,0,8,2,21
2/3/1996,5,0,3,7,15
2/4/1996,8,0,3,11,22
2/5/1996,11,0,6,0,17
2/6/1996,12,0,7,11,30
2/7/1996,9,0,4,0,13
2/8/1996,11,0,5,9,25
2/9/1996,6,0,2,10,18
2/10/1996,9,0,5,6,20
2/11/1996,4,0,10,1,15
2/12/1996,6,0,9,7,22
2/13/1996,9,0,7,4,20
2/14/1996,10,0,9,2,21
2/15/1996,5,0,5,7,17
2/16/1996,12,0,5,0,17
2/17/1996,9,0,2,1,12
2/18/1996,5,0,6,2,13
2/19/1996,4,0,6,1,11
2/20/1996,7,0,8,11,26
2/21/1996,6,0,4,8,18
2/22/1996,8,0,4,0,12
2/23/1996,7,0,4,7,18
2/24/1996,8,0,5,6,19
2/25/1996,9,0,8,6,23
2/26/1996,8,0,10,9,27
2/27/1996,6,0,9,7,22
2/28/1996,6,0,10,11,27
2/29/1996,6,0,9,9,24
3/1/1996,4,0,9,0,13
3/2/1996,4,0,6,0,10
3/3/1996,12,0,6,3,21
3/4/1996,8,0,2,0,10
3/5/1996,5,0,6,7,18
3/6/1996,11,0,8,8,27
3/7/1996,6,0,9,0,15
3/8/1996,11,0,6,0,17
3/9/1996,6,0,3,0,9
3/10/1996,7,0,7,1,15
3/11/1996,5,0,5,1,11
3/12/1996,8,0,5,10,23
3/13/1996,9,0,5,0,14
3/14/1996,6,0,8,6,20
3/15/1996,4,0,4,7,15
3/16/1996,5,0,10,5,20
3/17/1996,9,0,6,0,15
3/18/1996,9,0,4,5,18
3/19/1996,11,0,8,8,27
3/20/1996,6,0,2,5,13
3/21/1996,4,0,8,11,23
3/22/1996,9,0,9,8,26
3/23/1996,4,0,7,10,21
3/24/1996,12,0,5,6,23
3/25/1996,12,0,4,5,21
3/26/1996,10,0,7,3,20
3/27/1996,6,0,2,11,19
3/28/1996,8,0,4,1,13
3/29/1996,4,0,5,2,11
3/30/1996,9,0,7,7,23
3/31/1996,12,0,8,0,20
4/1/1996,12,0,4,8,24
4/2/1996,9,0,2,0,11
4/3/1996,8,0,7,7,22
4/4/1996,11,0,4,5,20
4/5/1996,10,0,6,2,18
4/6/1996,12,0,9,2,23
4/7/1996,6,0,8,1,15
4/8/1996,9,0,9,5,23
4/9/1996,5,0,2,2,9
4/10/1996,6,0,6,7,19
4/11/1996,8,0,6,7,21
4/12/1996,5,0,9,6,20
4/13/1996,8,0,7,7,22
4/14/1996,7,0,5,0,12
4/15/1996,6,0,5,1,12
4/16/1996,8,0,8,0,16
4/17/1996,10,0,4,4,18
4/18/1996,7,0,2,3,12
4/19/1996,4,0,10,1,15
4/20/1996,9,0,9,4,22
4/21/1996,6,0,7,5,18
4/22/1996,12,0,3,10,25
4/23/1996,8,0,9,8,25
4/24/1996,11,0,10,10,31
4/25/1996,8,0,8,2,18
4/26/1996,9,0,8,6,23
4/27/1996,12,0,2,0,14
4/28/1996,6,0,8,8,22
4/29/1996,10,0,8,9,27
4/30/1996,7,0,4,6,17
5/1/1996,8,0,9,6,23
5/2/1996,11,0,6,5,22
5/3/1996,9,0,9,5,23
5/4/1996,4,0,4,11,19
5/5/1996,4,0,8,1,13
5/6/1996,5,0,5,5,15
5/7/1996,9,0,8,0,17
5/8/1996,7,0,4,0,11
5/9/1996,6,0,3,6,15
5/10/1996,6,0,9,1,16
5/11/1996,11,0,9,0,20
5/12/1996,10,0,5,10,25
5/13/1996,10,0,7,4,21
5/14/1996,8,0,4,11,23
5/15/1996,12,0,9,11,32
5/16/1996,11,0,7,11,29
5/17/1996,6,0,9,1,16
5/18/1996,10,0,7,6,23
5/19/1996,9,0,2,1,12
5/20/1996,11,0,3,8,22
5/21/1996,9,0,5,1,15
5/22/1996,4,0,5,2,11
5/23/1996,11,0,6,1,18
5/24/1996,7,0,6,4,17
5/25/1996,4,0,8,8,20
5/26/1996,8,0,6,6,20
5/27/1996,11,0,7,5,23
5/28/1996,8,0,2,0,10
5/29/1996,9,0,4,6,19
5/30/1996,6,0,7,5,18
5/31/1996,8,0,10,0,18
6/1/1996,4,0,6,9,19
6/2/1996,6,0,5,9,20
6/3/1996,8,0,8,6,22
6/4/1996,4,0,6,4,14
6/5/1996,4,0,8,1,13
6/6/1996,11,0,3,8,22
6/7/1996,12,0,3,0,15
6/8/1996,4,0,3,11,18
6/9/1996,4,0,10,7,21
6/10/1996,4,0,7,1,12
6/11/1996,8,0,4,1,13
6/12/1996,10,0,6,9,25
6/13/1996,9,0,10,4,23
6/14/1996,8,0,5,11,24
6/15/1996,8,0,5,4,17
6/16/1996,10,0,5,8,23
6/17/1996,12,0,4,8,24
6/18/1996,10,0,3,6,19
6/19/1996,7,0,3,8,18
6/20/1996,4,0,9,2,15
6/21/1996,11,0,4,3,18
6/22/1996,4,0,3,5,12
6/23/1996,10,0,8,6,24
6/24/1996,10,0,2,5,17
6/25/1996,7,0,5,10,22
6/26/1996,5,0,8,10,23
6/27/1996,10,0,8,4,22
6/28/1996,9,0,9,8,26
6/29/1996,4,0,9,3,16
6/30/1996,4,0,3,1,8
7/1/1996,10,0,5,5,20
7/2/1996,5,0,6,2,13
7/3/1996,4,0,4,8,16
7/4/1996,4,0,8,10,22
7/5/1996,7,0,4,3,14
7/6/1996,10,0,8,10,28
7/7/1996,7,0,6,9,22
7/8/1996,4,0,9,11,24
7/9/1996,12,0,5,5,22
7/10/1996,6,0,7,2,15
7/11/1996,8,0,8,0,16
7/12/1996,7,0,9,4,20
7/13/1996,4,0,4,11,19
7/14/1996,12,0,6,4,22
7/15/1996,10,0,9,6,25
7/16/1996,7,0,5,9,21
7/17/1996,12,0,9,1,22
7/18/1996,4,0,8,5,17
7/19/1996,11,0,10,8,29
7/20/1996,9,0,2,1,12
7/21/1996,10,0,10,5,25
7/22/1996,5,0,3,7,15
7/23/1996,8,0,10,4,22
7/24/1996,11,0,6,4,21
7/25/1996,10,0,9,5,24
7/26/1996,5,0,9,5,19
7/27/1996,4,0,10,2,16
7/28/1996,8,0,7,3,18
7/29/1996,10,0,3,10,23
7/30/1996,6,0,3,1,10
7/31/1996,4,0,2,8,14
8/1/1996,9,0,5,11,25
8/2/1996,12,0,8,3,23
8/3/1996,6,0,3,5,14
8/4/1996,5,0,4,9,18
8/5/1996,4,0,9,0,13
8/6/1996,10,0,6,1,17
8/7/1996,12,0,10,4,26
8/8/1996,12,0,10,10,32
8/9/1996,11,0,6,9,26
8/10/1996,12,0,3,6,21
8/11/1996,6,0,4,8,18
8/12/1996,10,0,5,2,17
8/13/1996,4,0,6,6,16
8/14/1996,12,0,6,1,19
8/15/1996,5,0,8,2,15
8/16/1996,10,0,2,10,22
8/17/1996,5,0,4,1,10
8/18/1996,7,0,8,3,18
8/19/1996,12,0,4,4,20
8/20/1996,6,0,10,9,25
8/21/1996,8,0,7,2,17
8/22/1996,8,0,6,10,24
8/23/1996,11,0,6,9,26
8/24/1996,4,0,6,2,12
8/25/1996,11,0,2,4,17
8/26/1996,6,0,10,11,27
8/27/1996,12,0,9,1,22
8/28/1996,12,0,8,3,23
8/29/1996,11,0,10,0,21
8/30/1996,12,0,2,7,21
8/31/1996,12,0,8,10,30
9/1/1996,9,0,2,1,12
9/2/1996,11,0,6,8,25
9/3/1996,12,0,2,10,24
9/4/1996,12,0,9,5,26
9/5/1996,9,0,7,3,19
9/6/1996,6,0,7,3,16
9/7/1996,12,0,5,5,22
9/8/1996,8,0,10,9,27
9/9/1996,6,0,5,3,14
9/10/1996,7,0,4,7,18
9/11/1996,11,0,5,5,21
9/12/1996,8,0,6,1,15
9/13/1996,12,0,8,2,22
9/14/1996,10,0,7,10,27
9/15/1996,5,0,7,3,15
9/16/1996,9,0,3,1,13
9/17/1996,12,0,2,8,22
9/18/1996,11,0,5,4,20
9/19/1996,11,0,4,8,23
9/20/1996,12,0,5,2,19
9/21/1996,4,0,9,1,14
9/22/1996,7,0,10,0,17
9/23/1996,4,0,9,8,21
9/24/1996,9,0,2,3,14
9/25/1996,11,0,2,6,19
9/26/1996,11,0,6,11,28
9/27/1996,4,0,10,5,19
9/28/1996,9,0,10,4,23
9/29/1996,12,0,7,5,24
9/30/1996,6,0,8,10,24
10/1/1996,4,0,10,8,22
10/2/1996,12,0,8,4,24
10/3/1996,7,0,4,7,18
10/4/1996,7,0,5,0,12
10/5/1996,6,0,7,9,22
10/6/1996,6,0,4,5,15
10/7/1996,6,0,10,11,27
10/8/1996,5,0,5,7,17
10/9/1996,7,0,10,6,23
10/10/1996,6,0,5,3,14
10/11/1996,8,0,6,1,15
10/12/1996,5,0,10,4,19
10/13/1996,7,0,9,3,19
10/14/1996,12,0,3,5,20
10/15/1996,7,0,3,11,21
10/16/1996,9,0,10,4,23
10/17/1996,12,0,7,0,19
10/18/1996,4,0,10,6,20
10/19/1996,4,0,4,4,12
10/20/1996,9,0,4,0,13
10/21/1996,10,0,9,2,21
10/22/1996,7,0,3,0,10
10/23/1996,4,0,10,5,19
10/24/1996,4,0,2,9,15
10/25/1996,11,0,7,10,28
10/26/1996,12,0,10,5,27
10/27/1996,7,0,5,3,15
10/28/1996,4,0,9,4,17
10/29/1996,5,0,10,4,19
10/30/1996,10,0,8,8,26
10/31/1996,9,0,5,11,25
11/1/1996,10,0,9,6,25
11/2/1996,11,0,10,4,25
11/3/1996,6,0,9,5,20
11/4/1996,4,0,9,8,21
11/5/1996,10,0,7,5,22
11/6/1996,8,0,10,1,19
11/7/1996,5,0,8,2,15
11/8/1996,5,0,10,1,16
11/9/1996,4,0,4,0,8
11/10/1996,5,0,3,1,9
11/11/1996,5,0,3,2,10
11/12/1996,5,0,6,4,15
11/13/1996,8,0,3,3,14
11/14/1996,10,0,2,11,23
11/15/1996,7,0,3,6,16
11/16/1996,11,0,4,0,15
11/17/1996,4,0,6,4,14
11/18/1996,8,0,8,0,16
11/19/1996,9,0,5,11,25
11/20/1996,11,0,2,3,16
11/21/1996,7,0,6,10,23
11/22/1996,6,0,6,10,22
11/23/1996,9,0,9,9,27
11/24/1996,10,0,3,11,24
11/25/1996,4,0,4,4,12
11/26/1996,5,0,5,0,10
11/27/1996,9,0,5,3,17
11/28/1996,4,0,8,2,14
11/29/1996,10,0,4,6,20
11/30/1996,11,0,6,6,23
12/1/1996,8,0,5,5,18
12/2/1996,11,0,10,5,26
12/3/1996,9,0,9,8,26
12/4/1996,7,0,2,8,17
12/5/1996,8,0,4,7,19
12/6/1996,5,0,9,6,20
12/7/1996,4,0,5,0,9
12/8/1996,6,0,6,1,13
12/9/1996,11,0,3,4,18
12/10/1996,5,0,10,9,24
12/11/1996,6,0,7,5,18
12/12/1996,5,0,5,6,16
12/13/1996,10,0,4,0,14
12/14/1996,5,0,4,5,14
12/15/1996,11,0,2,8,21
12/16/1996,5,0,6,7,18
12/17/1996,4,0,7,2,13
12/18/1996,8,0,9,0,17
12/19/1996,6,0,4,5,15
12/20/1996,8,0,4,10,22
12/21/1996,12,0,8,1,21
12/22/1996,4,0,5,11,20
12/23/1996,8,0,8,8,24
12/24/1996,7,0,8,4,19
12/25/1996,5,0,10,11,26
12/26/1996,12,0,7,9,28
12/27/1996,6,0,6,10,22
12/28/1996,7,0,7,10,24
12/29/1996,11,0,2,8,21
12/30/1996,8,0,9,7,24
12/31/1996,8,0,4,3,15
1/1/1997,6,0,3,7,16
1/2/1997,6,0,9,0,15
1/3/1997,6,0,6,0,12
1/4/1997,10,0,5,6,21
1/5/1997,7,0,10,8,25
1/6/1997,8,0,8,8,24
1/7/1997,6,0,6,11,23
1/8/1997,10,0,3,5,18
1/9/1997,8,0,5,6,19
1/10/1997,11,0,9,6,26
1/11/1997,11,0,10,2,23
1/12/1997,4,0,5,8,17
1/13/1997,11,0,3,10,24
1/14/1997,4,0,8,8,20
1/15/1997,8,0,2,8,18
1/16/1997,11,0,8,3,22
1/17/1997,7,0,8,9,24
1/18/1997,4,0,10,0,14
1/19/1997,10,0,10,8,28
1/20/1997,9,0,6,6,21
1/21/1997,11,0,7,3,21
1/22/1997,10,0,3,4,17
1/23/1997,11,0,3,5,19
1/24/1997,5,0,7,10,22
1/25/1997,4,0,10,0,14
1/26/1997,11,0,9,10,30
1/27/1997,5,0,10,9,24
1/28/1997,10,0,7,6,23
1/29/1997,10,0,9,5,24
1/30/1997,12,0,8,10,30
1/31/1997,5,0,3,7,15
2/1/1997,8,0,10,4,22
2/2/1997,4,0,3,3,10
2/3/1997,4,0,6,11,21
2/4/1997,9,0,6,9,24
2/5/1997,9,0,5,5,19
2/6/1997,10,0,10,11,31
2/7/1997,5,0,2,7,14
2/8/1997,12,0,5,2,19
2/9/1997,4,0,10,3,17
2/10/1997,12,0,9,11,32
2/11/1997,10,0,10,9,29
2/12/1997,6,0,3,6,15
2/13/1997,9,0,3,10,22
2/14/1997,6,0,5,11,22
2/15/1997,5,0,7,6,18
2/16/1997,10,0,9,10,29
2/17/1997,8,0,8,11,27
2/18/1997,10,0,4,7,21
2/19/1997,10,0,2,9,21
2/20/1997,8,0,3,11,22
2/21/1997,4,0,2,10,16
2/22/1997,9,0,5,0,14
2/23/1997,12,0,4,2,18
2/24/1997,8,0,10,6,24
2/25/1997,12,0,6,6,24
2/26/1997,6,0,8,10,24
2/27/1997,4,0,6,10,20
2/28/1997,9,0,9,5,23
3/1/1997,9,0,6,8,23
3/2/1997,12,0,2,6,20
3/3/1997,8,0,5,9,22
3/4/1997,4,0,5,7,16
3/5/1997,10,0,9,10,29
3/6/1997,12,0,6,2,20
3/7/1997,4,0,10,9,23
3/8/1997,10,0,2,6,18
3/9/1997,11,0,10,7,28
3/10/1997,8,0,4,10,22
3/11/1997,7,0,5,8,20
3/12/1997,9,0,3,6,18
3/13/1997,5,0,4,7,16
3/14/1997,10,0,10,4,24
3/15/1997,5,0,3,7,15
3/16/1997,6,0,8,6,20
3/17/1997,12,0,9,5,26
3/18/1997,9,0,7,7,23
3/19/1997,4,0,4,1,9
3/20/1997,6,0,4,6,16
3/21/1997,12,0,5,8,25
3/22/1997,6,0,5,8,19
3/23/1997,11,0,6,5,22
3/24/1997,6,0,7,7,20
3/25/1997,8,0,3,7,18
3/26/1997,7,0,5,4,16
3/27/1997,6,0,7,3,16
3/28/1997,9,0,7,0,16
3/29/1997,8,0,7,4,19
3/30/1997,10,0,7,8,25
3/31/1997,8,0,7,11,26
4/1/1997,8,0,7,9,24
4/2/1997,6,0,8,11,25
4/3/1997,7,0,7,3,17
4/4/1997,8,0,10,9,27
4/5/1997,10,0,10,6,26
4/6/1997,7,0,3,1,11
4/7/1997,11,0,4,3,18
4/8/1997,11,0,8,1,20
4/9/1997,4,0,10,8,22
4/10/1997,7,0,8,1,16
4/11/1997,12,0,2,5,19
4/12/1997,12,0,3,6,21
4/13/1997,8,0,4,3,15
4/14/1997,10,0,10,5,25
4/15/1997,11,0,5,5,21
4/16/1997,7,0,6,4,17
4/17/1997,10,0,9,0,19
4/18/1997,11,0,10,6,27
4/19/1997,6,0,5,3,14
4/20/1997,10,0,3,5,18
4/21/1997,4,0,9,11,24
4/22/1997,8,0,5,9,22
4/23/1997,7,0,4,7,18
4/24/1997,5,0,9,5,19
4/25/1997,4,0,5,8,17
4/26/1997,11,0,7,9,27
4/27/1997,6,0,2,6,14
4/28/1997,7,0,6,4,17
4/29/1997,11,0,3,1,15
4/30/1997,5,0,10,3,18
5/1/1997,4,0,10,3,17
5/2/1997,7,0,2,1,10
5/3/1997,12,0,5,1,18
5/4/1997,7,0,9,3,19
5/5/1997,6,0,6,10,22
5/6/1997,6,0,5,4,15
5/7/1997,4,0,8,6,18
5/8/1997,6,0,3,0,9
5/9/1997,6,0,9,7,22
5/10/1997,5,0,9,7,21
5/11/1997,4,0,4,9,17
5/12/1997,10,0,4,5,19
5/13/1997,10,0,4,4,18
5/14/1997,9,0,9,11,29
5/15/1997,8,0,4,0,12
5/16/1997,5,0,8,0,13
5/17/1997,9,0,5,6,20
5/18/1997,11,0,9,5,25
5/19/1997,7,0,2,6,15
5/20/1997,9,0,10,9,28
5/21/1997,9,0,10,10,29
5/22/1997,4,0,4,6,14
5/23/1997,4,0,9,2,15
5/24/1997,7,0,9,6,22
5/25/1997,8,0,9,8,25
5/26/1997,4,0,3,0,7
5/27/1997,12,0,4,1,17
5/28/1997,11,0,3,10,24
5/29/1997,7,0,4,1,12
5/30/1997,5,0,4,4,13
5/31/1997,6,0,4,5,15
6/1/1997,9,0,6,11,26
6/2/1997,11,0,3,2,16
6/3/1997,9,0,2,5,16
6/4/1997,5,0,8,4,17
6/5/1997,8,0,2,5,15
6/6/1997,7,0,10,0,17
6/7/1997,12,0,4,7,23
6/8/1997,12,0,9,6,27
6/9/1997,5,0,6,5,16
6/10/1997,4,0,8,7,19
6/11/1997,9,0,2,10,21
6/12/1997,6,0,4,11,21
6/13/1997,4,0,4,0,8
6/14/1997,6,0,3,1,10
6/15/1997,11,0,2,11,24
6/16/1997,8,0,9,4,21
6/17/1997,5,0,7,7,19
6/18/1997,10,0,3,4,17
6/19/1997,8,0,8,1,17
6/20/1997,9,0,6,0,15
6/21/1997,7,0,9,0,16
6/22/1997,9,0,10,7,26
6/23/1997,11,0,5,3,19
6/24/1997,10,0,5,11,26
6/25/1997,11,0,3,2,16
6/26/1997,11,0,8,1,20
6/27/1997,10,0,5,1,16
6/28/1997,8,0,5,8,21
6/29/1997,8,0,9,2,19
6/30/1997,8,0,9,7,24
7/1/1997,4,0,5,0,9
7/2/1997,4,0,3,1,8
7/3/1997,8,0,2,2,12
7/4/1997,11,0,5,5,21
7/5/1997,4,0,5,5,14
7/6/1997,10,0,6,8,24
7/7/1997,11,0,8,10,29
7/8/1997,5,0,3,5,13
7/9/1997,9,0,8,1,18
7/10/1997,11,0,2,11,24
7/11/1997,9,0,10,0,19
7/12/1997,6,0,10,1,17
7/13/1997,5,0,6,9,20
7/14/1997,8,0,7,2,17
7/15/1997,10,0,8,3,21
7/16/1997,7,0,7,11,25
7/17/1997,5,0,4,9,18
7/18/1997,7,0,3,1,11
7/19/1997,12,0,6,3,21
7/20/1997,4,0,6,0,10
7/21/1997,4,0,10,10,24
7/22/1997,9,0,2,4,15
7/23/1997,8,0,4,1,13
7/24/1997,9,0,6,2,17
7/25/1997,11,0,10,2,23
7/26/1997,8,0,8,0,16
7/27/1997,11,0,8,5,24
7/28/1997,5,0,4,2,11
7/29/1997,10,0,9,9,28
7/30/1997,9,0,2,3,14
7/31/1997,5,0,3,9,17
8/1/1997,9,0,3,8,20
8/2/1997,4,0,4,11,19
8/3/1997,9,0,10,11,30
8/4/1997,4,0,6,10,20
8/5/1997,5,0,8,3,16
8/6/1997,8,0,6,0,14
8/7/1997,6,0,2,2,10
8/8/1997,9,0,10,9,28
8/9/1997,9,0,2,9,20
8/10/1997,10,0,8,4,22
8/11/1997,12,0,5,2,19
8/12/1997,9,0,9,11,29
8/13/1997,4,0,5,1,10
8/14/1997,9,0,8,9,26
8/15/1997,7,0,8,2,17
8/16/1997,5,0,10,5,20
8/17/1997,11,0,7,9,27
8/18/1997,10,0,3,8,21
8/19/1997,5,0,3,2,10
8/20/1997,12,0,4,6,22
8/21/1997,9,0,3,8,20
8/22/1997,11,0,5,6,22
8/23/1997,5,0,4,7,16
8/24/1997,6,0,5,6,17
8/25/1997,6,0,7,7,20
8/26/1997,9,0,4,1,14
8/27/1997,6,0,4,7,17
8/28/1997,9,0,10,3,22
8/29/1997,7,0,3,3,13
8/30/1997,11,0,6,10,27
8/31/1997,12,0,2,0,14
9/1/1997,5,0,7,3,15
9/2/1997,12,0,8,9,29
9/3/1997,12,0,9,6,27
9/4/1997,9,0,8,10,27
9/5/1997,6,0,5,11,22
9/6/1997,6,0,9,7,22
9/7/1997,5,0,7,2,14
9/8/1997,8,0,7,6,21
9/9/1997,8,0,3,7,18
9/10/1997,6,0,5,7,18
9/11/1997,11,0,6,5,22
9/12/1997,5,0,6,1,12
9/13/1997,7,0,4,0,11
9/14/1997,11,0,10,11,32
9/15/1997,9,0,2,6,17
9/16/1997,9,0,6,8,23
9/17/1997,11,0,3,0,14
9/18/1997,8,0,4,5,17
9/19/1997,8,0,5,2,15
9/20/1997,8,0,2,8,18
9/21/1997,8,0,10,6,24
9/22/1997,9,0,9,0,18
9/23/1997,12,0,8,10,30
9/24/1997,7,0,2,8,17
9/25/1997,8,0,8,2,18
9/26/1997,12,0,8,6,26
9/27/1997,11,0,7,3,21
9/28/1997,12,0,9,6,27
9/29/1997,9,0,3,5,17
9/30/1997,8,0,8,3,19
10/1/1997,9,0,7,8,24
10/2/1997,10,0,8,5,23
10/3/1997,5,0,9,0,14
10/4/1997,11,0,6,7,24
10/5/1997,6,0,2,11,19
10/6/1997,6,0,4,7,17
10/7/1997,10,0,8,11,29
10/8/1997,11,0,8,8,27
10/9/1997,6,0,6,6,18
10/10/1997,8,0,9,6,23
10/11/1997,7,0,9,10,26
10/12/1997,9,0,7,7,23
10/13/1997,7,0,2,9,18
10/14/1997,8,0,10,0,18
10/15/1997,11,0,9,8,28
10/16/1997,7,0,8,6,21
10/17/1997,5,0,3,1,9
10/18/1997,12,0,9,10,31
10/19/1997,5,0,8,8,21
10/20/1997,8,0,10,10,28
10/21/1997,9,0,2,5,16
10/22/1997,10,0,4,2,16
10/23/1997,10,0,6,9,25
10/24/1997,10,0,5,1,16
10/25/1997,7,0,6,8,21
10/26/1997,10,0,6,9,25
10/27/1997,11,0,9,4,24
10/28/1997,9,0,6,9,24
10/29/1997,11,0,8,0,19
10/30/1997,12,0,6,10,28
10/31/1997,10,0,5,7,22
11/1/1997,6,0,6,5,17
11/2/1997,6,0,4,11,21
11/3/1997,10,0,8,10,28
11/4/1997,8,0,6,0,14
11/5/1997,9,0,10,7,26
11/6/1997,12,0,6,3,21
11/7/1997,11,0,6,11,28
11/8/1997,10,0,5,10,25
11/9/1997,8,0,10,3,21
11/10/1997,6,0,3,2,11
11/11/1997,11,0,9,2,22
11/12/1997,7,0,3,0,10
11/13/1997,9,0,5,10,24
11/14/1997,12,0,10,4,26
11/15/1997,5,0,4,0,9
11/16/1997,7,0,2,10,19
11/17/1997,6,0,9,10,25
11/18/1997,6,0,4,2,12
11/19/1997,9,0,5,0,14
11/20/1997,11,0,3,9,23
11/21/1997,5,0,7,4,16
11/22/1997,10,0,4,10,24
11/23/1997,9,0,8,3,20
11/24/1997,9,0,6,11,26
11/25/1997,10,0,10,3,23
11/26/1997,6,0,6,3,15
11/27/1997,9,0,10,3,22
11/28/1997,6,0,3,11,20
11/29/1997,11,0,9,0,20
11/30/1997,7,0,8,1,16
12/1/1997,10,0,4,9,23
12/2/1997,12,0,9,8,29
12/3/1997,8,0,7,9,24
12/4/1997,7,0,8,6,21
12/5/1997,12,0,10,2,24
12/6/1997,12,0,5,9,26
12/7/1997,11,0,7,2,20
12/8/1997,4,0,4,1,9
12/9/1997,9,0,7,5,21
12/10/1997,12,0,3,10,25
12/11/1997,8,0,2,10,20
12/12/1997,10,0,8,7,25
12/13/1997,4,0,9,9,22
12/14/1997,11,0,5,6,22
12/15/1997,12,0,9,11,32
12/16/1997,7,0,7,4,18
12/17/1997,8,0,8,2,18
12/18/1997,6,0,9,1,16
12/19/1997,5,0,4,1,10
12/20/1997,7,0,4,0,11
12/21/1997,7,0,5,4,16
12/22/1997,6,0,10,8,24
12/23/1997,5,0,2,4,11
12/24/1997,7,0,8,4,19
12/25/1997,5,0,5,2,12
12/26/1997,4,0,4,5,13
12/27/1997,6,0,9,1,16
12/28/1997,5,0,7,0,12
12/29/1997,6,0,10,2,18
12/30/1997,9,0,9,3,21
12/31/1997,5,0,5,7,17
1/1/1998,10,0,5,6,21
1/2/1998,8,0,10,6,24
1/3/1998,4,0,8,1,13
1/4/1998,11,0,7,1,19
1/5/1998,10,0,3,10,23
1/6/1998,12,0,6,8,26
1/7/1998,7,0,8,1,16
1/8/1998,4,0,9,11,24
1/9/1998,7,0,9,0,16
1/10/1998,11,0,9,3,23
1/11/1998,9,0,4,9,22
1/12/1998,10,0,7,2,19
1/13/1998,5,0,8,11,24
1/14/1998,6,0,8,8,22
1/15/1998,4,0,9,10,23
1/16/1998,8,0,9,8,25
1/17/1998,10,0,9,4,23
1/18/1998,5,0,7,8,20
1/19/1998,5,0,5,10,20
1/20/1998,12,0,9,5,26
1/21/1998,8,0,6,4,18
1/22/1998,5,0,4,5,14
1/23/1998,4,0,8,6,18
1/24/1998,11,0,8,10,29
1/25/1998,11,0,10,7,28
1/26/1998,6,0,9,8,23
1/27/1998,6,0,10,4,20
1/28/1998,5,0,6,0,11
1/29/1998,10,0,4,1,15
1/30/1998,5,0,9,7,21
1/31/1998,7,0,3,0,10
2/1/1998,7,0,5,6,18
2/2/1998,5,0,2,3,10
2/3/1998,8,0,8,7,23
2/4/1998,4,0,7,1,12
2/5/1998,9,0,2,7,18
2/6/1998,11,0,4,4,19
2/7/1998,6,0,8,7,21
2/8/1998,8,0,3,6,17
2/9/1998,11,0,4,10,25
2/10/1998,7,0,8,7,22
2/11/1998,4,0,3,8,15
2/12/1998,5,0,5,4,14
2/13/1998,4,0,7,7,18
2/14/1998,5,0,5,9,19
2/15/1998,7,0,3,0,10
2/16/1998,12,0,5,2,19
2/17/1998,12,0,2,6,20
2/18/1998,8,0,7,4,19
2/19/1998,5,0,9,2,16
2/20/1998,11,0,6,5,22
2/21/1998,5,0,2,4,11
2/22/1998,9,0,3,11,23
2/23/1998,8,0,10,5,23
2/24/1998,5,0,9,1,15
2/25/1998,6,0,3,4,13
2/26/1998,10,0,3,0,13
2/27/1998,10,0,3,8,21
2/28/1998,9,0,4,4,17
3/1/1998,5,0,10,6,21
3/2/1998,5,0,9,10,24
3/3/1998,11,0,3,11,25
3/4/1998,5,0,10,3,18
3/5/1998,11,0,6,2,19
3/6/1998,7,0,7,2,16
3/7/1998,12,0,8,11,31
3/8/1998,9,0,6,4,19
3/9/1998,7,0,2,1,10
3/10/1998,9,0,7,1,17
3/11/1998,12,0,6,10,28
3/12/1998,5,0,3,3,11
3/13/1998,8,0,5,3,16
3/14/1998,10,0,2,6,18
3/15/1998,6,0,2,7,15
3/16/1998,5,0,3,5,13
3/17/1998,8,0,8,8,24
3/18/1998,8,0,9,9,26
3/19/1998,7,0,4,8,19
3/20/1998,4,0,5,10,19
3/21/1998,7,0,10,4,21
3/22/1998,12,0,2,6,20
3/23/1998,12,0,3,1,16
3/24/1998,5,0,10,1,16
3/25/1998,12,0,2,1,15
3/26/1998,7,0,5,8,20
3/27/1998,7,0,5,7,19
3/28/1998,9,0,3,1,13
3/29/1998,10,0,8,11,29
3/30/1998,12,0,5,2,19
3/31/1998,6,0,10,4,20
4/1/1998,5,0,4,0,9
4/2/1998,11,0,4,2,17
4/3/1998,8,0,4,10,22
4/4/1998,8,0,5,2,15
4/5/1998,11,0,2,1,14
4/6/1998,6,0,8,2,16
4/7/1998,8,0,6,5,19
4/8/1998,5,0,7,1,13
4/9/1998,4,0,2,6,12
4/10/1998,12,0,6,4,22
4/11/1998,4,0,6,3,13
4/12/1998,8,0,9,8,25
4/13/1998,6,0,4,3,13
4/14/1998,12,0,3,7,22
4/15/1998,12,0,4,10,26
4/16/1998,5,0,8,0,13
4/17/1998,12,0,4,0,16
4/18/1998,11,0,9,0,20
4/19/1998,7,0,5,1,13
4/20/1998,12,0,8,0,20
4/21/1998,7,0,6,10,23
4/22/1998,7,0,7,11,25
4/23/1998,5,0,6,9,20
4/24/1998,10,0,9,8,27
4/25/1998,11,0,6,7,24
4/26/1998,6,0,5,5,16
4/27/1998,9,0,9,1,19
4/28/1998,9,0,7,1,17
4/29/1998,10,0,6,8,24
4/30/1998,5,0,9,6,20
5/1/1998,12,0,8,10,30
5/2/1998,9,0,8,11,28
5/3/1998,9,0,10,0,19
5/4/1998,8,0,10,6,24
5/5/1998,8,0,3,8,19
5/6/1998,10,0,6,6,22
5/7/1998,6,0,9,10,25
5/8/1998,11,0,2,11,24
5/9/1998,11,0,4,10,25
5/10/1998,6,0,10,2,18
5/11/1998,4,0,9,11,24
5/12/1998,9,0,6,7,22
5/13/1998,4,0,6,2,12
5/14/1998,10,0,7,9,26
5/15/1998,4,0,9,4,17
5/16/1998,9,0,3,0,12
5/17/1998,7,0,4,10,21
5/18/1998,5,0,5,2,12
5/19/1998,5,0,6,6,17
5/20/1998,5,0,10,11,26
5/21/1998,10,0,10,0,20
5/22/1998,11,0,3,0,14
5/23/1998,8,0,2,8,18
5/24/1998,5,0,7,2,14
5/25/1998,12,0,6,1,19
5/26/1998,7,0,9,6,22
5/27/1998,12,0,6,2,20
5/28/1998,4,0,3,3,10
5/29/1998,9,0,3,1,13
5/30/1998,12,0,5,11,28
5/31/1998,10,0,2,10,22
6/1/1998,5,0,10,11,26
6/2/1998,12,0,4,9,25
6/3/1998,10,0,4,10,24
6/4/1998,10,0,10,7,27
6/5/1998,5,0,6,6,17
6/6/1998,6,0,10,9,25
6/7/1998,4,0,5,1,10
6/8/1998,5,0,9,4,18
6/9/1998,4,0,2,10,16
6/10/1998,11,0,5,8,24
6/11/1998,12,0,8,3,23
6/12/1998,5,0,7,5,17
6/13/1998,8,0,8,9,25
6/14/1998,4,0,2,10,16
6/15/1998,9,0,4,8,21
6/16/1998,8,0,10,0,18
6/17/1998,9,0,4,2,15
6/18/1998,11,0,9,5,25
6/19/1998,8,0,2,10,20
6/20/1998,4,0,7,8,19
6/21/1998,9,0,2,4,15
6/22/1998,4,0,8,5,17
6/23/1998,4,0,2,5,11
6/24/1998,4,0,10,11,25
6/25/1998,9,0,2,5,16
6/26/1998,11,0,10,9,30
6/27/1998,9,0,8,6,23
6/28/1998,8,0,4,9,21
6/29/1998,7,0,10,2,19
6/30/1998,9,0,10,7,26
7/1/1998,5,0,4,11,20
7/2/1998,7,0,7,10,24
7/3/1998,5,0,5,3,13
7/4/1998,9,0,4,3,16
7/5/1998,7,0,8,0,15
7/6/1998,7,0,5,6,18
7/7/1998,11,0,2,11,24
7/8/1998,11,0,2,2,15
7/9/1998,11,0,7,5,23
7/10/1998,8,0,2,1,11
7/11/1998,12,0,7,7,26
7/12/1998,9,0,7,2,18
7/13/1998,6,0,6,3,15
7/14/1998,11,0,2,9,22
7/15/1998,12,0,10,1,23
7/16/1998,12,0,2,8,22
7/17/1998,10,0,10,9,29
7/18/1998,11,0,4,10,25
7/19/1998,7,0,4,6,17
7/20/1998,9,0,10,4,23
7/21/1998,7,0,9,3,19
7/22/1998,7,0,7,4,18
7/23/1998,10,0,8,2,20
7/24/1998,12,0,3,5,20
7/25/1998,5,0,3,3,11
7/26/1998,8,0,4,6,18
7/27/1998,6,0,9,2,17
7/28/1998,8,0,5,7,20
7/29/1998,7,0,2,7,16
7/30/1998,4,0,6,6,16
7/31/1998,10,0,3,2,15
8/1/1998,11,0,2,8,21
8/2/1998,11,0,7,11,29
8/3/1998,10,0,4,4,18
8/4/1998,11,0,2,7,20
8/5/1998,7,0,6,8,21
8/6/1998,5,0,7,4,16
8/7/1998,7,0,3,8,18
8/8/1998,9,0,3,10,22
8/9/1998,10,0,5,4,19
8/10/1998,10,0,9,5,24
8/11/1998,7,0,4,5,16
8/12/1998,4,0,5,5,14
8/13/1998,12,0,4,4,20
8/14/1998,5,0,10,9,24
8/15/1998,9,0,4,11,24
8/16/1998,8,0,2,4,14
8/17/1998,12,0,3,8,23
8/18/1998,4,0,2,6,12
8/19/1998,9,0,3,7,19
8/20/1998,8,0,9,4,21
8/21/1998,10,0,10,10,30
8/22/1998,6,0,6,6,18
8/23/1998,5,0,3,3,11
8/24/1998,4,0,7,9,20
8/25/1998,10,0,10,7,27
8/26/1998,4,0,7,5,16
8/27/1998,8,0,2,3,13
8/28/1998,12,0,6,2,20
8/29/1998,10,0,5,1,16
8/30/1998,7,0,2,6,15
8/31/1998,7,0,9,6,22
9/1/1998,5,0,8,3,16
9/2/1998,11,0,9,3,23
9/3/1998,6,0,3,3,12
9/4/1998,8,0,4,9,21
9/5/1998,4,0,5,9,18
9/6/1998,9,0,7,7,23
9/7/1998,8,0,10,4,22
9/8/1998,10,0,3,10,23
9/9/1998,8,0,9,8,25
9/10/1998,10,0,4,8,22
9/11/1998,10,0,5,5,20
9/12/1998,10,0,2,8,20
9/13/1998,9,0,10,4,23
9/14/1998,9,0,10,0,19
9/15/1998,11,0,8,0,19
9/16/1998,5,0,9,7,21
9/17/1998,6,0,8,9,23
9/18/1998,5,0,10,8,23
9/19/1998,11,0,10,1,22
9/20/1998,12,0,5,8,25
9/21/1998,12,0,9,0,21
9/22/1998,11,0,10,6,27
9/23/1998,10,0,5,1,16
9/24/1998,5,0,8,6,19
9/25/1998,4,0,8,6,18
9/26/1998,5,0,5,4,14
9/27/1998,12,0,9,4,25
9/28/1998,9,0,7,11,27
9/29/1998,5,0,4,4,13
9/30/1998,7,0,4,11,22
10/1/1998,8,0,7,7,22
10/2/1998,9,0,6,1,16
10/3/1998,11,0,3,3,17
10/4/1998,6,0,8,4,18
10/5/1998,10,0,4,8,22
10/6/1998,8,0,7,1,16
10/7/1998,6,0,4,3,13
10/8/1998,9,0,10,6,25
10/9/1998,10,0,10,4,24
10/10/1998,7,0,5,5,17
10/11/1998,9,0,9,11,29
10/12/1998,10,0,8,7,25
10/13/1998,7,0,6,6,19
10/14/1998,6,0,6,5,17
10/15/1998,8,0,8,8,24
10/16/1998,5,0,7,0,12
10/17/1998,6,0,8,3,17
10/18/1998,4,0,10,1,15
10/19/1998,10,0,4,8,22
10/20/1998,8,0,7,6,21
10/21/1998,6,0,10,3,19
10/22/1998,5,0,8,5,18
10/23/1998,10,0,7,10,27
10/24/1998,12,0,10,7,29
10/25/1998,8,0,3,8,19
10/26/1998,10,0,3,2,15
10/27/1998,9,0,2,7,18
10/28/1998,10,0,3,11,24
10/29/1998,9,0,5,2,16
10/30/1998,4,0,5,8,17
10/31/1998,12,0,9,0,21
11/1/1998,12,0,3,11,26
11/2/1998,6,0,7,10,23
11/3/1998,4,0,8,4,16
11/4/1998,7,0,2,11,20
11/5/1998,6,0,2,2,10
11/6/1998,7,0,3,5,15
11/7/1998,12,0,3,8,23
11/8/1998,6,0,2,1,9
11/9/1998,10,0,6,1,17
11/10/1998,4,0,4,10,18
11/11/1998,7,0,4,9,20
11/12/1998,11,0,8,4,23
11/13/1998,4,0,8,11,23
11/14/1998,6,0,4,11,21
11/15/1998,11,0,6,7,24
11/16/1998,11,0,9,10,30
11/17/1998,6,0,6,7,19
11/18/1998,4,0,4,6,14
11/19/1998,7,0,7,2,16
11/20/1998,5,0,7,3,15
11/21/1998,8,0,9,7,24
11/22/1998,8,0,8,11,27
11/23/1998,9,0,5,11,25
11/24/1998,11,0,6,11,28
11/25/1998,10,0,8,3,21
11/26/1998,10,0,10,9,29
11/27/1998,4,0,2,4,10
11/28/1998,8,0,10,6,24
11/29/1998,11,0,7,2,20
11/30/1998,10,0,5,0,15
12/1/1998,12,0,9,9,30
12/2/1998,10,0,4,9,23
12/3/1998,9,0,8,8,25
12/4/1998,11,0,3,2,16
12/5/1998,6,0,5,6,17
12/6/1998,12,0,9,4,25
12/7/1998,11,0,3,3,17
12/8/1998,7,0,5,1,13
12/9/1998,8,0,10,1,19
12/10/1998,5,0,9,6,20
12/11/1998,6,0,9,4,19
12/12/1998,4,0,8,4,16
12/13/1998,12,0,4,8,24
12/14/1998,8,0,2,9,19
12/15/1998,10,0,7,8,25
12/16/1998,10,0,8,9,27
12/17/1998,12,0,2,10,24
12/18/1998,5,0,3,2,10
12/19/1998,8,0,8,0,16
12/20/1998,4,0,9,7,20
12/21/1998,8,0,8,7,23
12/22/1998,4,0,5,0,9
12/23/1998,9,0,5,11,25
12/24/1998,5,0,6,4,15
12/25/1998,9,0,10,6,25
12/26/1998,12,0,3,4,19
12/27/1998,4,0,10,4,18
12/28/1998,11,0,7,8,26
12/29/1998,7,0,10,4,21
12/30/1998,7,0,9,4,20
12/31/1998,8,0,3,11,22
1/1/1999,9,0,8,10,27
1/2/1999,4,0,9,1,14
1/3/1999,11,0,9,0,20
1/4/1999,12,0,8,0,20
1/5/1999,4,0,3,2,9
1/6/1999,12,0,6,11,29
1/7/1999,7,0,8,5,20
1/8/1999,7,0,3,5,15
1/9/1999,12,0,4,4,20
1/10/1999,9,0,2,3,14
1/11/1999,4,0,3,9,16
1/12/1999,6,0,9,8,23
1/13/1999,12,0,9,10,31
1/14/1999,11,0,3,3,17
1/15/1999,9,0,7,1,17
1/16/1999,6,0,4,3,13
1/17/1999,7,0,3,7,17
1/18/1999,8,0,6,4,18
1/19/1999,8,0,7,9,24
1/20/1999,4,0,5,11,20
1/21/1999,5,0,8,3,16
1/22/1999,7,0,9,5,21
1/23/1999,8,0,10,8,26
1/24/1999,4,0,6,7,17
1/25/1999,6,0,10,4,20
1/26/1999,12,0,4,10,26
1/27/1999,8,0,2,0,10
1/28/1999,4,0,3,4,11
1/29/1999,7,0,5,2,14
1/30/1999,4,0,8,0,12
1/31/1999,7,0,5,10,22
2/1/1999,9,0,4,2,15
2/2/1999,6,0,2,0,8
2/3/1999,11,0,4,9,24
2/4/1999,11,0,9,0,20
2/5/1999,6,0,8,11,25
2/6/1999,8,0,5,9,22
2/7/1999,5,0,10,3,18
2/8/1999,6,0,3,11,20
2/9/1999,7,0,8,3,18
2/10/1999,7,0,3,7,17
2/11/1999,8,0,7,7,22
2/12/1999,5,0,9,4,18
2/13/1999,5,0,2,0,7
2/14/1999,9,0,5,5,19
2/15/1999,4,0,8,5,17
2/16/1999,5,0,5,0,10
2/17/1999,10,0,8,9,27
2/18/1999,9,0,2,6,17
2/19/1999,6,0,7,7,20
2/20/1999,5,0,6,11,22
2/21/1999,10,0,7,10,27
2/22/1999,9,0,3,6,18
2/23/1999,10,0,9,8,27
2/24/1999,11,0,9,11,31
2/25/1999,10,0,4,5,19
2/26/1999,11,0,7,6,24
2/27/1999,6,0,7,6,19
2/28/1999,12,0,7,2,21
3/1/1999,6,0,2,2,10
3/2/1999,9,0,6,7,22
3/3/1999,4,0,2,8,14
3/4/1999,7,0,3,2,12
3/5/1999,6,0,8,6,20
3/6/1999,12,0,6,1,19
3/7/1999,8,0,3,10,21
3/8/1999,10,0,4,3,17
3/9/1999,7,0,7,0,14
3/10/1999,8,0,3,4,15
3/11/1999,5,0,2,8,15
3/12/1999,7,0,7,6,20
3/13/1999,11,0,6,9,26
3/14/1999,6,0,9,2,17
3/15/1999,10,0,8,1,19
3/16/1999,10,0,3,7,20
3/17/1999,4,0,2,9,15
3/18/1999,5,0,5,6,16
3/19/1999,10,0,2,10,22
3/20/1999,4,0,10,2,16
3/21/1999,6,0,9,5,20
3/22/1999,6,0,5,9,20
3/23/1999,9,0,7,8,24
3/24/1999,4,0,4,5,13
3/25/1999,12,0,7,5,24
3/26/1999,5,0,7,9,21
3/27/1999,4,0,5,8,17
3/28/1999,6,0,9,11,26
3/29/1999,12,0,9,8,29
3/30/1999,7,0,5,10,22
3/31/1999,6,0,5,4,15
4/1/1999,8,0,5,10,23
4/2/1999,12,0,8,11,31
4/3/1999,10,0,7,4,21
4/4/1999,7,0,9,2,18
4/5/1999,6,0,10,9,25
4/6/1999,6,0,10,5,21
4/7/1999,5,0,10,2,17
4/8/1999,9,0,3,4,16
4/9/1999,7,0,2,7,16
4/10/1999,8,0,3,7,18
4/11/1999,6,0,2,6,14
4/12/1999,11,0,6,7,24
4/13/1999,5,0,7,11,23
4/14/1999,9,0,6,6,21
4/15/1999,10,0,3,10,23
4/16/1999,4,0,8,4,16
4/17/1999,4,0,9,10,23
4/18/1999,10,0,6,10,26
4/19/1999,6,0,8,5,19
4/20/1999,8,0,3,8,19
4/21/1999,4,0,7,3,14
4/22/1999,8,0,7,2,17
4/23/1999,9,0,9,7,25
4/24/1999,6,0,7,2,15
4/25/1999,4,0,6,5,15
4/26/1999,7,0,2,1,10
4/27/1999,4,0,4,7,15
4/28/1999,11,0,7,8,26
4/29/1999,9,0,4,5,18
4/30/1999,11,0,2,6,19
5/1/1999,12,0,5,0,17
5/2/1999,6,0,5,5,16
5/3/1999,4,0,6,1,11
5/4/1999,7,0,10,4,21
5/5/1999,4,0,5,2,11
5/6/1999,6,0,2,9,17
5/7/1999,8,0,3,4,15
5/8/1999,8,0,6,1,15
5/9/1999,5,0,5,2,12
5/10/1999,7,0,10,4,21
5/11/1999,5,0,10,9,24
5/12/1999,5,0,2,4,11
5/13/1999,6,0,3,1,10
5/14/1999,10,0,6,6,22
5/15/1999,6,0,9,0,15
5/16/1999,6,0,5,10,21
5/17/1999,6,0,5,1,12
5/18/1999,6,0,2,7,15
5/19/1999,7,0,9,3,19
5/20/1999,9,0,6,11,26
5/21/1999,4,0,7,3,14
5/22/1999,9,0,8,8,25
5/23/1999,12,0,8,3,23
5/24/1999,9,0,10,4,23
5/25/1999,8,0,9,4,21
5/26/1999,6,0,3,10,19
5/27/1999,5,0,10,1,16
5/28/1999,7,0,3,0,10
5/29/1999,12,0,10,11,33
5/30/1999,8,0,6,7,21
5/31/1999,6,0,10,5,21
6/1/1999,6,0,2,0,8
6/2/1999,7,0,6,2,15
6/3/1999,7,0,7,7,21
6/4/1999,5,0,9,1,15
6/5/1999,12,0,4,1,17
6/6/1999,6,0,5,0,11
6/7/1999,10,0,3,3,16
6/8/1999,6,0,10,7,23
6/9/1999,10,0,4,5,19
6/10/1999,12,0,5,5,22
6/11/1999,8,0,3,7,18
6/12/1999,6,0,9,3,18
6/13/1999,4,0,6,11,21
6/14/1999,5,0,9,8,22
6/15/1999,7,0,4,0,11
6/16/1999,5,0,4,11,20
6/17/1999,12,0,6,0,18
6/18/1999,5,0,5,6,16
6/19/1999,10,0,9,9,28
6/20/1999,6,0,5,10,21
6/21/1999,4,0,9,1,14
6/22/1999,6,0,5,2,13
6/23/1999,4,0,4,0,8
6/24/1999,6,0,5,11,22
6/25/1999,4,0,8,2,14
6/26/1999,10,0,2,2,14
6/27/1999,6,0,10,9,25
6/28/1999,5,0,5,0,10
6/29/1999,9,0,7,0,16
6/30/1999,10,0,10,11,31
7/1/1999,5,0,5,6,16
7/2/1999,9,0,9,8,26
7/3/1999,11,0,6,4,21
7/4/1999,10,0,3,0,13
7/5/1999,7,0,10,2,19
7/6/1999,4,0,2,11,17
7/7/1999,10,0,9,7,26
7/8/1999,8,0,6,5,19
7/9/1999,10,0,8,5,23
7/10/1999,6,0,6,5,17
7/11/1999,5,0,9,10,24
7/12/1999,7,0,4,8,19
7/13/1999,9,0,7,5,21
7/14/1999,6,0,9,1,16
7/15/1999,9,0,2,10,21
7/16/1999,6,0,6,1,13
7/17/1999,4,0,9,9,22
7/18/1999,10,0,2,7,19
7/19/1999,9,0,4,3,16
7/20/1999,6,0,4,11,21
7/21/1999,9,0,9,10,28
7/22/1999,5,0,5,11,21
7/23/1999,11,0,2,11,24
7/24/1999,9,0,9,9,27
7/25/1999,12,0,4,6,22
7/26/1999,6,0,7,2,15
7/27/1999,11,0,8,5,24
7/28/1999,9,0,6,4,19
7/29/1999,6,0,10,6,22
7/30/1999,4,0,8,0,12
7/31/1999,11,0,7,11,29
8/1/1999,7,0,10,1,18
8/2/1999,12,0,10,6,28
8/3/1999,12,0,5,2,19
8/4/1999,4,0,6,10,20
8/5/1999,6,0,7,9,22
8/6/1999,6,0,9,3,18
8/7/1999,4,0,3,5,12
8/8/1999,11,0,3,1,15
8/9/1999,5,0,7,0,12
8/10/1999,12,0,10,3,25
8/11/1999,12,0,5,3,20
8/12/1999,8,0,8,3,19
8/13/1999,10,0,7,8,25
8/14/1999,11,0,3,9,23
8/15/1999,7,0,4,9,20
8/16/1999,12,0,3,3,18
8/17/1999,12,0,9,8,29
8/18/1999,4,0,6,9,19
8/19/1999,7,0,5,10,22
8/20/1999,10,0,10,2,22
8/21/1999,11,0,3,4,18
8/22/1999,5,0,9,7,21
8/23/1999,10,0,3,8,21
8/24/1999,6,0,4,2,12
8/25/1999,4,0,3,3,10
8/26/1999,12,0,3,5,20
8/27/1999,4,0,8,0,12
8/28/1999,8,0,6,3,17
8/29/1999,6,0,10,7,23
8/30/1999,6,0,9,2,17
8/31/1999,12,0,5,3,20
9/1/1999,6,0,7,6,19
9/2/1999,7,0,4,0,11
9/3/1999,10,0,6,3,19
9/4/1999,7,0,4,1,12
9/5/1999,4,0,6,9,19
9/6/1999,6,0,3,1,10
9/7/1999,4,0,7,10,21
9/8/1999,5,0,8,9,22
9/9/1999,12,0,9,4,25
9/10/1999,11,0,9,3,23
9/11/1999,12,0,6,11,29
9/12/1999,7,0,2,2,11
9/13/1999,9,0,8,8,25
9/14/1999,8,0,10,9,27
9/15/1999,8,0,4,2,14
9/16/1999,12,0,2,2,16
9/17/1999,8,0,7,7,22
9/18/1999,9,0,9,11,29
9/19/1999,12,0,2,5,19
9/20/1999,11,0,10,2,23
9/21/1999,9,0,5,6,20
9/22/1999,4,0,8,5,17
9/23/1999,7,0,10,3,20
9/24/1999,4,0,7,8,19
9/25/1999,11,0,4,2,17
9/26/1999,4,0,4,2,10
9/27/1999,6,0,4,2,12
9/28/1999,12,0,8,7,27
9/29/1999,4,0,3,3,10
9/30/1999,10,0,3,5,18
10/1/1999,11,0,7,11,29
10/2/1999,5,0,5,4,14
10/3/1999,5,0,8,6,19
10/4/1999,10,0,6,8,24
10/5/1999,12,0,4,9,25
10/6/1999,12,0,8,6,26
10/7/1999,6,0,8,0,14
10/8/1999,8,0,3,10,21
10/9/1999,8,0,2,1,11
10/10/1999,8,0,6,6,20
10/11/1999,9,0,6,6,21
10/12/1999,8,0,4,3,15
10/13/1999,4,0,5,2,11
10/14/1999,6,0,5,7,18
10/15/1999,10,0,7,9,26
10/16/1999,7,0,7,5,19
10/17/1999,10,0,9,6,25
10/18/1999,4,0,10,7,21
10/19/1999,9,0,8,9,26
10/20/1999,10,0,8,10,28
10/21/1999,11,0,9,1,21
10/22/1999,11,0,6,2,19
10/23/1999,6,0,3,8,17
10/24/1999,10,0,8,8,26
10/25/1999,7,0,3,9,19
10/26/1999,11,0,6,0,17
10/27/1999,9,0,9,6,24
10/28/1999,11,0,3,0,14
10/29/1999,6,0,2,1,9
10/30/1999,6,0,7,6,19
10/31/1999,8,0,9,11,28
11/1/1999,7,0,3,7,17
11/2/1999,11,0,9,4,24
11/3/1999,9,0,9,7,25
11/4/1999,7,0,8,2,17
11/5/1999,10,0,9,3,22
11/6/1999,9,0,6,5,20
11/7/1999,6,0,2,3,11
11/8/1999,6,0,7,4,17
11/9/1999,9,0,9,0,18
11/10/1999,10,0,7,9,26
11/11/1999,5,0,2,1,8
11/12/1999,5,0,8,4,17
11/13/1999,10,0,7,10,27
11/14/1999,5,0,4,3,12
11/15/1999,9,0,2,11,22
11/16/1999,7,0,9,1,17
11/17/1999,4,0,10,2,16
11/18/1999,8,0,7,7,22
11/19/1999,6,0,8,9,23
11/20/1999,5,0,8,9,22
11/21/1999,7,0,10,11,28
11/22/1999,6,0,8,9,23
11/23/1999,10,0,2,10,22
11/24/1999,11,0,8,5,24
11/25/1999,8,0,6,11,25
11/26/1999,12,0,7,4,23
11/27/1999,6,0,7,5,18
11/28/1999,9,0,10,0,19
11/29/1999,6,0,3,4,13
11/30/1999,5,0,7,6,18
12/1/1999,8,0,4,4,16
12/2/1999,4,0,5,1,10
12/3/1999,11,0,8,10,29
12/4/1999,8,0,8,8,24
12/5/1999,6,0,3,11,20
12/6/1999,9,0,9,11,29
12/7/1999,9,0,4,3,16
12/8/1999,11,0,5,8,24
12/9/1999,7,0,3,2,12
12/10/1999,7,0,4,4,15
12/11/1999,10,0,4,5,19
12/12/1999,11,0,3,3,17
12/13/1999,4,0,7,1,12
12/14/1999,12,0,7,9,28
12/15/1999,10,0,8,8,26
12/16/1999,4,0,7,2,13
12/17/1999,5,0,5,4,14
12/18/1999,4,0,9,10,23
12/19/1999,4,0,2,2,8
12/20/1999,10,0,3,6,19
12/21/1999,11,0,7,3,21
12/22/1999,7,0,10,1,18
12/23/1999,11,0,6,6,23
12/24/1999,7,0,10,10,27
12/25/1999,7,0,10,5,22
12/26/1999,7,0,8,9,24
12/27/1999,11,0,2,7,20
12/28/1999,7,0,7,5,19
12/29/1999,10,0,10,7,27
12/30/1999,9,0,4,0,13
12/31/1999,12,0,5,7,24
1/1/2000,6,0,5,7,18
1/2/2000,11,0,8,0,19
1/3/2000,10,0,8,1,19
1/4/2000,7,0,5,8,20
1/5/2000,6,0,2,4,12
1/6/2000,7,0,4,8,19
1/7/2000,5,0,10,5,20
1/8/2000,8,0,2,7,17
1/9/2000,9,0,6,0,15
1/10/2000,9,0,5,1,15
1/11/2000,5,0,5,9,19
1/12/2000,10,0,2,7,19
1/13/2000,5,0,10,11,26
1/14/2000,9,0,3,10,22
1/15/2000,8,0,3,1,12
1/16/2000,9,0,9,8,26
1/17/2000,4,0,6,4,14
1/18/2000,10,0,4,4,18
1/19/2000,4,0,6,6,16
1/20/2000,11,0,6,10,27
1/21/2000,12,0,7,4,23
1/22/2000,11,0,3,3,17
1/23/2000,7,0,8,1,16
1/24/2000,6,0,3,11,20
1/25/2000,12,0,4,7,23
1/26/2000,9,0,3,8,20
1/27/2000,8,0,3,9,20
1/28/2000,11,0,4,11,26
1/29/2000,10,0,10,11,31
1/30/2000,7,0,5,4,16
1/31/2000,10,0,7,11,28
2/1/2000,12,0,10,8,30
2/2/2000,9,0,6,3,18
2/3/2000,5,0,9,8,22
2/4/2000,11,0,4,2,17
2/5/2000,10,0,6,0,16
2/6/2000,8,0,8,1,17
2/7/2000,4,0,2,3,9
2/8/2000,6,0,5,1,12
2/9/2000,10,0,10,1,21
2/10/2000,9,0,3,3,15
2/11/2000,7,0,3,11,21
2/12/2000,8,0,8,6,22
2/13/2000,6,0,4,2,12
2/14/2000,5,0,9,4,18
2/15/2000,12,0,9,11,32
2/16/2000,6,0,4,2,12
2/17/2000,8,0,2,1,11
2/18/2000,11,0,7,9,27
2/19/2000,6,0,6,9,21
2/20/2000,5,0,9,7,21
2/21/2000,8,0,7,2,17
2/22/2000,8,0,7,4,19
2/23/2000,4,0,6,11,21
2/24/2000,8,0,10,1,19
2/25/2000,5,0,5,3,13
2/26/2000,5,0,10,2,17
2/27/2000,12,0,3,5,20
2/28/2000,9,0,9,10,28
2/29/2000,11,0,3,3,17
3/1/2000,8,0,2,4,14
3/2/2000,5,0,10,4,19
3/3/2000,9,0,2,8,19
3/4/2000,5,0,6,8,19
3/5/2000,9,0,2,1,12
3/6/2000,9,0,3,4,16
3/7/2000,9,0,10,6,25
3/8/2000,7,0,7,0,14
3/9/2000,8,0,9,7,24
3/10/2000,10,0,7,10,27
3/11/2000,5,0,7,9,21
3/12/2000,10,0,10,9,29
3/13/2000,4,0,10,9,23
3/14/2000,10,0,3,1,14
3/15/2000,6,0,10,8,24
3/16/2000,8,0,5,4,17
3/17/2000,8,0,9,5,22
3/18/2000,7,0,6,8,21
3/19/2000,4,0,2,10,16
3/20/2000,10,0,5,8,23
3/21/2000,5,0,4,9,18
3/22/2000,9,0,6,10,25
3/23/2000,4,0,10,6,20
3/24/2000,5,0,2,9,16
3/25/2000,7,0,9,7,23
3/26/2000,4,0,10,6,20
3/27/2000,12,0,9,1,22
3/28/2000,6,0,3,2,11
3/29/2000,10,0,7,8,25
3/30/2000,5,0,5,10,20
3/31/2000,9,0,4,11,24
4/1/2000,12,0,5,0,17
4/2/2000,9,0,4,4,17
4/3/2000,4,0,5,1,10
4/4/2000,8,0,8,7,23
4/5/2000,9,0,5,9,23
4/6/2000,5,0,4,1,10
4/7/2000,11,0,5,5,21
4/8/2000,9,0,6,0,15
4/9/2000,5,0,5,3,13
4/10/2000,5,0,5,10,20
4/11/2000,11,0,4,1,16
4/12/2000,4,0,4,0,8
4/13/2000,8,0,5,4,17
4/14/2000,12,0,7,0,19
4/15/2000,11,0,8,1,20
4/16/2000,11,0,9,10,30
4/17/2000,10,0,5,6,21
4/18/2000,9,0,10,10,29
4/19/2000,6,0,4,3,13
4/20/2000,6,0,9,8,23
4/21/2000,11,0,6,9,26
4/22/2000,7,0,4,7,18
4/23/2000,11,0,9,11,31
4/24/2000,8,0,3,7,18
4/25/2000,8,0,2,6,16
4/26/2000,8,0,2,11,21
4/27/2000,8,0,9,11,28
4/28/2000,8,0,6,6,20
4/29/2000,5,0,10,10,25
4/30/2000,11,0,2,5,18
5/1/2000,5,0,6,5,16
5/2/2000,5,0,8,6,19
5/3/2000,4,0,5,3,12
5/4/2000,4,0,4,10,18
5/5/2000,11,0,6,7,24
5/6/2000,5,0,10,9,24
5/7/2000,7,0,10,4,21
5/8/2000,4,0,10,4,18
5/9/2000,12,0,9,9,30
5/10/2000,11,0,3,11,25
5/11/2000,10,0,7,4,21
5/12/2000,8,0,10,6,24
5/13/2000,5,0,9,10,24
5/14/2000,6,0,2,1,9
5/15/2000,12,0,10,6,28
5/16/2000,4,0,6,4,14
5/17/2000,5,0,7,0,12
5/18/2000,11,0,8,0,19
5/19/2000,6,0,9,9,24
5/20/2000,7,0,3,1,11
5/21/2000,7,0,5,10,22
5/22/2000,6,0,4,5,15
5/23/2000,12,0,3,0,15
5/24/2000,5,0,2,7,14
5/25/2000,4,0,7,6,17
5/26/2000,8,0,2,4,14
5/27/2000,4,0,9,10,23
5/28/2000,7,0,7,8,22
5/29/2000,12,0,2,6,20
5/30/2000,8,0,3,3,14
5/31/2000,11,0,2,2,15
6/1/2000,9,0,9,9,27
6/2/2000,11,0,8,8,27
6/3/2000,11,0,7,11,29
6/4/2000,9,0,8,9,26
6/5/2000,10,0,5,10,25
6/6/2000,11,0,6,1,18
6/7/2000,6,0,4,3,13
6/8/2000,7,0,9,2,18
6/9/2000,12,0,5,2,19
6/10/2000,10,0,9,1,20
6/11/2000,6,0,9,4,19
6/12/2000,6,0,4,4,14
6/13/2000,10,0,7,9,26
6/14/2000,8,0,3,3,14
6/15/2000,8,0,4,3,15
6/16/2000,7,0,2,0,9
6/17/2000,4,0,9,2,15
6/18/2000,7,0,9,6,22
6/19/2000,12,0,3,4,19
6/20/2000,10,0,4,8,22
6/21/2000,10,0,4,9,23
6/22/2000,8,0,8,5,21
6/23/2000,7,0,9,11,27
6/24/2000,9,0,6,11,26
6/25/2000,6,0,8,1,15
6/26/2000,9,0,10,7,26
6/27/2000,8,0,10,8,26
6/28/2000,11,0,6,9,26
6/29/2000,11,0,3,5,19
6/30/2000,10,0,7,6,23
7/1/2000,6,0,3,2,11
7/2/2000,10,0,5,3,18
7/3/2000,5,0,7,0,12
7/4/2000,5,0,6,4,15
7/5/2000,5,0,5,9,19
7/6/2000,9,0,2,2,13
7/7/2000,4,0,2,8,14
7/8/2000,12,0,5,0,17
7/9/2000,10,0,6,0,16
7/10/2000,8,0,7,8,23
7/11/2000,10,0,5,9,24
7/12/2000,10,0,4,11,25
7/13/2000,9,0,7,3,19
7/14/2000,11,0,9,9,29
7/15/2000,11,0,5,6,22
7/16/2000,11,0,8,4,23
7/17/2000,12,0,2,2,16
7/18/2000,6,0,10,3,19
7/19/2000,9,0,9,1,19
7/20/2000,6,0,5,1,12
7/21/2000,11,0,9,9,29
7/22/2000,9,0,8,7,24
7/23/2000,4,0,10,9,23
7/24/2000,9,0,6,8,23
7/25/2000,5,0,9,2,16
7/26/2000,12,0,9,8,29
7/27/2000,9,0,3,9,21
7/28/2000,11,0,2,9,22
7/29/2000,10,0,3,7,20
7/30/2000,9,0,4,10,23
7/31/2000,6,0,10,5,21
8/1/2000,7,0,5,8,20
8/2/2000,5,0,7,4,16
8/3/2000,5,0,2,5,12
8/4/2000,4,0,4,7,15
8/5/2000,11,0,4,7,22
8/6/2000,4,0,10,0,14
8/7/2000,11,0,4,5,20
8/8/2000,10,0,7,4,21
8/9/2000,8,0,10,0,18
8/10/2000,6,0,9,8,23
8/11/2000,12,0,3,10,25
8/12/2000,11,0,7,7,25
8/13/2000,11,0,9,11,31
8/14/2000,11,0,9,8,28
8/15/2000,8,0,9,3,20
8/16/2000,11,0,3,6,20
8/17/2000,5,0,2,8,15
8/18/2000,6,0,7,1,14
8/19/2000,8,0,9,4,21
8/20/2000,12,0,9,2,23
8/21/2000,12,0,3,9,24
8/22/2000,4,0,7,2,13
8/23/2000,8,0,7,9,24
8/24/2000,7,0,8,9,24
8/25/2000,4,0,2,7,13
8/26/2000,9,0,3,9,21
8/27/2000,9,0,9,10,28
8/28/2000,6,0,3,8,17
8/29/2000,8,0,7,0,15
8/30/2000,8,0,4,0,12
8/31/2000,5,0,4,1,10
9/1/2000,9,0,2,2,13
9/2/2000,6,0,6,10,22
9/3/2000,9,0,5,0,14
9/4/2000,12,0,7,8,27
9/5/2000,9,0,10,0,19
9/6/2000,4,0,8,11,23
9/7/2000,4,0,7,1,12
9/8/2000,4,0,9,5,18
9/9/2000,5,0,4,10,19
9/10/2000,9,0,10,3,22
9/11/2000,7,0,9,10,26
9/12/2000,8,0,7,3,18
9/13/2000,10,0,6,0,16
9/14/2000,8,0,7,5,20
9/15/2000,10,0,4,11,25
9/16/2000,9,0,9,4,22
9/17/2000,6,0,9,1,16
9/18/2000,8,0,9,7,24
9/19/2000,8,0,7,4,19
9/20/2000,12,0,7,5,24
9/21/2000,10,0,9,8,27
9/22/2000,5,0,9,5,19
9/23/2000,4,0,10,11,25
9/24/2000,9,0,7,8,24
9/25/2000,4,0,8,5,17
9/26/2000,7,0,3,3,13
9/27/2000,4,0,3,5,12
9/28/2000,5,0,2,8,15
9/29/2000,10,0,3,5,18
9/30/2000,6,0,4,8,18
10/1/2000,10,0,8,5,23
10/2/2000,7,0,9,11,27
10/3/2000,10,0,8,3,21
10/4/2000,4,0,5,4,13
10/5/2000,7,0,9,3,19
10/6/2000,6,0,4,1,11
10/7/2000,8,0,8,8,24
10/8/2000,5,0,10,9,24
10/9/2000,6,0,4,1,11
10/10/2000,6,0,8,1,15
10/11/2000,5,0,8,2,15
10/12/2000,4,0,5,9,18
10/13/2000,6,0,5,0,11
10/14/2000,11,0,8,0,19
10/15/2000,7,0,6,1,14
10/16/2000,4,0,8,6,18
10/17/2000,7,0,9,9,25
10/18/2000,5,0,7,5,17
10/19/2000,6,0,10,1,17
10/20/2000,4,0,6,1,11
10/21/2000,6,0,8,10,24
10/22/2000,4,0,8,7,19
10/23/2000,12,0,8,8,28
10/24/2000,10,0,2,4,16
10/25/2000,7,0,3,6,16
10/26/2000,6,0,9,11,26
10/27/2000,9,0,6,4,19
10/28/2000,8,0,2,0,10
10/29/2000,6,0,3,11,20
10/30/2000,12,0,4,6,22
10/31/2000,11,0,7,8,26
11/1/2000,10,0,8,0,18
11/2/2000,6,0,6,8,20
11/3/2000,12,0,6,2,20
11/4/2000,4,0,9,11,24
11/5/2000,10,0,3,8,21
11/6/2000,4,0,2,1,7
11/7/2000,9,0,5,10,24
11/8/2000,5,0,10,5,20
11/9/2000,6,0,2,5,13
11/10/2000,10,0,5,10,25
11/11/2000,9,0,10,9,28
11/12/2000,7,0,7,0,14
11/13/2000,10,0,9,1,20
11/14/2000,11,0,10,11,32
11/15/2000,5,0,6,10,21
11/16/2000,8,0,8,5,21
11/17/2000,11,0,5,7,23
11/18/2000,4,0,6,11,21
11/19/2000,9,0,6,1,16
11/20/2000,12,0,9,5,26
11/21/2000,12,0,7,2,21
11/22/2000,6,0,6,5,17
11/23/2000,11,0,9,5,25
11/24/2000,5,0,10,9,24
11/25/2000,5,0,10,1,16
11/26/2000,11,0,5,0,16
11/27/2000,10,0,10,9,29
11/28/2000,11,0,9,7,27
11/29/2000,8,0,3,11,22
11/30/2000,4,0,9,4,17
12/1/2000,6,0,2,1,9
12/2/2000,9,0,3,7,19
12/3/2000,4,0,6,11,21
12/4/2000,12,0,7,4,23
12/5/2000,6,0,3,7,16
12/6/2000,5,0,7,10,22
12/7/2000,9,0,8,5,22
12/8/2000,8,0,6,2,16
12/9/2000,5,0,10,2,17
12/10/2000,10,0,10,9,29
12/11/2000,8,0,2,9,19
12/12/2000,5,0,8,0,13
12/13/2000,10,0,8,4,22
12/14/2000,4,0,3,3,10
12/15/2000,8,0,4,5,17
12/16/2000,8,0,10,10,28
12/17/2000,9,0,4,9,22
12/18/2000,9,0,3,9,21
12/19/2000,8,0,10,1,19
12/20/2000,9,0,9,10,28
12/21/2000,12,0,3,4,19
12/22/2000,7,0,2,5,14
12/23/2000,4,0,6,9,19
12/24/2000,10,0,6,11,27
12/25/2000,12,0,10,8,30
12/26/2000,7,0,8,8,23
12/27/2000,4,0,6,6,16
12/28/2000,11,0,7,2,20
12/29/2000,6,0,9,1,16
12/30/2000,8,0,7,1,16
12/31/2000,4,0,2,3,9
1/1/2001,6,0,8,11,25
1/2/2001,11,0,4,1,16
1/3/2001,9,0,9,7,25
1/4/2001,6,0,9,10,25
1/5/2001,8,0,9,5,22
1/6/2001,4,0,6,6,16
1/7/2001,5,0,7,7,19
1/8/2001,11,0,3,1,15
1/9/2001,8,0,3,8,19
1/10/2001,10,0,9,4,23
1/11/2001,9,0,7,8,24
1/12/2001,6,0,9,11,26
1/13/2001,8,0,10,2,20
1/14/2001,7,0,2,3,12
1/15/2001,4,0,5,3,12
1/16/2001,9,0,9,5,23
1/17/2001,7,0,3,8,18
1/18/2001,7,0,3,2,12
1/19/2001,12,0,2,3,17
1/20/2001,9,0,3,5,17
1/21/2001,8,0,3,2,13
1/22/2001,7,0,10,2,19
1/23/2001,12,0,10,2,24
1/24/2001,9,0,2,11,22
1/25/2001,7,0,2,0,9
1/26/2001,12,0,9,5,26
1/27/2001,6,0,4,8,18
1/28/2001,6,0,3,3,12
1/29/2001,11,0,3,0,14
1/30/2001,10,0,4,9,23
1/31/2001,9,0,4,8,21
2/1/2001,8,0,6,1,15
2/2/2001,6,0,3,9,18
2/3/2001,9,0,6,5,20
2/4/2001,7,0,10,0,17
2/5/2001,7,0,9,4,20
2/6/2001,4,0,9,7,20
2/7/2001,9,0,8,11,28
2/8/2001,10,0,7,1,18
2/9/2001,4,0,5,2,11
2/10/2001,7,0,10,0,17
2/11/2001,8,0,4,5,17
2/12/2001,9,0,7,1,17
2/13/2001,12,0,10,3,25
2/14/2001,8,0,10,1,19
2/15/2001,9,0,7,10,26
2/16/2001,6,0,5,6,17
2/17/2001,8,0,5,3,16
2/18/2001,9,0,4,1,14
2/19/2001,8,0,2,9,19
2/20/2001,9,0,6,6,21
2/21/2001,11,0,10,6,27
2/22/2001,8,0,2,9,19
2/23/2001,4,0,2,3,9
2/24/2001,11,0,2,9,22
2/25/2001,4,0,4,3,11
2/26/2001,8,0,4,11,23
2/27/2001,4,0,9,0,13
2/28/2001,9,0,4,10,23
3/1/2001,4,0,7,1,12
3/2/2001,7,0,5,8,20
3/3/2001,4,0,10,8,22
3/4/2001,4,0,2,9,15
3/5/2001,10,0,4,5,19
3/6/2001,8,0,2,0,10
3/7/2001,12,0,2,2,16
3/8/2001,8,0,10,2,20
3/9/2001,5,0,3,7,15
3/10/2001,8,0,6,10,24
3/11/2001,4,0,3,2,9
3/12/2001,4,0,2,4,10
3/13/2001,4,0,8,4,16
3/14/2001,12,0,5,8,25
3/15/2001,4,0,5,0,9
3/16/2001,6,0,5,11,22
3/17/2001,9,0,9,10,28
3/18/2001,12,0,7,4,23
3/19/2001,5,0,6,7,18
3/20/2001,6,0,3,8,17
3/21/2001,9,0,8,5,22
3/22/2001,5,0,7,9,21
3/23/2001,12,0,9,0,21
3/24/2001,5,0,8,9,22
3/25/2001,5,0,6,7,18
3/26/2001,8,0,6,9,23
3/27/2001,7,0,3,9,19
3/28/2001,5,0,6,11,22
3/29/2001,8,0,3,7,18
3/30/2001,12,0,3,3,18
3/31/2001,11,0,6,8,25
4/1/2001,10,0,3,10,23
4/2/2001,8,0,5,10,23
4/3/2001,10,0,6,9,25
4/4/2001,9,0,10,10,29
4/5/2001,7,0,6,11,24
4/6/2001,4,0,6,3,13
4/7/2001,11,0,10,1,22
4/8/2001,6,0,10,2,18
4/9/2001,4,0,8,1,13
4/10/2001,6,0,4,10,20
4/11/2001,10,0,6,2,18
4/12/2001,10,0,2,7,19
4/13/2001,7,0,2,9,18
4/14/2001,9,0,10,8,27
4/15/2001,12,0,2,5,19
4/16/2001,12,0,4,1,17
4/17/2001,10,0,10,2,22
4/18/2001,10,0,8,7,25
4/19/2001,6,0,2,5,13
4/20/2001,12,0,6,3,21
4/21/2001,11,0,7,6,24
4/22/2001,12,0,5,9,26
4/23/2001,9,0,4,10,23
4/24/2001,5,0,4,4,13
4/25/2001,5,0,4,8,17
4/26/2001,4,0,9,8,21
4/27/2001,8,0,9,2,19
4/28/2001,12,0,6,3,21
4/29/2001,11,0,7,2,20
4/30/2001,9,0,3,1,13
5/1/2001,9,0,10,1,20
5/2/2001,7,0,2,8,17
5/3/2001,10,0,10,6,26
5/4/2001,12,0,8,8,28
5/5/2001,7,0,3,1,11
5/6/2001,9,0,2,6,17
5/7/2001,8,0,8,3,19
5/8/2001,4,0,4,0,8
5/9/2001,8,0,9,9,26
5/10/2001,10,0,9,3,22
5/11/2001,11,0,3,3,17
5/12/2001,12,0,8,8,28
5/13/2001,6,0,5,3,14
5/14/2001,5,0,9,0,14
5/15/2001,10,0,9,11,30
5/16/2001,8,0,2,2,12
5/17/2001,6,0,4,11,21
5/18/2001,5,0,6,6,17
5/19/2001,4,0,3,11,18
5/20/2001,12,0,9,1,22
5/21/2001,8,0,2,5,15
5/22/2001,4,0,5,0,9
5/23/2001,7,0,9,9,25
5/24/2001,6,0,6,7,19
5/25/2001,12,0,2,0,14
5/26/2001,7,0,9,5,21
5/27/2001,9,0,6,9,24
5/28/2001,8,0,10,11,29
5/29/2001,6,0,7,8,21
5/30/2001,7,0,6,3,16
5/31/2001,10,0,3,0,13
6/1/2001,7,0,8,10,25
6/2/2001,9,0,3,6,18
6/3/2001,9,0,3,0,12
6/4/2001,10,0,4,5,19
6/5/2001,5,0,6,0,11
6/6/2001,8,0,9,6,23
6/7/2001,8,0,6,1,15
6/8/2001,6,0,3,7,16
6/9/2001,10,0,6,6,22
6/10/2001,9,0,7,6,22
6/11/2001,5,0,8,7,20
6/12/2001,9,0,4,5,18
6/13/2001,9,0,2,11,22
6/14/2001,6,0,6,5,17
6/15/2001,6,0,2,5,13
6/16/2001,7,0,8,3,18
6/17/2001,10,0,4,0,14
6/18/2001,9,0,9,1,19
6/19/2001,10,0,9,5,24
6/20/2001,10,0,5,4,19
6/21/2001,7,0,8,8,23
6/22/2001,12,0,10,5,27
6/23/2001,11,0,8,10,29
6/24/2001,7,0,9,1,17
6/25/2001,5,0,4,4,13
6/26/2001,8,0,4,10,22
6/27/2001,10,0,6,4,20
6/28/2001,10,0,4,7,21
6/29/2001,9,0,5,10,24
6/30/2001,7,0,3,7,17
7/1/2001,5,0,5,10,20
7/2/2001,9,0,7,5,21
7/3/2001,7,0,7,10,24
7/4/2001,12,0,9,7,28
7/5/2001,6,0,8,7,21
7/6/2001,11,0,10,9,30
7/7/2001,11,0,2,7,20
7/8/2001,11,0,5,11,27
7/9/2001,12,0,8,6,26
7/10/2001,7,0,7,11,25
7/11/2001,10,0,8,11,29
7/12/2001,11,0,5,2,18
7/13/2001,5,0,8,9,22
7/14/2001,7,0,4,3,14
7/15/2001,8,0,7,9,24
7/16/2001,5,0,3,11,19
7/17/2001,10,0,4,5,19
7/18/2001,5,0,6,1,12
7/19/2001,10,0,7,10,27
7/20/2001,6,0,7,2,15
7/21/2001,5,0,4,9,18
7/22/2001,11,0,3,1,15
7/23/2001,6,0,8,4,18
7/24/2001,8,0,6,8,22
7/25/2001,6,0,6,10,22
7/26/2001,7,0,3,2,12
7/27/2001,6,0,7,7,20
7/28/2001,5,0,6,9,20
7/29/2001,9,0,4,5,18
7/30/2001,12,0,5,1,18
7/31/2001,12,0,8,9,29
8/1/2001,9,0,3,3,15
8/2/2001,6,0,3,1,10
8/3/2001,9,0,5,2,16
8/4/2001,12,0,6,2,20
8/5/2001,10,0,9,6,25
8/6/2001,9,0,5,7,21
8/7/2001,7,0,5,2,14
8/8/2001,12,0,2,0,14
8/9/2001,8,0,4,0,12
8/10/2001,4,0,5,9,18
8/11/2001,5,0,3,3,11
8/12/2001,5,0,2,3,10
8/13/2001,12,0,4,7,23
8/14/2001,5,0,10,0,15
8/15/2001,8,0,10,3,21
8/16/2001,7,0,5,5,17
8/17/2001,4,0,10,10,24
8/18/2001,9,0,9,6,24
8/19/2001,9,0,10,0,19
8/20/2001,10,0,7,3,20
8/21/2001,4,0,10,2,16
8/22/2001,10,0,7,5,22
8/23/2001,9,0,5,6,20
8/24/2001,5,0,8,7,20
8/25/2001,6,0,8,2,16
8/26/2001,12,0,3,8,23
8/27/2001,4,0,8,11,23
8/28/2001,5,0,9,9,23
8/29/2001,8,0,3,8,19
8/30/2001,10,0,3,4,17
8/31/2001,10,0,6,8,24
9/1/2001,6,0,9,2,17
9/2/2001,4,0,9,11,24
9/3/2001,9,0,7,6,22
9/4/2001,8,0,4,6,18
9/5/2001,5,0,2,2,9
9/6/2001,9,0,7,4,20
9/7/2001,10,0,10,4,24
9/8/2001,4,0,3,6,13
9/9/2001,5,0,3,7,15
9/10/2001,4,0,10,0,14
9/11/2001,7,0,7,0,14
9/12/2001,10,0,6,10,26
9/13/2001,10,0,7,4,21
9/14/2001,5,0,10,8,23
9/15/2001,12,0,6,5,23
9/16/2001,6,0,10,0,16
9/17/2001,12,0,3,0,15
9/18/2001,5,0,3,2,10
9/19/2001,6,0,8,10,24
9/20/2001,10,0,6,7,23
9/21/2001,6,0,9,6,21
9/22/2001,10,0,3,0,13
9/23/2001,7,0,8,2,17
9/24/2001,4,0,9,6,19
9/25/2001,8,0,6,9,23
9/26/2001,8,0,3,3,14
9/27/2001,9,0,3,1,13
9/28/2001,12,0,9,10,31
9/29/2001,12,0,2,3,17
9/30/2001,9,0,8,2,19
10/1/2001,11,0,10,3,24
10/2/2001,12,0,9,9,30
10/3/2001,6,0,4,2,12
10/4/2001,11,0,2,7,20
10/5/2001,10,0,8,6,24
10/6/2001,11,0,9,1,21
10/7/2001,10,0,2,11,23
10/8/2001,7,0,3,0,10
10/9/2001,10,0,3,5,18
10/10/2001,4,0,4,5,13
10/11/2001,5,0,3,8,16
10/12/2001,4,0,3,4,11
10/13/2001,4,0,5,5,14
10/14/2001,11,0,10,5,26
10/15/2001,10,0,10,11,31
10/16/2001,5,0,4,0,9
10/17/2001,5,0,2,4,11
10/18/2001,9,0,8,6,23
10/19/2001,10,0,7,2,19
10/20/2001,10,0,8,6,24
10/21/2001,5,0,8,3,16
10/22/2001,5,0,3,10,18
10/23/2001,12,0,3,9,24
10/24/2001,4,0,8,3,15
10/25/2001,10,0,5,8,23
10/26/2001,8,0,2,2,12
10/27/2001,5,0,2,9,16
10/28/2001,9,0,3,1,13
10/29/2001,5,0,4,0,9
10/30/2001,4,0,8,2,14
10/31/2001,12,0,6,10,28
11/1/2001,12,0,10,9,31
11/2/2001,12,0,7,5,24
11/3/2001,11,0,3,11,25
11/4/2001,10,0,2,9,21
11/5/2001,7,0,8,7,22
11/6/2001,10,0,6,6,22
11/7/2001,4,0,9,1,14
11/8/2001,5,0,8,4,17
11/9/2001,5,0,3,4,12
11/10/2001,4,0,8,0,12
11/11/2001,4,0,6,11,21
11/12/2001,9,0,5,10,24
11/13/2001,12,0,5,4,21
11/14/2001,11,0,2,4,17
11/15/2001,12,0,6,11,29
11/16/2001,6,0,10,0,16
11/17/2001,5,0,9,8,22
11/18/2001,10,0,9,3,22
11/19/2001,12,0,9,4,25
11/20/2001,10,0,7,0,17
11/21/2001,7,0,5,1,13
11/22/2001,12,0,8,3,23
11/23/2001,9,0,3,10,22
11/24/2001,12,0,8,1,21
11/25/2001,8,0,2,4,14
11/26/2001,5,0,6,11,22
11/27/2001,10,0,8,0,18
11/28/2001,9,0,8,9,26
11/29/2001,5,0,7,3,15
11/30/2001,11,0,7,6,24
12/1/2001,8,0,6,7,21
12/2/2001,8,0,4,3,15
12/3/2001,12,0,6,2,20
12/4/2001,12,0,2,2,16
12/5/2001,6,0,7,7,20
12/6/2001,10,0,10,8,28
12/7/2001,12,0,2,7,21
12/8/2001,5,0,2,2,9
12/9/2001,9,0,6,3,18
12/10/2001,8,0,3,10,21
12/11/2001,5,0,3,7,15
12/12/2001,9,0,10,11,30
12/13/2001,12,0,8,0,20
12/14/2001,11,0,7,5,23
12/15/2001,10,0,7,3,20
12/16/2001,4,0,8,3,15
12/17/2001,5,0,7,0,12
12/18/2001,6,0,4,7,17
12/19/2001,9,0,7,8,24
12/20/2001,9,0,2,3,14
12/21/2001,4,0,2,11,17
12/22/2001,10,0,8,3,21
12/23/2001,9,0,6,4,19
12/24/2001,4,0,5,6,15
12/25/2001,9,0,5,5,19
12/26/2001,5,0,9,4,18
12/27/2001,12,0,8,2,22
12/28/2001,11,0,5,6,22
12/29/2001,11,0,2,4,17
12/30/2001,9,0,4,9,22
12/31/2001,4,0,6,2,12
1/1/2002,11,0,7,4,22
1/2/2002,5,0,8,4,17
1/3/2002,5,0,3,10,18
1/4/2002,5,0,2,1,8
1/5/2002,10,0,9,7,26
1/6/2002,5,0,6,4,15
1/7/2002,6,0,3,1,10
1/8/2002,9,0,6,8,23
1/9/2002,11,0,4,1,16
1/10/2002,4,0,4,9,17
1/11/2002,7,0,9,10,26
1/12/2002,9,0,9,4,22
1/13/2002,5,0,10,5,20
1/14/2002,9,0,2,4,15
1/15/2002,8,0,8,8,24
1/16/2002,6,0,10,4,20
1/17/2002,5,0,9,6,20
1/18/2002,11,0,10,7,28
1/19/2002,5,0,4,3,12
1/20/2002,12,0,10,10,32
1/21/2002,5,0,3,10,18
1/22/2002,12,0,3,6,21
1/23/2002,6,0,6,7,19
1/24/2002,9,0,6,2,17
1/25/2002,8,0,7,2,17
1/26/2002,7,0,7,0,14
1/27/2002,7,0,2,6,15
1/28/2002,7,0,9,6,22
1/29/2002,4,0,10,6,20
1/30/2002,6,0,3,0,9
1/31/2002,9,0,7,10,26
2/1/2002,10,0,7,3,20
2/2/2002,8,0,6,7,21
2/3/2002,7,0,10,8,25
2/4/2002,10,0,3,0,13
2/5/2002,4,0,6,11,21
2/6/2002,11,0,10,0,21
2/7/2002,9,0,9,7,25
2/8/2002,10,0,4,0,14
2/9/2002,7,0,9,9,25
2/10/2002,7,0,8,9,24
2/11/2002,11,0,7,8,26
2/12/2002,8,0,3,4,15
2/13/2002,5,0,8,5,18
2/14/2002,9,0,7,2,18
2/15/2002,10,0,6,9,25
2/16/2002,11,0,2,2,15
2/17/2002,7,0,10,9,26
2/18/2002,6,0,9,3,18
2/19/2002,7,0,6,1,14
2/20/2002,12,0,2,6,20
2/21/2002,5,0,2,3,10
2/22/2002,5,0,8,0,13
2/23/2002,4,0,10,0,14
2/24/2002,9,0,9,3,21
2/25/2002,4,0,8,8,20
2/26/2002,10,0,10,0,20
2/27/2002,9,0,6,11,26
2/28/2002,8,0,5,5,18
3/1/2002,10,0,4,3,17
3/2/2002,11,0,10,10,31
3/3/2002,11,0,5,0,16
3/4/2002,11,0,8,6,25
3/5/2002,12,0,2,3,17
3/6/2002,10,0,9,10,29
3/7/2002,9,0,5,2,16
3/8/2002,5,0,6,10,21
3/9/2002,9,0,3,10,22
3/10/2002,9,0,3,11,23
3/11/2002,6,0,6,5,17
3/12/2002,6,0,8,11,25
3/13/2002,5,0,6,5,16
3/14/2002,6,0,10,10,26
3/15/2002,10,0,4,2,16
3/16/2002,10,0,8,7,25
3/17/2002,4,0,8,1,13
3/18/2002,12,0,7,9,28
3/19/2002,9,0,9,2,20
3/20/2002,8,0,8,6,22
3/21/2002,10,0,4,5,19
3/22/2002,9,0,9,9,27
3/23/2002,4,0,5,6,15
3/24/2002,7,0,2,11,20
3/25/2002,7,0,5,2,14
3/26/2002,6,0,10,1,17
3/27/2002,7,0,10,11,28
3/28/2002,11,0,5,8,24
3/29/2002,9,0,2,11,22
3/30/2002,8,0,3,3,14
3/31/2002,11,0,6,8,25
4/1/2002,4,0,9,0,13
4/2/2002,6,0,3,8,17
4/3/2002,12,0,7,7,26
4/4/2002,12,0,10,4,26
4/5/2002,7,0,3,1,11
4/6/2002,4,0,9,0,13
4/7/2002,11,0,2,7,20
4/8/2002,12,0,8,5,25
4/9/2002,9,0,6,5,20
4/10/2002,8,0,2,4,14
4/11/2002,11,0,6,3,20
4/12/2002,5,0,2,3,10
4/13/2002,7,0,2,5,14
4/14/2002,11,0,8,11,30
4/15/2002,9,0,6,11,26
4/16/2002,11,0,8,3,22
4/17/2002,11,0,8,5,24
4/18/2002,4,0,3,1,8
4/19/2002,8,0,10,0,18
4/20/2002,5,0,8,1,14
4/21/2002,11,0,10,11,32
4/22/2002,11,0,7,4,22
4/23/2002,11,0,4,11,26
4/24/2002,8,0,8,9,25
4/25/2002,11,0,2,10,23
4/26/2002,9,0,3,2,14
4/27/2002,7,0,2,0,9
4/28/2002,6,0,7,7,20
4/29/2002,5,0,9,11,25
4/30/2002,8,0,6,0,14
5/1/2002,12,0,10,11,33
5/2/2002,4,0,8,10,22
5/3/2002,8,0,4,10,22
5/4/2002,6,0,4,1,11
5/5/2002,9,0,4,6,19
5/6/2002,10,0,8,0,18
5/7/2002,11,0,8,6,25
5/8/2002,8,0,2,9,19
5/9/2002,7,0,6,1,14
5/10/2002,5,0,6,10,21
5/11/2002,6,0,5,8,19
5/12/2002,4,0,7,2,13
5/13/2002,12,0,8,1,21
5/14/2002,6,0,4,10,20
5/15/2002,4,0,5,11,20
5/16/2002,6,0,9,4,19
5/17/2002,4,0,9,7,20
5/18/2002,5,0,3,1,9
5/19/2002,7,0,10,5,22
5/20/2002,12,0,2,2,16
5/21/2002,7,0,9,7,23
5/22/2002,4,0,2,8,14
5/23/2002,8,0,7,2,17
5/24/2002,9,0,3,2,14
5/25/2002,6,0,8,2,16
5/26/2002,10,0,5,6,21
5/27/2002,10,0,6,11,27
5/28/2002,5,0,10,5,20
5/29/2002,7,0,5,0,12
5/30/2002,11,0,6,2,19
5/31/2002,7,0,6,11,24
6/1/2002,12,0,2,6,20
6/2/2002,10,0,2,5,17
6/3/2002,10,0,5,4,19
6/4/2002,11,0,9,0,20
6/5/2002,9,0,8,3,20
6/6/2002,8,0,10,2,20
6/7/2002,5,0,5,10,20
6/8/2002,4,0,3,10,17
6/9/2002,7,0,5,10,22
6/10/2002,7,0,3,9,19
6/11/2002,5,0,5,7,17
6/12/2002,6,0,9,8,23
6/13/2002,6,0,3,0,9
6/14/2002,12,0,4,2,18
6/15/2002,7,0,7,2,16
6/16/2002,10,0,8,10,28
6/17/2002,7,0,6,8,21
6/18/2002,9,0,4,11,24
6/19/2002,10,0,5,0,15
6/20/2002,10,0,6,6,22
6/21/2002,6,0,9,10,25
6/22/2002,4,0,5,11,20
6/23/2002,10,0,9,4,23
6/24/2002,6,0,8,7,21
6/25/2002,4,0,8,8,20
6/26/2002,9,0,8,2,19
6/27/2002,6,0,10,0,16
6/28/2002,6,0,6,3,15
6/29/2002,9,0,7,7,23
6/30/2002,9,0,4,10,23
7/1/2002,8,0,10,0,18
7/2/2002,4,0,3,9,16
7/3/2002,4,0,3,6,13
7/4/2002,8,0,10,6,24
7/5/2002,7,0,6,8,21
7/6/2002,11,0,5,5,21
7/7/2002,5,0,6,0,11
7/8/2002,6,0,10,9,25
7/9/2002,10,0,2,10,22
7/10/2002,11,0,6,7,24
7/11/2002,7,0,3,9,19
7/12/2002,5,0,2,0,7
7/13/2002,10,0,4,9,23
7/14/2002,7,0,7,0,14
7/15/2002,4,0,7,0,11
7/16/2002,5,0,10,9,24
7/17/2002,11,0,3,6,20
7/18/2002,8,0,3,5,16
7/19/2002,11,0,4,1,16
7/20/2002,11,0,5,0,16
7/21/2002,10,0,6,1,17
7/22/2002,6,0,8,0,14
7/23/2002,8,0,6,0,14
7/24/2002,11,0,5,4,20
7/25/2002,4,0,2,8,14
7/26/2002,4,0,2,7,13
7/27/2002,10,0,8,3,21
7/28/2002,10,0,8,11,29
7/29/2002,10,0,2,4,16
7/30/2002,8,0,3,3,14
7/31/2002,9,0,2,10,21
8/1/2002,7,0,8,7,22
8/2/2002,6,0,2,0,8
8/3/2002,11,0,2,0,13
8/4/2002,6,0,4,9,19
8/5/2002,10,0,2,3,15
8/6/2002,10,0,9,7,26
8/7/2002,7,0,6,10,23
8/8/2002,9,0,6,2,17
8/9/2002,11,0,2,5,18
8/10/2002,10,0,8,11,29
8/11/2002,11,0,3,9,23
8/12/2002,10,0,8,0,18
8/13/2002,8,0,6,5,19
8/14/2002,4,0,3,10,17
8/15/2002,10,0,7,9,26
8/16/2002,6,0,5,8,19
8/17/2002,4,0,7,8,19
8/18/2002,7,0,2,11,20
8/19/2002,8,0,6,6,20
8/20/2002,6,0,6,3,15
8/21/2002,8,0,7,9,24
8/22/2002,5,0,2,8,15
8/23/2002,12,0,5,11,28
8/24/2002,8,0,4,3,15
8/25/2002,9,0,2,7,18
8/26/2002,4,0,10,6,20
8/27/2002,12,0,6,1,19
8/28/2002,7,0,6,7,20
8/29/2002,11,0,7,9,27
8/30/2002,7,0,8,7,22
8/31/2002,5,0,2,9,16
9/1/2002,10,0,3,6,19
9/2/2002,9,0,8,5,22
9/3/2002,6,0,6,9,21
9/4/2002,9,0,5,0,14
9/5/2002,7,0,7,4,18
9/6/2002,4,0,9,2,15
9/7/2002,4,0,3,1,8
9/8/2002,11,0,2,8,21
9/9/2002,10,0,8,2,20
9/10/2002,7,0,5,6,18
9/11/2002,12,0,2,0,14
9/12/2002,5,0,7,7,19
9/13/2002,9,0,9,2,20
9/14/2002,7,0,6,11,24
9/15/2002,4,0,4,10,18
9/16/2002,6,0,5,9,20
9/17/2002,9,0,7,3,19
9/18/2002,10,0,9,11,30
9/19/2002,11,0,6,3,20
9/20/2002,10,0,10,10,30
9/21/2002,6,0,9,8,23
9/22/2002,7,0,7,0,14
9/23/2002,8,0,2,6,16
9/24/2002,10,0,9,0,19
9/25/2002,7,0,6,11,24
9/26/2002,5,0,6,11,22
9/27/2002,8,0,8,0,16
9/28/2002,6,0,3,7,16
9/29/2002,8,0,3,4,15
9/30/2002,4,0,2,8,14
10/1/2002,6,0,9,8,23
10/2/2002,5,0,5,0,10
10/3/2002,9,0,9,9,27
10/4/2002,4,0,4,0,8
10/5/2002,6,0,4,4,14
10/6/2002,6,0,10,4,20
10/7/2002,10,0,9,4,23
10/8/2002,5,0,5,4,14
10/9/2002,11,0,4,1,16
10/10/2002,5,0,6,6,17
10/11/2002,5,0,9,10,24
10/12/2002,10,0,10,1,21
10/13/2002,7,0,6,6,19
10/14/2002,5,0,4,7,16
10/15/2002,8,0,4,9,21
10/16/2002,11,0,6,8,25
10/17/2002,9,0,10,5,24
10/18/2002,10,0,7,11,28
10/19/2002,6,0,8,1,15
10/20/2002,11,0,9,9,29
10/21/2002,7,0,3,2,12
10/22/2002,12,0,5,5,22
10/23/2002,7,0,3,4,14
10/24/2002,8,0,5,4,17
10/25/2002,12,0,10,5,27
10/26/2002,4,0,4,6,14
10/27/2002,11,0,8,0,19
10/28/2002,4,0,7,1,12
10/29/2002,11,0,9,6,26
10/30/2002,12,0,4,5,21
10/31/2002,4,0,10,5,19
11/1/2002,9,0,7,10,26
11/2/2002,12,0,5,3,20
11/3/2002,6,0,4,1,11
11/4/2002,4,0,2,2,8
11/5/2002,9,0,2,11,22
11/6/2002,5,0,8,6,19
11/7/2002,5,0,8,0,13
11/8/2002,5,0,8,1,14
11/9/2002,10,0,2,4,16
11/10/2002,4,0,3,3,10
11/11/2002,6,0,7,4,17
11/12/2002,7,0,3,3,13
11/13/2002,9,0,10,0,19
11/14/2002,7,0,3,10,20
11/15/2002,11,0,2,10,23
11/16/2002,7,0,7,11,25
11/17/2002,4,0,5,7,16
11/18/2002,7,0,6,5,18
11/19/2002,5,0,7,1,13
11/20/2002,11,0,5,11,27
11/21/2002,5,0,3,1,9
11/22/2002,8,0,6,1,15
11/23/2002,4,0,4,5,13
11/24/2002,9,0,7,10,26
11/25/2002,4,0,6,6,16
11/26/2002,9,0,2,6,17
11/27/2002,11,0,10,3,24
11/28/2002,6,0,3,10,19
11/29/2002,7,0,9,0,16
11/30/2002,9,0,3,11,23
12/1/2002,10,0,9,5,24
12/2/2002,12,0,8,5,25
12/3/2002,8,0,5,9,22
12/4/2002,9,0,4,8,21
12/5/2002,9,0,7,4,20
12/6/2002,8,0,9,2,19
12/7/2002,9,0,8,6,23
12/8/2002,10,0,8,11,29
12/9/2002,12,0,5,0,17
12/10/2002,11,0,7,7,25
12/11/2002,11,0,9,0,20
12/12/2002,7,0,7,9,23
12/13/2002,11,0,6,6,23
12/14/2002,7,0,2,0,9
12/15/2002,5,0,10,5,20
12/16/2002,9,0,2,10,21
12/17/2002,7,0,9,3,19
12/18/2002,4,0,7,6,17
12/19/2002,11,0,2,0,13
12/20/2002,9,0,5,8,22
12/21/2002,9,0,3,7,19
12/22/2002,4,0,9,5,18
12/23/2002,5,0,4,1,10
12/24/2002,4,0,2,5,11
12/25/2002,5,0,6,9,20
12/26/2002,7,0,7,9,23
12/27/2002,5,0,7,0,12
12/28/2002,6,0,5,4,15
12/29/2002,6,0,5,11,22
12/30/2002,8,0,7,10,25
12/31/2002,12,0,5,3,20
1/1/2003,4,0,9,3,16
1/2/2003,9,0,4,5,18
1/3/2003,10,0,6,0,16
1/4/2003,6,0,10,3,19
1/5/2003,9,0,7,10,26
1/6/2003,6,0,7,4,17
1/7/2003,4,0,9,2,15
1/8/2003,5,0,3,6,14
1/9/2003,9,0,10,3,22
1/10/2003,7,0,3,3,13
1/11/2003,6,0,3,4,13
1/12/2003,9,0,2,8,19
1/13/2003,10,0,4,8,22
1/14/2003,8,0,6,6,20
1/15/2003,7,0,7,9,23
1/16/2003,4,0,2,0,6
1/17/2003,10,0,2,0,12
1/18/2003,7,0,10,1,18
1/19/2003,8,0,7,8,23
1/20/2003,6,0,5,9,20
1/21/2003,6,0,3,9,18
1/22/2003,8,0,9,7,24
1/23/2003,10,0,10,9,29
1/24/2003,8,0,10,1,19
1/25/2003,10,0,9,0,19
1/26/2003,9,0,10,10,29
1/27/2003,7,0,9,6,22
1/28/2003,10,0,10,1,21
1/29/2003,7,0,5,10,22
1/30/2003,4,0,10,6,20
1/31/2003,9,0,4,0,13
2/1/2003,7,0,3,10,20
2/2/2003,11,0,2,1,14
2/3/2003,4,0,5,1,10
2/4/2003,9,0,10,8,27
2/5/2003,5,0,8,9,22
2/6/2003,6,0,8,10,24
2/7/2003,6,0,9,1,16
2/8/2003,7,0,9,2,18
2/9/2003,5,0,5,9,19
2/10/2003,10,0,7,1,18
2/11/2003,8,0,6,5,19
2/12/2003,5,0,4,10,19
2/13/2003,4,0,5,3,12
2/14/2003,12,0,6,8,26
2/15/2003,5,0,4,2,11
2/16/2003,6,0,7,10,23
2/17/2003,9,0,10,10,29
2/18/2003,4,0,9,0,13
2/19/2003,8,0,8,6,22
2/20/2003,10,0,9,5,24
2/21/2003,6,0,6,6,18
2/22/2003,7,0,8,1,16
2/23/2003,7,0,7,8,22
2/24/2003,4,0,4,4,12
2/25/2003,5,0,7,6,18
2/26/2003,10,0,7,2,19
2/27/2003,4,0,5,5,14
2/28/2003,10,0,6,8,24
3/1/2003,10,0,3,2,15
3/2/2003,9,0,3,8,20
3/3/2003,6,0,10,11,27
3/4/2003,5,0,4,0,9
3/5/2003,9,0,3,7,19
3/6/2003,8,0,10,2,20
3/7/2003,4,0,10,9,23
3/8/2003,10,0,10,7,27
3/9/2003,4,0,8,6,18
3/10/2003,6,0,8,1,15
3/11/2003,8,0,7,7,22
3/12/2003,12,0,4,7,23
3/13/2003,10,0,3,5,18
3/14/2003,11,0,10,0,21
3/15/2003,8,0,9,1,18
3/16/2003,7,0,9,5,21
3/17/2003,12,0,9,6,27
3/18/2003,4,0,3,8,15
3/19/2003,6,0,5,11,22
3/20/2003,6,0,5,2,13
3/21/2003,11,0,3,2,16
3/22/2003,9,0,7,6,22
3/23/2003,10,0,5,7,22
3/24/2003,10,0,5,7,22
3/25/2003,11,0,4,2,17
3/26/2003,11,0,8,3,22
3/27/2003,6,0,2,4,12
3/28/2003,7,0,3,2,12
3/29/2003,7,0,4,11,22
3/30/2003,11,0,10,5,26
3/31/2003,7,0,7,0,14
4/1/2003,7,0,9,5,21
4/2/2003,11,0,8,1,20
4/3/2003,12,0,6,7,25
4/4/2003,6,0,6,4,16
4/5/2003,4,0,4,1,9
4/6/2003,12,0,10,6,28
4/7/2003,8,0,2,5,15
4/8/2003,6,0,9,3,18
4/9/2003,10,0,7,8,25
4/10/2003,12,0,6,0,18
4/11/2003,5,0,4,2,11
4/12/2003,4,0,7,1,12
4/13/2003,5,0,3,4,12
4/14/2003,9,0,5,11,25
4/15/2003,10,0,8,11,29
4/16/2003,4,0,2,7,13
4/17/2003,11,0,6,1,18
4/18/2003,4,0,8,7,19
4/19/2003,10,0,2,1,13
4/20/2003,10,0,9,4,23
4/21/2003,6,0,4,0,10
4/22/2003,6,0,10,9,25
4/23/2003,4,0,8,7,19
4/24/2003,8,0,10,7,25
4/25/2003,6,0,10,10,26
4/26/2003,12,0,4,6,22
4/27/2003,5,0,10,1,16
4/28/2003,12,0,2,1,15
4/29/2003,8,0,7,6,21
4/30/2003,5,0,6,11,22
5/1/2003,10,0,8,3,21
5/2/2003,7,0,10,3,20
5/3/2003,10,0,7,5,22
5/4/2003,6,0,8,8,22
5/5/2003,5,0,10,3,18
5/6/2003,5,0,8,0,13
5/7/2003,5,0,7,0,12
5/8/2003,7,0,9,9,25
5/9/2003,8,0,7,11,26
5/10/2003,12,0,5,11,28
5/11/2003,8,0,2,8,18
5/12/2003,9,0,5,3,17
5/13/2003,5,0,7,2,14
5/14/2003,8,0,2,3,13
5/15/2003,8,0,4,2,14
5/16/2003,12,0,5,4,21
5/17/2003,8,0,2,5,15
5/18/2003,7,0,3,10,20
5/19/2003,10,0,2,6,18
5/20/2003,11,0,8,1,20
5/21/2003,6,0,9,0,15
5/22/2003,4,0,4,9,17
5/23/2003,8,0,5,4,17
5/24/2003,8,0,4,5,17
5/25/2003,8,0,9,3,20
5/26/2003,7,0,4,8,19
5/27/2003,7,0,4,11,22
5/28/2003,8,0,7,8,23
5/29/2003,7,0,2,5,14
5/30/2003,9,0,10,4,23
5/31/2003,6,0,3,1,10
6/1/2003,8,0,3,10,21
6/2/2003,11,0,8,9,28
6/3/2003,12,0,3,7,22
6/4/2003,4,0,8,2,14
6/5/2003,9,0,3,3,15
6/6/2003,9,0,7,8,24
6/7/2003,12,0,7,7,26
6/8/2003,7,0,4,2,13
6/9/2003,8,0,3,0,11
6/10/2003,10,0,2,5,17
6/11/2003,5,0,6,4,15
6/12/2003,5,0,5,10,20
6/13/2003,7,0,9,4,20
6/14/2003,9,0,3,5,17
6/15/2003,4,0,6,0,10
6/16/2003,11,0,9,0,20
6/17/2003,5,0,9,4,18
6/18/2003,7,0,10,3,20
6/19/2003,12,0,4,9,25
6/20/2003,5,0,4,0,9
6/21/2003,11,0,8,10,29
6/22/2003,12,0,8,9,29
6/23/2003,8,0,8,3,19
6/24/2003,11,0,2,8,21
6/25/2003,6,0,6,8,20
6/26/2003,6,0,7,9,22
6/27/2003,5,0,4,11,20
6/28/2003,12,0,3,9,24
6/29/2003,7,0,10,10,27
6/30/2003,7,0,9,1,17
7/1/2003,9,0,10,2,21
7/2/2003,5,0,2,5,12
7/3/2003,4,0,8,7,19
7/4/2003,7,0,4,1,12
7/5/2003,7,0,2,7,16
7/6/2003,12,0,2,6,20
7/7/2003,10,0,2,6,18
7/8/2003,4,0,5,11,20
7/9/2003,10,0,8,0,18
7/10/2003,5,0,7,3,15
7/11/2003,11,0,4,4,19
7/12/2003,8,0,5,1,14
7/13/2003,4,0,8,9,21
7/14/2003,5,0,10,6,21
7/15/2003,7,0,10,9,26
7/16/2003,10,0,5,2,17
7/17/2003,7,0,3,7,17
7/18/2003,10,0,7,0,17
7/19/2003,10,0,7,0,17
7/20/2003,9,0,8,5,22
7/21/2003,11,0,3,6,20
7/22/2003,6,0,3,10,19
7/23/2003,4,0,10,10,24
7/24/2003,4,0,5,11,20
7/25/2003,7,0,2,8,17
7/26/2003,12,0,3,11,26
7/27/2003,4,0,7,9,20
7/28/2003,8,0,4,2,14
7/29/2003,10,0,4,7,21
7/30/2003,11,0,5,2,18
7/31/2003,12,0,6,3,21
8/1/2003,9,0,9,1,19
8/2/2003,7,0,5,4,16
8/3/2003,4,0,4,11,19
8/4/2003,9,0,7,3,19
8/5/2003,10,0,2,11,23
8/6/2003,5,0,10,9,24
8/7/2003,12,0,3,6,21
8/8/2003,4,0,2,11,17
8/9/2003,10,0,5,7,22
8/10/2003,11,0,6,6,23
8/11/2003,4,0,2,1,7
8/12/2003,6,0,9,7,22
8/13/2003,9,0,2,9,20
8/14/2003,9,0,2,7,18
8/15/2003,5,0,9,11,25
8/16/2003,6,0,7,10,23
8/17/2003,10,0,5,6,21
8/18/2003,5,0,8,10,23
8/19/2003,10,0,4,4,18
8/20/2003,12,0,10,1,23
8/21/2003,12,0,5,9,26
8/22/2003,4,0,2,6,12
8/23/2003,8,0,9,0,17
8/24/2003,9,0,6,8,23
8/25/2003,11,0,8,5,24
8/26/2003,12,0,2,7,21
8/27/2003,5,0,4,7,16
8/28/2003,10,0,3,11,24
8/29/2003,12,0,2,5,19
8/30/2003,9,0,2,7,18
8/31/2003,10,0,6,6,22
9/1/2003,7,0,3,6,16
9/2/2003,11,0,4,4,19
9/3/2003,8,0,9,0,17
9/4/2003,8,0,5,0,13
9/5/2003,6,0,10,0,16
9/6/2003,10,0,4,11,25
9/7/2003,6,0,9,7,22
9/8/2003,4,0,2,10,16
9/9/2003,8,0,3,10,21
9/10/2003,5,0,3,7,15
9/11/2003,11,0,6,8,25
9/12/2003,9,0,9,9,27
9/13/2003,8,0,8,6,22
9/14/2003,9,0,7,4,20
9/15/2003,6,0,8,8,22
9/16/2003,10,0,4,6,20
9/17/2003,4,0,2,8,14
9/18/2003,6,0,7,2,15
9/19/2003,7,0,9,8,24
9/20/2003,7,0,3,8,18
9/21/2003,12,0,3,8,23
9/22/2003,5,0,10,10,25
9/23/2003,11,0,10,1,22
9/24/2003,9,0,6,6,21
9/25/2003,8,0,8,3,19
9/26/2003,6,0,8,0,14
9/27/2003,11,0,3,7,21
9/28/2003,9,0,3,5,17
9/29/2003,5,0,9,4,18
9/30/2003,4,0,10,8,22
10/1/2003,5,0,3,6,14
10/2/2003,8,0,2,3,13
10/3/2003,11,0,2,8,21
10/4/2003,4,0,8,3,15
10/5/2003,8,0,2,1,11
10/6/2003,10,0,9,1,20
10/7/2003,7,0,10,8,25
10/8/2003,8,0,5,9,22
10/9/2003,6,0,5,11,22
10/10/2003,7,0,2,7,16
10/11/2003,11,0,9,0,20
10/12/2003,9,0,8,5,22
10/13/2003,5,0,4,9,18
10/14/2003,10,0,4,3,17
10/15/2003,12,0,9,1,22
10/16/2003,12,0,4,5,21
10/17/2003,8,0,2,6,16
10/18/2003,5,0,8,4,17
10/19/2003,5,0,10,8,23
10/20/2003,8,0,9,7,24
10/21/2003,6,0,6,4,16
10/22/2003,5,0,3,0,8
10/23/2003,6,0,4,5,15
10/24/2003,10,0,8,11,29
10/25/2003,12,0,10,11,33
10/26/2003,9,0,7,6,22
10/27/2003,5,0,6,0,11
10/28/2003,12,0,5,3,20
10/29/2003,10,0,7,0,17
10/30/2003,6,0,3,1,10
10/31/2003,6,0,8,5,19
11/1/2003,12,0,9,8,29
11/2/2003,6,0,7,0,13
11/3/2003,10,0,8,8,26
11/4/2003,8,0,9,9,26
11/5/2003,10,0,8,4,22
11/6/2003,9,0,8,0,17
11/7/2003,5,0,4,10,19
11/8/2003,9,0,10,2,21
11/9/2003,8,0,2,5,15
11/10/2003,7,0,4,2,13
11/11/2003,8,0,10,3,21
11/12/2003,9,0,6,7,22
11/13/2003,10,0,3,0,13
11/14/2003,5,0,5,7,17
11/15/2003,9,0,8,2,19
11/16/2003,12,0,10,11,33
11/17/2003,10,0,2,6,18
11/18/2003,5,0,5,2,12
11/19/2003,4,0,2,10,16
11/20/2003,7,0,7,4,18
11/21/2003,9,0,6,10,25
11/22/2003,5,0,9,6,20
11/23/2003,10,0,7,8,25
11/24/2003,9,0,3,1,13
11/25/2003,7,0,2,3,12
11/26/2003,12,0,2,6,20
11/27/2003,8,0,3,10,21
11/28/2003,11,0,3,1,15
11/29/2003,6,0,2,5,13
11/30/2003,10,0,10,7,27
12/1/2003,6,0,3,4,13
12/2/2003,10,0,8,5,23
12/3/2003,7,0,7,2,16
12/4/2003,12,0,3,10,25
12/5/2003,8,0,10,6,24
12/6/2003,12,0,4,11,27
12/7/2003,7,0,5,9,21
12/8/2003,12,0,10,7,29
12/9/2003,9,0,7,5,21
12/10/2003,9,0,4,3,16
12/11/2003,4,0,5,9,18
12/12/2003,10,0,9,0,19
12/13/2003,9,0,4,7,20
12/14/2003,9,0,9,10,28
12/15/2003,4,0,4,6,14
12/16/2003,5,0,4,5,14
12/17/2003,7,0,8,4,19
12/18/2003,8,0,7,11,26
12/19/2003,4,0,5,11,20
12/20/2003,10,0,8,10,28
12/21/2003,11,0,9,1,21
12/22/2003,11,0,9,2,22
12/23/2003,6,0,8,8,22
12/24/2003,7,0,3,11,21
12/25/2003,12,0,8,5,25
12/26/2003,12,0,7,10,29
12/27/2003,9,0,10,1,20
12/28/2003,7,0,6,0,13
12/29/2003,12,0,7,3,22
12/30/2003,9,0,4,3,16
12/31/2003,5,0,10,0,15
1/1/2004,10,0,5,10,25
1/2/2004,11,0,6,9,26
1/3/2004,11,0,3,0,14
1/4/2004,10,0,9,5,24
1/5/2004,7,0,7,9,23
1/6/2004,7,0,2,9,18
1/7/2004,6,0,9,5,20
1/8/2004,11,0,6,7,24
1/9/2004,5,0,8,6,19
1/10/2004,4,0,6,5,15
1/11/2004,5,0,6,9,20
1/12/2004,5,0,6,5,16
1/13/2004,10,0,8,1,19
1/14/2004,4,0,8,3,15
1/15/2004,10,0,9,4,23
1/16/2004,12,0,5,3,20
1/17/2004,6,0,7,6,19
1/18/2004,4,0,6,0,10
1/19/2004,5,0,5,1,11
1/20/2004,10,0,7,9,26
1/21/2004,9,0,4,10,23
1/22/2004,9,0,10,11,30
1/23/2004,12,0,6,1,19
1/24/2004,5,0,8,5,18
1/25/2004,10,0,3,10,23
1/26/2004,12,0,7,10,29
1/27/2004,10,0,3,11,24
1/28/2004,8,0,2,3,13
1/29/2004,7,0,9,2,18
1/30/2004,12,0,3,7,22
1/31/2004,12,0,8,8,28
2/1/2004,8,0,9,4,21
2/2/2004,12,0,4,2,18
2/3/2004,7,0,2,3,12
2/4/2004,12,0,6,0,18
2/5/2004,4,0,4,11,19
2/6/2004,12,0,9,9,30
2/7/2004,5,0,2,4,11
2/8/2004,6,0,6,4,16
2/9/2004,11,0,2,7,20
2/10/2004,5,0,8,10,23
2/11/2004,7,0,4,11,22
2/12/2004,7,0,5,9,21
2/13/2004,11,0,8,0,19
2/14/2004,5,0,3,9,17
2/15/2004,8,0,7,8,23
2/16/2004,6,0,9,5,20
2/17/2004,9,0,5,1,15
2/18/2004,7,0,9,8,24
2/19/2004,8,0,9,9,26
2/20/2004,5,0,10,7,22
2/21/2004,9,0,6,2,17
2/22/2004,9,0,4,1,14
2/23/2004,7,0,3,0,10
2/24/2004,7,0,6,10,23
2/25/2004,7,0,2,8,17
2/26/2004,10,0,4,5,19
2/27/2004,9,0,9,10,28
2/28/2004,9,0,8,4,21
2/29/2004,4,0,6,10,20
3/1/2004,11,0,9,0,20
3/2/2004,4,0,4,10,18
3/3/2004,5,0,9,9,23
3/4/2004,12,0,6,8,26
3/5/2004,5,0,2,2,9
3/6/2004,9,0,7,2,18
3/7/2004,10,0,7,9,26
3/8/2004,5,0,3,9,17
3/9/2004,12,0,5,1,18
3/10/2004,6,0,4,4,14
3/11/2004,4,0,7,7,18
3/12/2004,11,0,2,2,15
3/13/2004,11,0,5,1,17
3/14/2004,6,0,2,11,19
3/15/2004,12,0,4,5,21
3/16/2004,7,0,7,7,21
3/17/2004,4,0,5,11,20
3/18/2004,8,0,9,11,28
3/19/2004,5,0,8,4,17
3/20/2004,5,0,5,2,12
3/21/2004,7,0,8,0,15
3/22/2004,8,0,2,4,14
3/23/2004,10,0,10,2,22
3/24/2004,9,0,4,8,21
3/25/2004,11,0,7,0,18
3/26/2004,5,0,4,9,18
3/27/2004,5,0,4,9,18
3/28/2004,11,0,10,1,22
3/29/2004,10,0,9,1,20
3/30/2004,12,0,7,5,24
3/31/2004,6,0,8,7,21
4/1/2004,9,0,2,10,21
4/2/2004,11,0,7,2,20
4/3/2004,9,0,3,5,17
4/4/2004,10,0,3,4,17
4/5/2004,7,0,9,5,21
4/6/2004,12,0,9,9,30
4/7/2004,8,0,10,9,27
4/8/2004,6,0,2,4,12
4/9/2004,12,0,2,10,24
4/10/2004,5,0,6,3,14
4/11/2004,6,0,7,0,13
4/12/2004,7,0,8,0,15
4/13/2004,8,0,4,2,14
4/14/2004,5,0,10,4,19
4/15/2004,5,0,4,0,9
4/16/2004,5,0,5,1,11
4/17/2004,7,0,6,8,21
4/18/2004,10,0,9,3,22
4/19/2004,7,0,2,2,11
4/20/2004,10,0,2,7,19
4/21/2004,5,0,2,4,11
4/22/2004,6,0,10,10,26
4/23/2004,12,0,7,7,26
4/24/2004,4,0,5,9,18
4/25/2004,10,0,3,4,17
4/26/2004,9,0,5,0,14
4/27/2004,4,0,7,9,20
4/28/2004,8,0,10,9,27
4/29/2004,11,0,3,5,19
4/30/2004,8,0,10,2,20
5/1/2004,7,0,6,11,24
5/2/2004,12,0,2,9,23
5/3/2004,9,0,8,2,19
5/4/2004,12,0,8,3,23
5/5/2004,8,0,3,9,20
5/6/2004,9,0,8,8,25
5/7/2004,4,0,4,1,9
5/8/2004,12,0,5,1,18
5/9/2004,11,0,3,9,23
5/10/2004,8,0,10,4,22
5/11/2004,9,0,2,9,20
5/12/2004,11,0,4,5,20
5/13/2004,9,0,8,11,28
5/14/2004,4,0,9,3,16
5/15/2004,7,0,6,6,19
5/16/2004,5,0,4,2,11
5/17/2004,12,0,10,3,25
5/18/2004,4,0,10,8,22
5/19/2004,8,0,2,1,11
5/20/2004,11,0,9,7,27
5/21/2004,10,0,4,5,19
5/22/2004,8,0,7,0,15
5/23/2004,12,0,5,5,22
5/24/2004,9,0,2,9,20
5/25/2004,10,0,7,7,24
5/26/2004,12,0,4,1,17
5/27/2004,10,0,10,8,28
5/28/2004,7,0,4,4,15
5/29/2004,8,0,5,9,22
5/30/2004,12,0,6,2,20
5/31/2004,11,0,4,3,18
6/1/2004,6,0,9,11,26
6/2/2004,6,0,7,3,16
6/3/2004,10,0,4,8,22
6/4/2004,9,0,10,7,26
6/5/2004,8,0,2,2,12
6/6/2004,7,0,10,1,18
6/7/2004,10,0,2,11,23
6/8/2004,6,0,9,6,21
6/9/2004,12,0,9,4,25
6/10/2004,12,0,3,8,23
6/11/2004,11,0,10,8,29
6/12/2004,7,0,9,11,27
6/13/2004,5,0,7,8,20
6/14/2004,4,0,8,0,12
6/15/2004,5,0,10,8,23
6/16/2004,5,0,9,6,20
6/17/2004,4,0,8,6,18
6/18/2004,7,0,10,9,26
6/19/2004,6,0,2,6,14
6/20/2004,9,0,3,5,17
6/21/2004,7,0,6,1,14
6/22/2004,8,0,5,7,20
6/23/2004,11,0,10,11,32
6/24/2004,5,0,3,4,12
6/25/2004,12,0,10,3,25
6/26/2004,7,0,2,3,12
6/27/2004,9,0,7,8,24
6/28/2004,4,0,9,1,14
6/29/2004,5,0,10,11,26
6/30/2004,11,0,4,8,23
7/1/2004,5,0,2,1,8
7/2/2004,5,0,2,1,8
7/3/2004,6,0,5,6,17
7/4/2004,7,0,9,2,18
7/5/2004,5,0,2,0,7
7/6/2004,12,0,8,7,27
7/7/2004,4,0,3,3,10
7/8/2004,10,0,9,2,21
7/9/2004,4,0,6,7,17
7/10/2004,5,0,7,2,14
7/11/2004,12,0,5,0,17
7/12/2004,6,0,8,7,21
7/13/2004,10,0,5,11,26
7/14/2004,7,0,2,7,16
7/15/2004,7,0,9,4,20
7/16/2004,8,0,8,2,18
7/17/2004,10,0,5,8,23
7/18/2004,9,0,10,0,19
7/19/2004,9,0,3,4,16
7/20/2004,8,0,10,9,27
7/21/2004,5,0,10,11,26
7/22/2004,9,0,8,1,18
7/23/2004,4,0,8,2,14
7/24/2004,4,0,5,9,18
7/25/2004,7,0,9,9,25
7/26/2004,9,0,5,9,23
7/27/2004,12,0,7,11,30
7/28/2004,6,0,4,9,19
7/29/2004,9,0,10,7,26
7/30/2004,5,0,7,10,22
7/31/2004,8,0,2,3,13
8/1/2004,9,0,8,4,21
8/2/2004,10,0,7,7,24
8/3/2004,6,0,10,3,19
8/4/2004,8,0,5,2,15
8/5/2004,4,0,10,2,16
8/6/2004,12,0,3,3,18
8/7/2004,11,0,3,0,14
8/8/2004,6,0,9,3,18
8/9/2004,12,0,8,1,21
8/10/2004,10,0,6,6,22
8/11/2004,8,0,9,5,22
8/12/2004,12,0,8,10,30
8/13/2004,11,0,3,4,18
8/14/2004,4,0,6,3,13
8/15/2004,10,0,4,5,19
8/16/2004,6,0,2,8,16
8/17/2004,7,0,3,0,10
8/18/2004,4,0,8,11,23
8/19/2004,9,0,2,4,15
8/20/2004,12,0,9,9,30
8/21/2004,4,0,4,10,18
8/22/2004,12,0,7,1,20
8/23/2004,4,0,9,6,19
8/24/2004,9,0,6,2,17
8/25/2004,5,0,7,5,17
8/26/2004,7,0,7,6,20
8/27/2004,4,0,10,1,15
8/28/2004,12,0,9,0,21
8/29/2004,8,0,9,11,28
8/30/2004,11,0,5,6,22
8/31/2004,6,0,9,3,18
9/1/2004,8,0,6,1,15
9/2/2004,7,0,3,6,16
9/3/2004,8,0,10,6,24
9/4/2004,10,0,2,9,21
9/5/2004,12,0,7,0,19
9/6/2004,9,0,8,4,21
9/7/2004,4,0,6,2,12
9/8/2004,6,0,4,7,17
9/9/2004,4,0,10,9,23
9/10/2004,12,0,9,11,32
9/11/2004,8,0,8,8,24
9/12/2004,11,0,2,6,19
9/13/2004,11,0,10,11,32
9/14/2004,12,0,2,10,24
9/15/2004,6,0,5,6,17
9/16/2004,8,0,2,0,10
9/17/2004,7,0,7,5,19
9/18/2004,4,0,6,0,10
9/19/2004,11,0,3,8,22
9/20/2004,10,0,2,8,20
9/21/2004,9,0,9,7,25
9/22/2004,4,0,6,10,20
9/23/2004,9,0,3,3,15
9/24/2004,7,0,9,2,18
9/25/2004,8,0,10,8,26
9/26/2004,7,0,5,4,16
9/27/2004,8,0,6,10,24
9/28/2004,7,0,6,10,23
9/29/2004,6,0,6,10,22
9/30/2004,5,0,3,9,17
10/1/2004,9,0,9,1,19
10/2/2004,4,0,5,3,12
10/3/2004,9,0,7,8,24
10/4/2004,4,0,2,1,7
10/5/2004,6,0,4,4,14
10/6/2004,11,0,4,5,20
10/7/2004,5,0,5,9,19
10/8/2004,7,0,5,9,21
10/9/2004,7,0,9,0,16
10/10/2004,8,0,6,0,14
10/11/2004,11,0,9,0,20
10/12/2004,12,0,2,3,17
10/13/2004,11,0,9,6,26
10/14/2004,6,0,3,8,17
10/15/2004,10,0,7,3,20
10/16/2004,10,0,5,10,25
10/17/2004,12,0,9,3,24
10/18/2004,4,0,7,1,12
10/19/2004,12,0,8,6,26
10/20/2004,4,0,8,10,22
10/21/2004,9,0,2,11,22
10/22/2004,4,0,5,8,17
10/23/2004,5,0,7,9,21
10/24/2004,8,0,8,1,17
10/25/2004,5,0,10,10,25
10/26/2004,10,0,9,0,19
10/27/2004,11,0,6,4,21
10/28/2004,8,0,3,1,12
10/29/2004,5,0,8,3,16
10/30/2004,9,0,8,4,21
10/31/2004,6,0,5,11,22
11/1/2004,7,0,6,8,21
11/2/2004,8,0,10,0,18
11/3/2004,9,0,9,1,19
11/4/2004,6,0,8,7,21
11/5/2004,5,0,3,5,13
11/6/2004,10,0,4,10,24
11/7/2004,12,0,7,7,26
11/8/2004,8,0,10,3,21
11/9/2004,10,0,3,9,22
11/10/2004,10,0,3,5,18
11/11/2004,10,0,2,0,12
11/12/2004,5,0,7,4,16
11/13/2004,6,0,8,9,23
11/14/2004,9,0,4,7,20
11/15/2004,9,0,4,9,22
11/16/2004,6,0,9,5,20
11/17/2004,11,0,7,6,24
11/18/2004,4,0,4,11,19
11/19/2004,10,0,4,10,24
11/20/2004,7,0,10,7,24
11/21/2004,9,0,7,5,21
11/22/2004,12,0,10,4,26
11/23/2004,6,0,7,7,20
11/24/2004,10,0,2,1,13
11/25/2004,6,0,2,10,18
11/26/2004,4,0,2,11,17
11/27/2004,6,0,6,6,18
11/28/2004,5,0,6,1,12
11/29/2004,4,0,2,7,13
11/30/2004,4,0,2,4,10
12/1/2004,11,0,3,4,18
12/2/2004,7,0,5,1,13
12/3/2004,11,0,6,11,28
12/4/2004,6,0,10,0,16
12/5/2004,8,0,10,4,22
12/6/2004,7,0,2,9,18
12/7/2004,4,0,6,5,15
12/8/2004,8,0,8,3,19
12/9/2004,9,0,5,10,24
12/10/2004,10,0,4,3,17
12/11/2004,9,0,10,3,22
12/12/2004,4,0,9,6,19
12/13/2004,9,0,9,1,19
12/14/2004,8,0,6,5,19
12/15/2004,5,0,3,10,18
12/16/2004,12,0,6,6,24
12/17/2004,9,0,6,9,24
12/18/2004,11,0,2,1,14
12/19/2004,12,0,8,7,27
12/20/2004,12,0,7,0,19
12/21/2004,8,0,8,11,27
12/22/2004,11,0,9,9,29
12/23/2004,7,0,7,10,24
12/24/2004,8,0,4,1,13
12/25/2004,11,0,10,6,27
12/26/2004,7,0,4,3,14
12/27/2004,11,0,8,0,19
12/28/2004,6,0,5,6,17
12/29/2004,7,0,3,5,15
12/30/2004,8,0,4,5,17
12/31/2004,6,0,10,1,17
1/1/2005,11,0,8,6,25
1/2/2005,10,0,3,6,19
1/3/2005,10,0,10,11,31
1/4/2005,10,0,7,5,22
1/5/2005,9,0,2,10,21
1/6/2005,6,0,6,8,20
1/7/2005,12,0,3,3,18
1/8/2005,9,0,7,4,20
1/9/2005,5,0,2,9,16
1/10/2005,5,0,4,10,19
1/11/2005,10,0,7,9,26
1/12/2005,11,0,7,5,23
1/13/2005,9,0,4,7,20
1/14/2005,11,0,9,8,28
1/15/2005,7,0,6,10,23
1/16/2005,7,0,9,5,21
1/17/2005,6,0,8,11,25
1/18/2005,7,0,10,6,23
1/19/2005,8,0,2,11,21
1/20/2005,11,0,10,8,29
1/21/2005,6,0,8,4,18
1/22/2005,8,0,9,8,25
1/23/2005,5,0,10,9,24
1/24/2005,5,0,8,11,24
1/25/2005,10,0,2,3,15
1/26/2005,4,0,10,5,19
1/27/2005,11,0,2,6,19
1/28/2005,5,0,6,0,11
1/29/2005,10,0,7,1,18
1/30/2005,5,0,3,3,11
1/31/2005,7,0,2,3,12
2/1/2005,7,0,2,0,9
2/2/2005,7,0,4,0,11
2/3/2005,12,0,4,7,23
2/4/2005,9,0,10,5,24
2/5/2005,12,0,8,4,24
2/6/2005,10,0,4,2,16
2/7/2005,7,0,6,3,16
2/8/2005,10,0,10,11,31
2/9/2005,12,0,3,8,23
2/10/2005,10,0,2,8,20
2/11/2005,4,0,5,9,18
2/12/2005,10,0,5,9,24
2/13/2005,11,0,2,8,21
2/14/2005,11,0,7,7,25
2/15/2005,9,0,8,0,17
2/16/2005,10,0,6,1,17
2/17/2005,8,0,5,0,13
2/18/2005,5,0,8,9,22
2/19/2005,11,0,7,0,18
2/20/2005,7,0,10,2,19
2/21/2005,10,0,9,10,29
2/22/2005,8,0,7,2,17
2/23/2005,7,0,5,11,23
2/24/2005,6,0,7,10,23
2/25/2005,6,0,5,7,18
2/26/2005,4,0,7,9,20
2/27/2005,7,0,8,1,16
2/28/2005,4,0,5,0,9
3/1/2005,7,0,10,2,19
3/2/2005,4,0,10,0,14
3/3/2005,9,0,10,10,29
3/4/2005,10,0,8,9,27
3/5/2005,6,0,3,0,9
3/6/2005,10,0,3,2,15
3/7/2005,5,0,10,7,22
3/8/2005,4,0,5,3,12
3/9/2005,6,0,7,4,17
3/10/2005,9,0,4,7,20
3/11/2005,12,0,6,9,27
3/12/2005,7,0,6,7,20
3/13/2005,11,0,3,3,17
3/14/2005,6,0,5,6,17
3/15/2005,8,0,2,4,14
3/16/2005,8,0,7,2,17
3/17/2005,4,0,6,3,13
3/18/2005,11,0,5,9,25
3/19/2005,12,0,4,7,23
3/20/2005,4,0,3,2,9
3/21/2005,11,0,7,4,22
3/22/2005,7,0,7,4,18
3/23/2005,9,0,6,0,15
3/24/2005,10,0,10,5,25
3/25/2005,12,0,10,3,25
3/26/2005,6,0,5,7,18
3/27/2005,4,0,9,5,18
3/28/2005,4,0,3,0,7
3/29/2005,10,0,3,2,15
3/30/2005,10,0,2,10,22
3/31/2005,11,0,3,6,20
4/1/2005,9,0,4,11,24
4/2/2005,5,0,6,9,20
4/3/2005,4,0,3,7,14
4/4/2005,7,0,7,4,18
4/5/2005,11,0,4,10,25
4/6/2005,4,0,2,11,17
4/7/2005,11,0,2,3,16
4/8/2005,12,0,5,0,17
4/9/2005,11,0,4,3,18
4/10/2005,6,0,5,6,17
4/11/2005,11,0,3,4,18
4/12/2005,12,0,2,5,19
4/13/2005,4,0,8,3,15
4/14/2005,8,0,6,2,16
4/15/2005,8,0,2,5,15
4/16/2005,7,0,10,9,26
4/17/2005,5,0,9,7,21
4/18/2005,11,0,3,4,18
4/19/2005,10,0,6,11,27
4/20/2005,8,0,5,2,15
4/21/2005,4,0,6,1,11
4/22/2005,8,0,10,0,18
4/23/2005,8,0,2,1,11
4/24/2005,10,0,4,3,17
4/25/2005,8,0,6,1,15
4/26/2005,12,0,10,2,24
4/27/2005,5,0,2,1,8
4/28/2005,8,0,3,6,17
4/29/2005,7,0,2,9,18
4/30/2005,12,0,9,5,26
5/1/2005,7,0,9,11,27
5/2/2005,6,0,5,5,16
5/3/2005,5,0,5,10,20
5/4/2005,6,0,5,7,18
5/5/2005,5,0,5,2,12
5/6/2005,5,0,3,4,12
5/7/2005,11,0,10,5,26
5/8/2005,11,0,8,0,19
5/9/2005,11,0,8,0,19
5/10/2005,11,0,4,5,20
5/11/2005,11,0,6,8,25
5/12/2005,8,0,2,8,18
5/13/2005,11,0,6,9,26
5/14/2005,10,0,9,10,29
5/15/2005,5,0,8,9,22
5/16/2005,8,0,9,3,20
5/17/2005,7,0,5,3,15
5/18/2005,6,0,9,2,17
5/19/2005,7,0,3,2,12
5/20/2005,12,0,3,9,24
5/21/2005,5,0,10,8,23
5/22/2005,4,0,3,7,14
5/23/2005,12,0,5,10,27
5/24/2005,9,0,4,10,23
5/25/2005,12,0,6,5,23
5/26/2005,6,0,9,5,20
5/27/2005,12,0,8,5,25
5/28/2005,6,0,7,2,15
5/29/2005,6,0,9,10,25
5/30/2005,4,0,6,9,19
5/31/2005,12,0,10,1,23
6/1/2005,7,0,6,11,24
6/2/2005,5,0,5,3,13
6/3/2005,7,0,3,2,12
6/4/2005,11,0,5,7,23
6/5/2005,7,0,9,2,18
6/6/2005,7,0,7,7,21
6/7/2005,12,0,9,5,26
6/8/2005,9,0,2,6,17
6/9/2005,9,0,5,7,21
6/10/2005,11,0,8,5,24
6/11/2005,7,0,6,3,16
6/12/2005,5,0,3,7,15
6/13/2005,9,0,3,6,18
6/14/2005,9,0,4,6,19
6/15/2005,12,0,9,0,21
6/16/2005,10,0,10,5,25
6/17/2005,10,0,8,0,18
6/18/2005,7,0,3,10,20
6/19/2005,12,0,3,7,22
6/20/2005,6,0,8,7,21
6/21/2005,6,0,4,11,21
6/22/2005,9,0,5,3,17
6/23/2005,4,0,8,4,16
6/24/2005,8,0,9,11,28
6/25/2005,9,0,6,10,25
6/26/2005,12,0,8,4,24
6/27/2005,6,0,9,6,21
6/28/2005,9,0,8,1,18
6/29/2005,8,0,10,0,18
6/30/2005,4,0,8,10,22
7/1/2005,12,0,7,0,19
7/2/2005,11,0,9,1,21
7/3/2005,10,0,4,1,15
7/4/2005,11,0,7,2,20
7/5/2005,7,0,5,9,21
7/6/2005,11,0,9,4,24
7/7/2005,4,0,4,5,13
7/8/2005,9,0,3,8,20
7/9/2005,12,0,5,6,23
7/10/2005,5,0,4,8,17
7/11/2005,6,0,5,8,19
7/12/2005,6,0,7,4,17
7/13/2005,12,0,5,2,19
7/14/2005,7,0,7,7,21
7/15/2005,6,0,4,8,18
7/16/2005,7,0,6,5,18
7/17/2005,11,0,10,3,24
7/18/2005,4,0,4,5,13
7/19/2005,5,0,8,2,15
7/20/2005,11,0,7,4,22
7/21/2005,5,0,9,0,14
7/22/2005,11,0,8,4,23
7/23/2005,9,0,9,1,19
7/24/2005,12,0,3,9,24
7/25/2005,8,0,9,9,26
7/26/2005,4,0,10,0,14
7/27/2005,5,0,8,8,21
7/28/2005,8,0,10,1,19
7/29/2005,10,0,9,7,26
7/30/2005,6,0,3,6,15
7/31/2005,8,0,3,3,14
8/1/2005,6,0,9,5,20
8/2/2005,4,0,5,8,17
8/3/2005,8,0,5,9,22
8/4/2005,10,0,7,6,23
8/5/2005,7,0,4,2,13
8/6/2005,7,0,6,5,18
8/7/2005,8,0,4,9,21
8/8/2005,6,0,7,9,22
8/9/2005,11,0,2,2,15
8/10/2005,10,0,6,6,22
8/11/2005,6,0,6,5,17
8/12/2005,8,0,7,10,25
8/13/2005,7,0,4,5,16
8/14/2005,6,0,9,2,17
8/15/2005,4,0,6,5,15
8/16/2005,5,0,7,10,22
8/17/2005,8,0,3,1,12
8/18/2005,4,0,10,5,19
8/19/2005,9,0,6,5,20
8/20/2005,4,0,8,9,21
8/21/2005,11,0,6,2,19
8/22/2005,9,0,6,9,24
8/23/2005,4,0,7,2,13
8/24/2005,5,0,2,11,18
8/25/2005,9,0,4,0,13
8/26/2005,7,0,3,1,11
8/27/2005,12,0,9,2,23
8/28/2005,4,0,9,7,20
8/29/2005,7,0,5,2,14
8/30/2005,5,0,2,0,7
8/31/2005,11,0,2,5,18
9/1/2005,5,0,10,11,26
9/2/2005,12,0,8,1,21
9/3/2005,12,0,3,7,22
9/4/2005,8,0,6,3,17
9/5/2005,5,0,3,2,10
9/6/2005,10,0,10,1,21
9/7/2005,11,0,10,3,24
9/8/2005,8,0,3,11,22
9/9/2005,11,0,4,4,19
9/10/2005,7,0,8,9,24
9/11/2005,8,0,3,8,19
9/12/2005,11,0,6,11,28
9/13/2005,5,0,6,2,13
9/14/2005,8,0,7,4,19
9/15/2005,7,0,7,11,25
9/16/2005,7,0,9,2,18
9/17/2005,8,0,8,9,25
9/18/2005,7,0,4,6,17
9/19/2005,7,0,6,0,13
9/20/2005,6,0,3,2,11
9/21/2005,11,0,2,1,14
9/22/2005,10,0,6,0,16
9/23/2005,10,0,5,1,16
9/24/2005,7,0,3,7,17
9/25/2005,7,0,3,5,15
9/26/2005,12,0,4,10,26
9/27/2005,10,0,3,2,15
9/28/2005,10,0,8,6,24
9/29/2005,11,0,3,1,15
9/30/2005,9,0,6,2,17
10/1/2005,10,0,7,9,26
10/2/2005,8,0,3,9,20
10/3/2005,6,0,10,3,19
10/4/2005,12,0,8,2,22
10/5/2005,4,0,4,6,14
10/6/2005,12,0,6,11,29
10/7/2005,6,0,2,3,11
10/8/2005,11,0,9,3,23
10/9/2005,12,0,10,0,22
10/10/2005,7,0,5,4,16
10/11/2005,4,0,6,4,14
10/12/2005,10,0,4,11,25
10/13/2005,12,0,7,6,25
10/14/2005,10,0,10,4,24
10/15/2005,7,0,5,0,12
10/16/2005,5,0,3,8,16
10/17/2005,10,0,7,9,26
10/18/2005,6,0,4,1,11
10/19/2005,5,0,9,5,19
10/20/2005,11,0,6,4,21
10/21/2005,9,0,5,8,22
10/22/2005,4,0,9,6,19
10/23/2005,6,0,9,2,17
10/24/2005,9,0,3,6,18
10/25/2005,4,0,10,1,15
10/26/2005,11,0,7,9,27
10/27/2005,10,0,4,4,18
10/28/2005,11,0,7,11,29
10/29/2005,9,0,3,4,16
10/30/2005,8,0,8,7,23
10/31/2005,4,0,3,5,12
11/1/2005,9,0,8,8,25
11/2/2005,4,0,9,11,24
11/3/2005,12,0,9,1,22
11/4/2005,7,0,9,0,16
11/5/2005,6,0,7,2,15
11/6/2005,7,0,5,4,16
11/7/2005,11,0,10,10,31
11/8/2005,8,0,10,9,27
11/9/2005,4,0,4,7,15
11/10/2005,10,0,2,10,22
11/11/2005,10,0,3,10,23
11/12/2005,9,0,10,6,25
11/13/2005,6,0,10,0,16
11/14/2005,11,0,5,0,16
11/15/2005,6,0,5,9,20
11/16/2005,6,0,9,8,23
11/17/2005,8,0,10,1,19
11/18/2005,9,0,2,11,22
11/19/2005,10,0,8,1,19
11/20/2005,7,0,9,10,26
11/21/2005,6,0,7,6,19
11/22/2005,8,0,4,9,21
11/23/2005,11,0,4,5,20
11/24/2005,11,0,6,9,26
11/25/2005,11,0,6,2,19
11/26/2005,10,0,5,5,20
11/27/2005,9,0,2,0,11
11/28/2005,8,0,10,9,27
11/29/2005,12,0,3,2,17
11/30/2005,9,0,3,7,19
12/1/2005,12,0,4,9,25
12/2/2005,11,0,10,3,24
12/3/2005,8,0,3,8,19
12/4/2005,9,0,7,3,19
12/5/2005,8,0,6,11,25
12/6/2005,12,0,9,3,24
12/7/2005,9,0,9,8,26
12/8/2005,4,0,6,9,19
12/9/2005,10,0,4,11,25
12/10/2005,10,0,4,7,21
12/11/2005,10,0,8,9,27
12/12/2005,9,0,7,7,23
12/13/2005,11,0,9,3,23
12/14/2005,12,0,3,11,26
12/15/2005,9,0,3,6,18
12/16/2005,8,0,6,4,18
12/17/2005,5,0,7,4,16
12/18/2005,11,0,5,0,16
12/19/2005,10,0,9,9,28
12/20/2005,12,0,6,3,21
12/21/2005,4,0,10,6,20
12/22/2005,7,0,8,7,22
12/23/2005,4,0,10,10,24
12/24/2005,11,0,4,6,21
12/25/2005,7,0,4,3,14
12/26/2005,4,0,5,5,14
12/27/2005,8,0,4,11,23
12/28/2005,6,0,6,8,20
12/29/2005,10,0,2,10,22
12/30/2005,10,0,3,0,13
12/31/2005,10,0,3,9,22
1/1/2006,12,0,6,3,21
1/2/2006,12,0,9,9,30
1/3/2006,9,0,6,1,16
1/4/2006,11,0,6,3,20
1/5/2006,6,0,7,6,19
1/6/2006,12,0,2,2,16
1/7/2006,4,0,8,2,14
1/8/2006,5,0,6,1,12
1/9/2006,4,0,4,2,10
1/10/2006,6,0,3,3,12
1/11/2006,5,0,6,1,12
1/12/2006,4,0,6,5,15
1/13/2006,8,0,5,1,14
1/14/2006,6,0,9,11,26
1/15/2006,12,0,9,9,30
1/16/2006,4,0,6,7,17
1/17/2006,11,0,8,4,23
1/18/2006,9,0,8,3,20
1/19/2006,8,0,2,2,12
1/20/2006,4,0,6,2,12
1/21/2006,9,0,9,10,28
1/22/2006,7,0,8,8,23
1/23/2006,8,0,8,5,21
1/24/2006,8,0,7,2,17
1/25/2006,11,0,2,5,18
1/26/2006,4,0,7,11,22
1/27/2006,8,0,9,1,18
1/28/2006,8,0,5,6,19
1/29/2006,8,0,8,9,25
1/30/2006,8,0,2,0,10
1/31/2006,8,0,9,11,28
2/1/2006,6,0,7,11,24
2/2/2006,12,0,2,11,25
2/3/2006,9,0,3,1,13
2/4/2006,6,0,10,8,24
2/5/2006,5,0,4,11,20
2/6/2006,7,0,2,4,13
2/7/2006,11,0,9,1,21
2/8/2006,10,0,9,7,26
2/9/2006,4,0,8,10,22
2/10/2006,5,0,2,7,14
2/11/2006,8,0,9,9,26
2/12/2006,4,0,2,2,8
2/13/2006,10,0,3,4,17
2/14/2006,10,0,8,9,27
2/15/2006,8,0,10,10,28
2/16/2006,10,0,4,8,22
2/17/2006,12,0,6,3,21
2/18/2006,7,0,7,0,14
2/19/2006,9,0,8,3,20
2/20/2006,9,0,6,9,24
2/21/2006,5,0,4,2,11
2/22/2006,9,0,8,0,17
2/23/2006,8,0,6,4,18
2/24/2006,11,0,4,6,21
2/25/2006,7,0,7,1,15
2/26/2006,8,0,8,11,27
2/27/2006,4,0,6,6,16
2/28/2006,9,0,4,6,19
3/1/2006,4,0,3,5,12
3/2/2006,7,0,9,6,22
3/3/2006,12,0,6,1,19
3/4/2006,4,0,5,6,15
3/5/2006,6,0,10,7,23
3/6/2006,7,0,10,9,26
3/7/2006,9,0,9,7,25
3/8/2006,5,0,8,9,22
3/9/2006,9,0,3,2,14
3/10/2006,5,0,10,11,26
3/11/2006,7,0,7,3,17
3/12/2006,5,0,7,10,22
3/13/2006,6,0,9,5,20
3/14/2006,12,0,4,8,24
3/15/2006,5,0,5,6,16
3/16/2006,10,0,9,9,28
3/17/2006,10,0,7,8,25
3/18/2006,9,0,10,10,29
3/19/2006,7,0,9,2,18
3/20/2006,6,0,6,10,22
3/21/2006,4,0,7,5,16
3/22/2006,7,0,6,11,24
3/23/2006,9,0,10,4,23
3/24/2006,12,0,5,0,17
3/25/2006,5,0,9,4,18
3/26/2006,7,0,6,1,14
3/27/2006,8,0,10,8,26
3/28/2006,10,0,6,4,20
3/29/2006,12,0,2,5,19
3/30/2006,5,0,5,9,19
3/31/2006,7,0,7,11,25
4/1/2006,9,0,10,11,30
4/2/2006,12,0,8,1,21
4/3/2006,9,0,10,2,21
4/4/2006,5,0,10,9,24
4/5/2006,5,0,10,4,19
4/6/2006,7,0,6,9,22
4/7/2006,4,0,3,4,11
4/8/2006,4,0,9,5,18
4/9/2006,12,0,6,2,20
4/10/2006,7,0,6,4,17
4/11/2006,4,0,9,4,17
4/12/2006,5,0,7,5,17
4/13/2006,9,0,8,1,18
4/14/2006,12,0,5,2,19
4/15/2006,7,0,9,0,16
4/16/2006,7,0,9,5,21
4/17/2006,6,0,4,6,16
4/18/2006,5,0,7,11,23
4/19/2006,4,0,8,6,18
4/20/2006,12,0,10,4,26
4/21/2006,4,0,7,7,18
4/22/2006,11,0,8,8,27
4/23/2006,5,0,5,5,15
4/24/2006,11,0,10,5,26
4/25/2006,10,0,4,0,14
4/26/2006,9,0,8,6,23
4/27/2006,4,0,9,4,17
4/28/2006,9,0,2,10,21
4/29/2006,7,0,4,1,12
4/30/2006,12,0,8,10,30
5/1/2006,4,0,9,3,16
5/2/2006,5,0,7,6,18
5/3/2006,4,0,9,4,17
5/4/2006,11,0,5,11,27
5/5/2006,4,0,5,5,14
5/6/2006,7,0,4,5,16
5/7/2006,8,0,6,4,18
5/8/2006,10,0,4,8,22
5/9/2006,5,0,6,1,12
5/10/2006,6,0,10,4,20
5/11/2006,7,0,6,7,20
5/12/2006,11,0,2,4,17
5/13/2006,8,0,10,4,22
5/14/2006,6,0,9,6,21
5/15/2006,12,0,3,0,15
5/16/2006,9,0,5,6,20
5/17/2006,11,0,10,9,30
5/18/2006,6,0,8,5,19
5/19/2006,4,0,2,5,11
5/20/2006,7,0,9,4,20
5/21/2006,9,0,7,6,22
5/22/2006,5,0,10,1,16
5/23/2006,12,0,5,8,25
5/24/2006,8,0,8,0,16
5/25/2006,6,0,8,5,19
5/26/2006,12,0,2,11,25
5/27/2006,11,0,4,7,22
5/28/2006,11,0,9,6,26
5/29/2006,10,0,5,11,26
5/30/2006,8,0,3,6,17
5/31/2006,7,0,10,3,20
6/1/2006,8,0,9,10,27
6/2/2006,4,0,2,11,17
6/3/2006,7,0,9,1,17
6/4/2006,11,0,9,4,24
6/5/2006,8,0,5,6,19
6/6/2006,9,0,7,3,19
6/7/2006,10,0,4,1,15
6/8/2006,7,0,5,7,19
6/9/2006,8,0,3,9,20
6/10/2006,12,0,7,4,23
6/11/2006,5,0,2,5,12
6/12/2006,6,0,6,11,23
6/13/2006,7,0,4,1,12
6/14/2006,11,0,10,5,26
6/15/2006,6,0,2,3,11
6/16/2006,8,0,9,10,27
6/17/2006,9,0,9,7,25
6/18/2006,8,0,10,6,24
6/19/2006,10,0,6,4,20
6/20/2006,7,0,2,1,10
6/21/2006,5,0,9,10,24
6/22/2006,12,0,7,8,27
6/23/2006,11,0,7,5,23
6/24/2006,4,0,9,5,18
6/25/2006,5,0,6,6,17
6/26/2006,9,0,6,6,21
6/27/2006,12,0,9,3,24
6/28/2006,5,0,4,7,16
6/29/2006,11,0,8,4,23
6/30/2006,8,0,4,0,12
7/1/2006,6,0,6,7,19
7/2/2006,8,0,4,5,17
7/3/2006,5,0,9,4,18
7/4/2006,5,0,3,6,14
7/5/2006,5,0,8,7,20
7/6/2006,4,0,6,4,14
7/7/2006,10,0,6,10,26
7/8/2006,6,0,3,10,19
7/9/2006,10,0,8,9,27
7/10/2006,7,0,6,4,17
7/11/2006,5,0,10,7,22
7/12/2006,8,0,4,0,12
7/13/2006,10,0,4,9,23
7/14/2006,7,0,3,7,17
7/15/2006,7,0,8,7,22
7/16/2006,12,0,3,10,25
7/17/2006,6,0,9,6,21
7/18/2006,4,0,7,1,12
7/19/2006,9,0,6,4,19
7/20/2006,12,0,6,5,23
7/21/2006,8,0,10,10,28
7/22/2006,8,0,4,10,22
7/23/2006,6,0,7,1,14
7/24/2006,10,0,2,4,16
7/25/2006,8,0,4,6,18
7/26/2006,12,0,7,0,19
7/27/2006,10,0,7,6,23
7/28/2006,9,0,8,8,25
7/29/2006,9,0,8,6,23
7/30/2006,8,0,7,7,22
7/31/2006,7,0,10,4,21
8/1/2006,10,0,9,3,22
8/2/2006,7,0,6,2,15
8/3/2006,12,0,3,6,21
8/4/2006,6,0,3,11,20
8/5/2006,4,0,9,7,20
8/6/2006,5,0,5,2,12
8/7/2006,5,0,9,10,24
8/8/2006,4,0,5,4,13
8/9/2006,5,0,10,1,16
8/10/2006,11,0,6,9,26
8/11/2006,10,0,8,4,22
8/12/2006,11,0,4,0,15
8/13/2006,5,0,3,0,8
8/14/2006,6,0,7,5,18
8/15/2006,7,0,3,7,17
8/16/2006,11,0,10,4,25
8/17/2006,10,0,9,4,23
8/18/2006,9,0,8,3,20
8/19/2006,5,0,10,10,25
8/20/2006,7,0,10,0,17
8/21/2006,10,0,10,3,23
8/22/2006,10,0,7,2,19
8/23/2006,8,0,10,4,22
8/24/2006,11,0,3,1,15
8/25/2006,12,0,3,7,22
8/26/2006,4,0,4,11,19
8/27/2006,10,0,2,8,20
8/28/2006,9,0,6,8,23
8/29/2006,6,0,6,7,19
8/30/2006,4,0,4,0,8
8/31/2006,7,0,8,2,17
9/1/2006,4,0,2,6,12
9/2/2006,9,0,10,6,25
9/3/2006,7,0,6,9,22
9/4/2006,8,0,10,2,20
9/5/2006,11,0,7,3,21
9/6/2006,6,0,9,9,24
9/7/2006,6,0,8,9,23
9/8/2006,11,0,6,6,23
9/9/2006,9,0,9,0,18
9/10/2006,6,0,6,6,18
9/11/2006,8,0,6,4,18
9/12/2006,5,0,2,10,17
9/13/2006,12,0,5,3,20
9/14/2006,8,0,4,3,15
9/15/2006,4,0,2,1,7
9/16/2006,7,0,7,11,25
9/17/2006,8,0,7,7,22
9/18/2006,4,0,10,6,20
9/19/2006,11,0,7,1,19
9/20/2006,8,0,6,1,15
9/21/2006,11,0,10,8,29
9/22/2006,9,0,7,4,20
9/23/2006,10,0,5,1,16
9/24/2006,9,0,5,10,24
9/25/2006,4,0,7,8,19
9/26/2006,12,0,5,7,24
9/27/2006,6,0,7,7,20
9/28/2006,7,0,4,5,16
9/29/2006,5,0,5,10,20
9/30/2006,7,0,9,3,19
10/1/2006,4,0,5,4,13
10/2/2006,5,0,6,0,11
10/3/2006,5,0,9,8,22
10/4/2006,9,0,2,3,14
10/5/2006,5,0,3,3,11
10/6/2006,6,0,5,2,13
10/7/2006,12,0,10,3,25
10/8/2006,11,0,3,8,22
10/9/2006,8,0,6,0,14
10/10/2006,9,0,8,8,25
10/11/2006,12,0,3,6,21
10/12/2006,11,0,8,0,19
10/13/2006,4,0,4,10,18
10/14/2006,8,0,8,5,21
10/15/2006,4,0,3,11,18
10/16/2006,8,0,8,4,20
10/17/2006,5,0,10,1,16
10/18/2006,5,0,4,11,20
10/19/2006,5,0,3,3,11
10/20/2006,12,0,8,5,25
10/21/2006,7,0,3,11,21
10/22/2006,8,0,2,6,16
10/23/2006,5,0,4,2,11
10/24/2006,6,0,10,1,17
10/25/2006,12,0,6,9,27
10/26/2006,9,0,5,6,20
10/27/2006,4,0,2,3,9
10/28/2006,12,0,7,1,20
10/29/2006,7,0,10,4,21
10/30/2006,10,0,7,0,17
10/31/2006,11,0,10,4,25
11/1/2006,7,0,4,9,20
11/2/2006,6,0,6,11,23
11/3/2006,9,0,6,6,21
11/4/2006,11,0,7,8,26
11/5/2006,6,0,8,2,16
11/6/2006,4,0,2,2,8
11/7/2006,6,0,6,8,20
11/8/2006,7,0,3,8,18
11/9/2006,5,0,2,5,12
11/10/2006,6,0,9,9,24
11/11/2006,8,0,7,2,17
11/12/2006,8,0,8,7,23
11/13/2006,7,0,6,5,18
11/14/2006,12,0,9,2,23
11/15/2006,7,0,6,8,21
11/16/2006,7,0,2,11,20
11/17/2006,4,0,10,8,22
11/18/2006,8,0,5,7,20
11/19/2006,4,0,7,8,19
11/20/2006,4,0,2,1,7
11/21/2006,10,0,9,11,30
11/22/2006,10,0,4,10,24
11/23/2006,8,0,2,4,14
11/24/2006,8,0,6,6,20
11/25/2006,4,0,5,6,15
11/26/2006,4,0,2,10,16
11/27/2006,7,0,4,8,19
11/28/2006,12,0,3,3,18
11/29/2006,12,0,6,1,19
11/30/2006,8,0,7,8,23
12/1/2006,5,0,4,1,10
12/2/2006,8,0,8,9,25
12/3/2006,8,0,7,6,21
12/4/2006,10,0,7,3,20
12/5/2006,4,0,7,7,18
12/6/2006,6,0,9,5,20
12/7/2006,4,0,8,0,12
12/8/2006,11,0,5,10,26
12/9/2006,12,0,3,8,23
12/10/2006,12,0,10,10,32
12/11/2006,9,0,2,7,18
12/12/2006,8,0,4,8,20
12/13/2006,4,0,3,8,15
12/14/2006,9,0,8,11,28
12/15/2006,7,0,5,0,12
12/16/2006,11,0,3,1,15
12/17/2006,9,0,6,6,21
12/18/2006,5,0,2,4,11
12/19/2006,7,0,2,8,17
12/20/2006,7,0,10,3,20
12/21/2006,12,0,5,10,27
12/22/2006,12,0,7,0,19
12/23/2006,12,0,9,9,30
12/24/2006,9,0,2,4,15
12/25/2006,5,0,2,4,11
12/26/2006,9,0,4,3,16
12/27/2006,9,0,8,3,20
12/28/2006,4,0,4,7,15
12/29/2006,11,0,9,8,28
12/30/2006,8,0,2,9,19
12/31/2006,12,0,8,1,21
1/1/2007,12,0,10,0,22
1/2/2007,9,0,10,9,28
1/3/2007,11,0,4,9,24
1/4/2007,8,0,3,9,20
1/5/2007,12,0,9,11,32
1/6/2007,7,0,6,0,13
1/7/2007,10,0,6,2,18
1/8/2007,10,0,5,5,20
1/9/2007,8,0,8,2,18
1/10/2007,4,0,9,4,17
1/11/2007,11,0,9,9,29
1/12/2007,4,0,4,0,8
1/13/2007,11,0,2,9,22
1/14/2007,6,0,2,5,13
1/15/2007,12,0,4,2,18
1/16/2007,5,0,6,4,15
1/17/2007,9,0,10,8,27
1/18/2007,10,0,3,10,23
1/19/2007,12,0,4,6,22
1/20/2007,4,0,7,2,13
1/21/2007,4,0,5,4,13
1/22/2007,11,0,4,7,22
1/23/2007,8,0,9,8,25
1/24/2007,9,0,2,9,20
1/25/2007,11,0,8,11,30
1/26/2007,9,0,10,6,25
1/27/2007,9,0,10,2,21
1/28/2007,4,0,7,5,16
1/29/2007,7,0,5,2,14
1/30/2007,4,0,7,1,12
1/31/2007,7,0,3,9,19
2/1/2007,11,0,7,5,23
2/2/2007,4,0,6,6,16
2/3/2007,11,0,5,3,19
2/4/2007,12,0,2,5,19
2/5/2007,8,0,6,3,17
2/6/2007,7,0,10,11,28
2/7/2007,12,0,4,1,17
2/8/2007,8,0,8,7,23
2/9/2007,5,0,5,11,21
2/10/2007,10,0,3,7,20
2/11/2007,8,0,2,1,11
2/12/2007,10,0,2,6,18
2/13/2007,9,0,2,0,11
2/14/2007,4,0,10,5,19
2/15/2007,7,0,2,2,11
2/16/2007,5,0,4,7,16
2/17/2007,6,0,5,11,22
2/18/2007,6,0,8,0,14
2/19/2007,11,0,10,2,23
2/20/2007,11,0,10,11,32
2/21/2007,7,0,7,6,20
2/22/2007,12,0,6,8,26
2/23/2007,6,0,8,9,23
2/24/2007,5,0,7,9,21
2/25/2007,8,0,7,10,25
2/26/2007,7,0,7,8,22
2/27/2007,9,0,6,5,20
2/28/2007,11,0,10,5,26
3/1/2007,9,0,10,5,24
3/2/2007,7,0,5,9,21
3/3/2007,7,0,7,1,15
3/4/2007,4,0,5,2,11
3/5/2007,12,0,9,7,28
3/6/2007,5,0,5,9,19
3/7/2007,4,0,7,3,14
3/8/2007,7,0,9,4,20
3/9/2007,12,0,3,4,19
3/10/2007,5,0,4,10,19
3/11/2007,8,0,6,4,18
3/12/2007,8,0,2,10,20
3/13/2007,4,0,9,8,21
3/14/2007,11,0,2,1,14
3/15/2007,6,0,8,8,22
3/16/2007,9,0,3,11,23
3/17/2007,12,0,10,5,27
3/18/2007,11,0,9,11,31
3/19/2007,11,0,10,4,25
3/20/2007,4,0,8,0,12
3/21/2007,10,0,5,8,23
3/22/2007,4,0,7,11,22
3/23/2007,9,0,4,5,18
3/24/2007,10,0,5,11,26
3/25/2007,10,0,4,2,16
3/26/2007,11,0,3,11,25
3/27/2007,8,0,10,7,25
3/28/2007,12,0,4,7,23
3/29/2007,9,0,2,3,14
3/30/2007,5,0,3,3,11
3/31/2007,7,0,2,2,11
4/1/2007,6,0,6,6,18
4/2/2007,6,0,8,6,20
4/3/2007,9,0,9,4,22
4/4/2007,7,0,5,10,22
4/5/2007,12,0,7,11,30
4/6/2007,9,0,4,4,17
4/7/2007,12,0,3,4,19
4/8/2007,10,0,2,2,14
4/9/2007,10,0,10,2,22
4/10/2007,5,0,9,2,16
4/11/2007,10,0,5,9,24
4/12/2007,10,0,5,3,18
4/13/2007,6,0,4,0,10
4/14/2007,6,0,6,6,18
4/15/2007,5,0,7,11,23
4/16/2007,5,0,5,10,20
4/17/2007,7,0,10,8,25
4/18/2007,9,0,2,11,22
4/19/2007,5,0,8,5,18
4/20/2007,4,0,2,0,6
4/21/2007,11,0,8,8,27
4/22/2007,5,0,3,7,15
4/23/2007,5,0,6,7,18
4/24/2007,8,0,8,10,26
4/25/2007,11,0,2,9,22
4/26/2007,7,0,6,5,18
4/27/2007,5,0,3,4,12
4/28/2007,9,0,6,7,22
4/29/2007,12,0,9,6,27
4/30/2007,5,0,5,5,15
5/1/2007,5,0,9,10,24
5/2/2007,10,0,8,8,26
5/3/2007,11,0,5,1,17
5/4/2007,12,0,2,6,20
5/5/2007,12,0,6,0,18
5/6/2007,10,0,7,0,17
5/7/2007,9,0,4,5,18
5/8/2007,9,0,10,1,20
5/9/2007,4,0,5,9,18
5/10/2007,7,0,9,9,25
5/11/2007,7,0,10,2,19
5/12/2007,11,0,10,11,32
5/13/2007,8,0,4,7,19
5/14/2007,9,0,9,9,27
5/15/2007,10,0,7,7,24
5/16/2007,11,0,6,8,25
5/17/2007,5,0,7,3,15
5/18/2007,4,0,7,0,11
5/19/2007,11,0,2,3,16
5/20/2007,10,0,2,0,12
5/21/2007,9,0,10,9,28
5/22/2007,6,0,9,0,15
5/23/2007,8,0,10,9,27
5/24/2007,12,0,10,2,24
5/25/2007,7,0,4,0,11
5/26/2007,4,0,4,2,10
5/27/2007,5,0,5,7,17
5/28/2007,4,0,2,5,11
5/29/2007,7,0,9,1,17
5/30/2007,8,0,8,9,25
5/31/2007,6,0,4,4,14
6/1/2007,6,0,5,9,20
6/2/2007,11,0,2,9,22
6/3/2007,4,0,8,6,18
6/4/2007,5,0,7,10,22
6/5/2007,5,0,8,6,19
6/6/2007,8,0,2,5,15
6/7/2007,6,0,8,6,20
6/8/2007,12,0,5,2,19
6/9/2007,10,0,7,5,22
6/10/2007,9,0,7,2,18
6/11/2007,4,0,9,7,20
6/12/2007,11,0,4,6,21
6/13/2007,10,0,6,11,27
6/14/2007,5,0,6,11,22
6/15/2007,11,0,3,4,18
6/16/2007,8,0,3,1,12
6/17/2007,9,0,4,11,24
6/18/2007,8,0,2,10,20
6/19/2007,8,0,4,11,23
6/20/2007,6,0,7,10,23
6/21/2007,11,0,4,0,15
6/22/2007,4,0,7,0,11
6/23/2007,12,0,8,7,27
6/24/2007,5,0,4,11,20
6/25/2007,4,0,8,7,19
6/26/2007,8,0,6,3,17
6/27/2007,7,0,9,11,27
6/28/2007,11,0,2,0,13
6/29/2007,4,0,3,8,15
6/30/2007,6,0,8,6,20
7/1/2007,4,0,4,3,11
7/2/2007,5,0,2,9,16
7/3/2007,11,0,8,2,21
7/4/2007,4,0,9,9,22
7/5/2007,11,0,8,11,30
7/6/2007,5,0,3,7,15
7/7/2007,11,0,4,1,16
7/8/2007,12,0,9,1,22
7/9/2007,6,0,6,7,19
7/10/2007,10,0,6,10,26
7/11/2007,5,0,5,6,16
7/12/2007,11,0,8,2,21
7/13/2007,4,0,10,5,19
7/14/2007,6,0,7,11,24
7/15/2007,6,0,4,4,14
7/16/2007,9,0,2,11,22
7/17/2007,8,0,3,0,11
7/18/2007,6,0,7,2,15
7/19/2007,10,0,5,6,21
7/20/2007,10,0,2,4,16
7/21/2007,10,0,3,7,20
7/22/2007,10,0,10,4,24
7/23/2007,12,0,9,7,28
7/24/2007,9,0,7,2,18
7/25/2007,10,0,3,7,20
7/26/2007,6,0,7,6,19
7/27/2007,9,0,8,2,19
7/28/2007,7,0,8,7,22
7/29/2007,6,0,7,5,18
7/30/2007,7,0,3,7,17
7/31/2007,5,0,7,2,14
8/1/2007,5,0,10,5,20
8/2/2007,10,0,5,5,20
8/3/2007,10,0,7,3,20
8/4/2007,10,0,5,2,17
8/5/2007,11,0,10,3,24
8/6/2007,4,0,8,2,14
8/7/2007,6,0,2,0,8
8/8/2007,7,0,6,10,23
8/9/2007,6,0,3,4,13
8/10/2007,4,0,9,7,20
8/11/2007,8,0,6,10,24
8/12/2007,8,0,9,8,25
8/13/2007,11,0,3,0,14
8/14/2007,10,0,4,7,21
8/15/2007,10,0,2,4,16
8/16/2007,10,0,5,9,24
8/17/2007,9,0,2,2,13
8/18/2007,12,0,6,0,18
8/19/2007,4,0,2,4,10
8/20/2007,4,0,9,0,13
8/21/2007,7,0,6,6,19
8/22/2007,5,0,9,0,14
8/23/2007,10,0,2,6,18
8/24/2007,4,0,6,7,17
8/25/2007,10,0,3,5,18
8/26/2007,9,0,9,1,19
8/27/2007,4,0,6,5,15
8/28/2007,5,0,10,10,25
8/29/2007,5,0,5,0,10
8/30/2007,12,0,7,9,28
8/31/2007,6,0,7,1,14
9/1/2007,8,0,7,10,25
9/2/2007,10,0,3,3,16
9/3/2007,12,0,7,2,21
9/4/2007,12,0,10,8,30
9/5/2007,4,0,4,11,19
9/6/2007,8,0,6,4,18
9/7/2007,9,0,4,5,18
9/8/2007,5,0,10,0,15
9/9/2007,6,0,9,9,24
9/10/2007,12,0,8,9,29
9/11/2007,7,0,7,1,15
9/12/2007,10,0,2,5,17
9/13/2007,8,0,5,4,17
9/14/2007,7,0,8,5,20
9/15/2007,7,0,6,6,19
9/16/2007,8,0,8,4,20
9/17/2007,11,0,7,4,22
9/18/2007,8,0,2,2,12
9/19/2007,11,0,2,3,16
9/20/2007,6,0,9,4,19
9/21/2007,7,0,9,10,26
9/22/2007,9,0,5,3,17
9/23/2007,12,0,6,3,21
9/24/2007,4,0,7,0,11
9/25/2007,11,0,10,8,29
9/26/2007,10,0,9,3,22
9/27/2007,5,0,6,4,15
9/28/2007,9,0,7,0,16
9/29/2007,8,0,2,0,10
9/30/2007,6,0,9,3,18
10/1/2007,4,0,8,5,17
10/2/2007,11,0,8,0,19
10/3/2007,6,0,2,11,19
10/4/2007,11,0,8,2,21
10/5/2007,6,0,9,8,23
10/6/2007,6,0,8,1,15
10/7/2007,7,0,9,6,22
10/8/2007,9,0,3,2,14
10/9/2007,11,0,5,7,23
10/10/2007,4,0,7,11,22
10/11/2007,5,0,5,9,19
10/12/2007,12,0,6,0,18
10/13/2007,11,0,10,10,31
10/14/2007,5,0,7,0,12
10/15/2007,12,0,3,4,19
10/16/2007,4,0,5,1,10
10/17/2007,4,0,2,6,12
10/18/2007,5,0,7,1,13
10/19/2007,4,0,3,6,13
10/20/2007,4,0,6,4,14
10/21/2007,9,0,2,5,16
10/22/2007,10,0,2,8,20
10/23/2007,8,0,3,6,17
10/24/2007,7,0,6,10,23
10/25/2007,9,0,8,5,22
10/26/2007,7,0,9,7,23
10/27/2007,12,0,6,9,27
10/28/2007,4,0,4,6,14
10/29/2007,8,0,4,10,22
10/30/2007,12,0,10,9,31
10/31/2007,6,0,8,1,15
11/1/2007,8,0,9,7,24
11/2/2007,11,0,3,8,22
11/3/2007,10,0,7,8,25
11/4/2007,12,0,4,6,22
11/5/2007,7,0,6,1,14
11/6/2007,11,0,10,1,22
11/7/2007,5,0,2,3,10
11/8/2007,5,0,7,11,23
11/9/2007,9,0,6,6,21
11/10/2007,5,0,10,2,17
11/11/2007,7,0,6,3,16
11/12/2007,9,0,8,10,27
11/13/2007,6,0,4,1,11
11/14/2007,11,0,2,0,13
11/15/2007,4,0,5,8,17
11/16/2007,6,0,10,0,16
11/17/2007,9,0,4,7,20
11/18/2007,7,0,3,0,10
11/19/2007,11,0,4,7,22
11/20/2007,4,0,10,1,15
11/21/2007,10,0,2,10,22
11/22/2007,12,0,2,8,22
11/23/2007,12,0,2,11,25
11/24/2007,6,0,7,6,19
11/25/2007,11,0,4,5,20
11/26/2007,5,0,4,0,9
11/27/2007,5,0,4,5,14
11/28/2007,6,0,4,1,11
11/29/2007,8,0,5,11,24
11/30/2007,12,0,6,4,22
12/1/2007,6,0,6,10,22
12/2/2007,11,0,10,10,31
12/3/2007,12,0,7,7,26
12/4/2007,11,0,7,7,25
12/5/2007,9,0,2,8,19
12/6/2007,7,0,5,11,23
12/7/2007,10,0,8,5,23
12/8/2007,9,0,10,3,22
12/9/2007,4,0,9,9,22
12/10/2007,12,0,4,8,24
12/11/2007,9,0,5,2,16
12/12/2007,10,0,8,11,29
12/13/2007,7,0,10,0,17
12/14/2007,7,0,8,7,22
12/15/2007,6,0,9,5,20
12/16/2007,6,0,9,0,15
12/17/2007,4,0,8,4,16
12/18/2007,10,0,7,0,17
12/19/2007,5,0,8,9,22
12/20/2007,9,0,7,5,21
12/21/2007,11,0,9,5,25
12/22/2007,8,0,2,11,21
12/23/2007,7,0,10,8,25
12/24/2007,9,0,5,2,16
12/25/2007,12,0,10,8,30
12/26/2007,7,0,10,8,25
12/27/2007,6,0,4,6,16
12/28/2007,11,0,7,7,25
12/29/2007,5,0,7,2,14
12/30/2007,7,0,6,10,23
12/31/2007,8,0,6,0,14
1/1/2008,12,0,6,3,21
1/2/2008,5,0,9,1,15
1/3/2008,11,0,8,4,23
1/4/2008,4,0,4,5,13
1/5/2008,4,0,5,2,11
1/6/2008,6,0,10,6,22
1/7/2008,5,0,4,9,18
1/8/2008,4,0,7,3,14
1/9/2008,5,0,9,3,17
1/10/2008,7,0,8,2,17
1/11/2008,9,0,10,2,21
1/12/2008,8,0,4,11,23
1/13/2008,5,0,5,5,15
1/14/2008,6,0,8,0,14
1/15/2008,8,0,8,6,22
1/16/2008,4,0,10,2,16
1/17/2008,8,0,4,0,12
1/18/2008,10,0,10,7,27
1/19/2008,9,0,10,9,28
1/20/2008,4,0,8,1,13
1/21/2008,9,0,7,4,20
1/22/2008,6,0,6,5,17
1/23/2008,8,0,7,2,17
1/24/2008,7,0,10,0,17
1/25/2008,7,0,7,2,16
1/26/2008,9,0,2,4,15
1/27/2008,11,0,9,11,31
1/28/2008,4,0,8,5,17
1/29/2008,11,0,7,5,23
1/30/2008,10,0,10,0,20
1/31/2008,12,0,9,4,25
2/1/2008,8,0,7,2,17
2/2/2008,7,0,5,7,19
2/3/2008,10,0,8,2,20
2/4/2008,5,0,5,8,18
2/5/2008,6,0,9,11,26
2/6/2008,4,0,8,1,13
2/7/2008,12,0,7,5,24
2/8/2008,8,0,9,9,26
2/9/2008,10,0,3,4,17
2/10/2008,7,0,5,2,14
2/11/2008,5,0,7,9,21
2/12/2008,4,0,9,2,15
2/13/2008,4,0,6,10,20
2/14/2008,8,0,4,6,18
2/15/2008,6,0,8,9,23
2/16/2008,12,0,3,7,22
2/17/2008,9,0,6,11,26
2/18/2008,9,0,8,10,27
2/19/2008,10,0,9,3,22
2/20/2008,6,0,10,11,27
2/21/2008,12,0,3,9,24
2/22/2008,11,0,7,5,23
2/23/2008,10,0,3,0,13
2/24/2008,7,0,9,6,22
2/25/2008,5,0,5,3,13
2/26/2008,4,0,3,1,8
2/27/2008,5,0,2,9,16
2/28/2008,4,0,10,2,16
2/29/2008,4,0,2,8,14
3/1/2008,10,0,5,9,24
3/2/2008,12,0,7,2,21
3/3/2008,10,0,3,6,19
3/4/2008,5,0,4,4,13
3/5/2008,12,0,5,1,18
3/6/2008,5,0,7,5,17
3/7/2008,10,0,8,1,19
3/8/2008,11,0,10,8,29
3/9/2008,8,0,9,6,23
3/10/2008,12,0,3,8,23
3/11/2008,10,0,3,6,19
3/12/2008,6,0,6,10,22
3/13/2008,6,0,10,1,17
3/14/2008,7,0,8,2,17
3/15/2008,11,0,3,5,19
3/16/2008,11,0,8,8,27
3/17/2008,12,0,2,11,25
3/18/2008,4,0,7,7,18
3/19/2008,12,0,2,7,21
3/20/2008,12,0,5,6,23
3/21/2008,4,0,10,8,22
3/22/2008,5,0,8,9,22
3/23/2008,12,0,2,4,18
3/24/2008,6,0,5,7,18
3/25/2008,8,0,4,5,17
3/26/2008,8,0,4,2,14
3/27/2008,11,0,2,10,23
3/28/2008,5,0,5,6,16
3/29/2008,7,0,7,9,23
3/30/2008,9,0,4,7,20
3/31/2008,7,0,2,11,20
4/1/2008,6,0,3,7,16
4/2/2008,6,0,3,6,15
4/3/2008,8,0,5,10,23
4/4/2008,10,0,3,4,17
4/5/2008,7,0,9,1,17
4/6/2008,10,0,8,2,20
4/7/2008,8,0,8,4,20
4/8/2008,5,0,2,9,16
4/9/2008,4,0,8,9,21
4/10/2008,4,0,2,10,16
4/11/2008,11,0,8,9,28
4/12/2008,5,0,4,5,14
4/13/2008,12,0,2,0,14
4/14/2008,9,0,2,10,21
4/15/2008,7,0,7,7,21
4/16/2008,5,0,6,6,17
4/17/2008,11,0,6,10,27
4/18/2008,11,0,7,9,27
4/19/2008,8,0,8,0,16
4/20/2008,6,0,4,6,16
4/21/2008,11,0,7,10,28
4/22/2008,6,0,2,11,19
4/23/2008,5,0,3,1,9
4/24/2008,9,0,5,7,21
4/25/2008,10,0,10,5,25
4/26/2008,5,0,3,8,16
4/27/2008,11,0,10,5,26
4/28/2008,8,0,3,4,15
4/29/2008,9,0,2,3,14
4/30/2008,6,0,5,1,12
5/1/2008,7,0,7,9,23
5/2/2008,6,0,4,1,11
5/3/2008,8,0,5,7,20
5/4/2008,11,0,4,10,25
5/5/2008,6,0,4,2,12
5/6/2008,11,0,2,5,18
5/7/2008,8,0,2,2,12
5/8/2008,7,0,9,4,20
5/9/2008,9,0,5,9,23
5/10/2008,12,0,3,10,25
5/11/2008,4,0,9,10,23
5/12/2008,7,0,4,4,15
5/13/2008,9,0,10,11,30
5/14/2008,9,0,2,8,19
5/15/2008,4,0,10,7,21
5/16/2008,10,0,2,10,22
5/17/2008,10,0,4,9,23
5/18/2008,6,0,10,5,21
5/19/2008,7,0,8,4,19
5/20/2008,10,0,8,9,27
5/21/2008,8,0,8,2,18
5/22/2008,11,0,5,1,17
5/23/2008,11,0,7,11,29
5/24/2008,6,0,2,10,18
5/25/2008,6,0,9,11,26
5/26/2008,10,0,4,7,21
5/27/2008,5,0,9,6,20
5/28/2008,6,0,8,2,16
5/29/2008,6,0,4,9,19
5/30/2008,4,0,2,11,17
5/31/2008,6,0,9,4,19
6/1/2008,4,0,6,0,10
6/2/2008,4,0,8,4,16
6/3/2008,6,0,5,6,17
6/4/2008,9,0,9,6,24
6/5/2008,12,0,2,0,14
6/6/2008,4,0,7,0,11
6/7/2008,11,0,7,1,19
6/8/2008,5,0,8,11,24
6/9/2008,9,0,10,4,23
6/10/2008,4,0,10,2,16
6/11/2008,11,0,10,5,26
6/12/2008,11,0,10,4,25
6/13/2008,7,0,9,10,26
6/14/2008,4,0,10,5,19
6/15/2008,8,0,8,5,21
6/16/2008,9,0,2,8,19
6/17/2008,5,0,4,1,10
6/18/2008,11,0,3,11,25
6/19/2008,6,0,6,10,22
6/20/2008,12,0,8,1,21
6/21/2008,9,0,9,4,22
6/22/2008,12,0,6,8,26
6/23/2008,12,0,3,3,18
6/24/2008,10,0,4,5,19
6/25/2008,6,0,8,3,17
6/26/2008,4,0,6,2,12
6/27/2008,10,0,6,11,27
6/28/2008,8,0,10,2,20
6/29/2008,9,0,3,10,22
6/30/2008,10,0,3,2,15
7/1/2008,7,0,9,11,27
7/2/2008,12,0,10,3,25
7/3/2008,12,0,2,5,19
7/4/2008,10,0,7,7,24
7/5/2008,6,0,9,1,16
7/6/2008,11,0,3,11,25
7/7/2008,5,0,9,2,16
7/8/2008,12,0,6,6,24
7/9/2008,9,0,5,11,25
7/10/2008,12,0,3,2,17
7/11/2008,10,0,5,4,19
7/12/2008,5,0,3,5,13
7/13/2008,9,0,5,11,25
7/14/2008,5,0,9,8,22
7/15/2008,6,0,5,4,15
7/16/2008,12,0,4,5,21
7/17/2008,9,0,2,8,19
7/18/2008,8,0,8,3,19
7/19/2008,6,0,10,1,17
7/20/2008,6,0,10,4,20
7/21/2008,11,0,5,5,21
7/22/2008,6,0,5,8,19
7/23/2008,11,0,9,0,20
7/24/2008,10,0,6,3,19
7/25/2008,10,0,6,3,19
7/26/2008,8,0,2,11,21
7/27/2008,6,0,4,8,18
7/28/2008,12,0,9,5,26
7/29/2008,11,0,5,4,20
7/30/2008,5,0,4,4,13
7/31/2008,12,0,8,3,23
8/1/2008,8,0,4,9,21
8/2/2008,12,0,8,2,22
8/3/2008,9,0,4,8,21
8/4/2008,7,0,6,2,15
8/5/2008,5,0,4,0,9
8/6/2008,6,0,6,6,18
8/7/2008,5,0,10,4,19
8/8/2008,10,0,2,7,19
8/9/2008,5,0,2,7,14
8/10/2008,10,0,5,0,15
8/11/2008,5,0,3,1,9
8/12/2008,4,0,9,5,18
8/13/2008,6,0,6,4,16
8/14/2008,4,0,8,7,19
8/15/2008,11,0,10,1,22
8/16/2008,6,0,3,8,17
8/17/2008,12,0,4,5,21
8/18/2008,7,0,8,3,18
8/19/2008,8,0,2,0,10
8/20/2008,10,0,2,4,16
8/21/2008,5,0,8,7,20
8/22/2008,12,0,6,10,28
8/23/2008,6,0,2,4,12
8/24/2008,6,0,8,9,23
8/25/2008,6,0,3,10,19
8/26/2008,6,0,6,3,15
8/27/2008,4,0,9,0,13
8/28/2008,7,0,10,11,28
8/29/2008,4,0,2,6,12
8/30/2008,8,0,6,0,14
8/31/2008,9,0,10,11,30
9/1/2008,6,0,8,6,20
9/2/2008,4,0,2,6,12
9/3/2008,8,0,7,1,16
9/4/2008,5,0,6,5,16
9/5/2008,12,0,9,5,26
9/6/2008,12,0,7,6,25
9/7/2008,6,0,9,3,18
9/8/2008,4,0,8,3,15
9/9/2008,9,0,4,4,17
9/10/2008,7,0,9,10,26
9/11/2008,11,0,9,5,25
9/12/2008,8,0,8,8,24
9/13/2008,9,0,5,7,21
9/14/2008,10,0,5,10,25
9/15/2008,10,0,5,2,17
9/16/2008,4,0,9,7,20
9/17/2008,9,0,10,3,22
9/18/2008,11,0,8,1,20
9/19/2008,7,0,8,5,20
9/20/2008,12,0,8,9,29
9/21/2008,7,0,6,2,15
9/22/2008,7,0,3,2,12
9/23/2008,6,0,8,4,18
9/24/2008,8,0,10,5,23
9/25/2008,5,0,5,0,10
9/26/2008,4,0,4,11,19
9/27/2008,12,0,7,5,24
9/28/2008,4,0,4,3,11
9/29/2008,6,0,8,5,19
9/30/2008,8,0,3,11,22
10/1/2008,4,0,10,8,22
10/2/2008,9,0,10,6,25
10/3/2008,5,0,2,8,15
10/4/2008,4,0,10,4,18
10/5/2008,7,0,3,4,14
10/6/2008,7,0,4,8,19
10/7/2008,8,0,2,2,12
10/8/2008,10,0,5,10,25
10/9/2008,12,0,9,9,30
10/10/2008,10,0,4,9,23
10/11/2008,4,0,6,3,13
10/12/2008,9,0,5,4,18
10/13/2008,9,0,2,3,14
10/14/2008,8,0,8,0,16
10/15/2008,7,0,6,9,22
10/16/2008,5,0,3,0,8
10/17/2008,6,0,3,4,13
10/18/2008,4,0,7,3,14
10/19/2008,4,0,9,6,19
10/20/2008,7,0,5,2,14
10/21/2008,11,0,7,8,26
10/22/2008,8,0,4,4,16
10/23/2008,6,0,10,8,24
10/24/2008,4,0,10,2,16
10/25/2008,6,0,4,10,20
10/26/2008,8,0,4,9,21
10/27/2008,9,0,3,10,22
10/28/2008,4,0,4,4,12
10/29/2008,8,0,3,10,21
10/30/2008,4,0,6,2,12
10/31/2008,11,0,4,5,20
11/1/2008,10,0,4,3,17
11/2/2008,11,0,8,3,22
11/3/2008,4,0,4,5,13
11/4/2008,8,0,9,0,17
11/5/2008,4,0,2,10,16
11/6/2008,5,0,6,7,18
11/7/2008,5,0,10,9,24
11/8/2008,10,0,5,0,15
11/9/2008,8,0,3,8,19
11/10/2008,12,0,9,3,24
11/11/2008,9,0,9,10,28
11/12/2008,4,0,4,4,12
11/13/2008,9,0,8,3,20
11/14/2008,5,0,2,2,9
11/15/2008,5,0,10,9,24
11/16/2008,5,0,6,9,20
11/17/2008,7,0,5,7,19
11/18/2008,5,0,6,6,17
11/19/2008,4,0,3,1,8
11/20/2008,5,0,5,9,19
11/21/2008,11,0,8,4,23
11/22/2008,5,0,6,7,18
11/23/2008,8,0,9,10,27
11/24/2008,8,0,4,4,16
11/25/2008,10,0,3,4,17
11/26/2008,10,0,4,11,25
11/27/2008,9,0,5,5,19
11/28/2008,11,0,5,9,25
11/29/2008,8,0,10,0,18
11/30/2008,10,0,3,3,16
12/1/2008,6,0,9,10,25
12/2/2008,12,0,6,9,27
12/3/2008,4,0,3,0,7
12/4/2008,8,0,4,3,15
12/5/2008,5,0,8,11,24
12/6/2008,4,0,7,3,14
12/7/2008,5,0,4,5,14
12/8/2008,4,0,5,3,12
12/9/2008,4,0,3,1,8
12/10/2008,11,0,6,3,20
12/11/2008,8,0,2,0,10
12/12/2008,5,0,7,8,20
12/13/2008,11,0,3,8,22
12/14/2008,9,0,4,6,19
12/15/2008,4,0,7,8,19
12/16/2008,8,0,9,0,17
12/17/2008,12,0,9,4,25
12/18/2008,11,0,8,3,22
12/19/2008,11,0,2,0,13
12/20/2008,4,0,4,1,9
12/21/2008,10,0,10,3,23
12/22/2008,7,0,2,10,19
12/23/2008,4,0,9,4,17
12/24/2008,5,0,10,11,26
12/25/2008,4,0,8,0,12
12/26/2008,8,0,4,8,20
12/27/2008,6,0,6,8,20
12/28/2008,6,0,2,11,19
12/29/2008,9,0,7,6,22
12/30/2008,5,0,8,10,23
12/31/2008,8,0,5,6,19
1/1/2009,7,0,8,10,25
1/2/2009,4,0,2,8,14
1/3/2009,11,0,3,10,24
1/4/2009,4,0,5,2,11
1/5/2009,7,0,5,11,23
1/6/2009,9,0,6,1,16
1/7/2009,6,0,2,3,11
1/8/2009,4,0,5,10,19
1/9/2009,7,0,10,7,24
1/10/2009,11,0,6,7,24
1/11/2009,4,0,4,0,8
1/12/2009,8,0,6,10,24
1/13/2009,11,0,4,5,20
1/14/2009,9,0,10,1,20
1/15/2009,6,0,5,3,14
1/16/2009,4,0,6,8,18
1/17/2009,9,0,2,2,13
1/18/2009,8,0,8,11,27
1/19/2009,5,0,6,11,22
1/20/2009,12,0,9,1,22
1/21/2009,11,0,8,8,27
1/22/2009,7,0,9,2,18
1/23/2009,6,0,9,4,19
1/24/2009,7,0,7,5,19
1/25/2009,7,0,10,3,20
1/26/2009,8,0,3,6,17
1/27/2009,9,0,5,6,20
1/28/2009,4,0,3,1,8
1/29/2009,4,0,5,3,12
1/30/2009,5,0,2,10,17
1/31/2009,9,0,6,5,20
2/1/2009,8,0,7,11,26
2/2/2009,10,0,9,0,19
2/3/2009,10,0,10,6,26
2/4/2009,4,0,9,5,18
2/5/2009,6,0,2,9,17
2/6/2009,5,0,9,11,25
2/7/2009,8,0,2,8,18
2/8/2009,7,0,3,7,17
2/9/2009,12,0,5,1,18
2/10/2009,12,0,6,0,18
2/11/2009,12,0,2,4,18
2/12/2009,10,0,9,8,27
2/13/2009,6,0,9,0,15
2/14/2009,8,0,5,4,17
2/15/2009,8,0,7,10,25
2/16/2009,4,0,6,3,13
2/17/2009,5,0,8,8,21
2/18/2009,10,0,7,10,27
2/19/2009,12,0,5,6,23
2/20/2009,6,0,2,10,18
2/21/2009,11,0,9,4,24
2/22/2009,8,0,8,5,21
2/23/2009,11,0,7,1,19
2/24/2009,5,0,7,2,14
2/25/2009,11,0,9,9,29
2/26/2009,7,0,6,2,15
2/27/2009,5,0,6,10,21
2/28/2009,9,0,7,8,24
3/1/2009,12,0,4,5,21
3/2/2009,10,0,6,0,16
3/3/2009,6,0,7,2,15
3/4/2009,7,0,8,7,22
3/5/2009,5,0,2,2,9
3/6/2009,6,0,3,8,17
3/7/2009,7,0,5,3,15
3/8/2009,9,0,7,6,22
3/9/2009,11,0,9,4,24
3/10/2009,11,0,9,8,28
3/11/2009,6,0,7,6,19
3/12/2009,9,0,9,1,19
3/13/2009,12,0,4,0,16
3/14/2009,9,0,2,9,20
3/15/2009,8,0,6,9,23
3/16/2009,9,0,2,7,18
3/17/2009,5,0,8,10,23
3/18/2009,4,0,4,0,8
3/19/2009,10,0,9,5,24
3/20/2009,7,0,10,3,20
3/21/2009,10,0,7,1,18
3/22/2009,11,0,4,2,17
3/23/2009,9,0,2,2,13
3/24/2009,8,0,2,4,14
3/25/2009,12,0,4,1,17
3/26/2009,9,0,5,2,16
3/27/2009,7,0,7,2,16
3/28/2009,6,0,5,6,17
3/29/2009,11,0,3,9,23
3/30/2009,7,0,6,0,13
3/31/2009,6,0,10,10,26
4/1/2009,10,0,6,4,20
4/2/2009,10,0,2,0,12
4/3/2009,11,0,8,9,28
4/4/2009,10,0,2,6,18
4/5/2009,5,0,10,1,16
4/6/2009,5,0,6,11,22
4/7/2009,12,0,8,4,24
4/8/2009,9,0,6,6,21
4/9/2009,10,0,5,7,22
4/10/2009,10,0,10,1,21
4/11/2009,12,0,6,11,29
4/12/2009,12,0,9,6,27
4/13/2009,7,0,10,6,23
4/14/2009,4,0,9,6,19
4/15/2009,12,0,3,6,21
4/16/2009,4,0,8,11,23
4/17/2009,6,0,10,2,18
4/18/2009,10,0,5,4,19
4/19/2009,5,0,6,2,13
4/20/2009,8,0,8,3,19
4/21/2009,8,0,4,4,16
4/22/2009,5,0,8,5,18
4/23/2009,11,0,10,3,24
4/24/2009,11,0,6,4,21
4/25/2009,6,0,9,1,16
4/26/2009,12,0,5,10,27
4/27/2009,8,0,6,7,21
4/28/2009,8,0,7,3,18
4/29/2009,4,0,10,6,20
4/30/2009,12,0,9,7,28
5/1/2009,7,0,10,8,25
5/2/2009,7,0,2,3,12
5/3/2009,6,0,4,4,14
5/4/2009,7,0,4,11,22
5/5/2009,5,0,2,8,15
5/6/2009,4,0,4,4,12
5/7/2009,4,0,9,4,17
5/8/2009,5,0,3,7,15
5/9/2009,12,0,2,3,17
5/10/2009,4,0,8,10,22
5/11/2009,5,0,9,5,19
5/12/2009,8,0,2,7,17
5/13/2009,5,0,4,11,20
5/14/2009,8,0,9,11,28
5/15/2009,9,0,5,7,21
5/16/2009,7,0,2,4,13
5/17/2009,8,0,5,6,19
5/18/2009,10,0,10,10,30
5/19/2009,6,0,6,2,14
5/20/2009,12,0,2,3,17
5/21/2009,5,0,4,7,16
5/22/2009,4,0,10,6,20
5/23/2009,5,0,4,6,15
5/24/2009,12,0,6,3,21
5/25/2009,10,0,7,5,22
5/26/2009,11,0,8,7,26
5/27/2009,10,0,2,3,15
5/28/2009,10,0,9,2,21
5/29/2009,6,0,9,10,25
5/30/2009,5,0,9,5,19
5/31/2009,4,0,3,4,11
6/1/2009,11,0,6,11,28
6/2/2009,12,0,4,0,16
6/3/2009,11,0,4,0,15
6/4/2009,8,0,10,4,22
6/5/2009,8,0,10,5,23
6/6/2009,9,0,2,10,21
6/7/2009,10,0,2,2,14
6/8/2009,12,0,7,3,22
6/9/2009,11,0,6,8,25
6/10/2009,12,0,4,9,25
6/11/2009,11,0,3,6,20
6/12/2009,7,0,7,8,22
6/13/2009,12,0,10,2,24
6/14/2009,7,0,4,2,13
6/15/2009,4,0,10,9,23
6/16/2009,7,0,6,9,22
6/17/2009,12,0,8,6,26
6/18/2009,11,0,10,3,24
6/19/2009,10,0,7,10,27
6/20/2009,9,0,7,7,23
6/21/2009,4,0,5,5,14
6/22/2009,4,0,5,6,15
6/23/2009,6,0,10,5,21
6/24/2009,5,0,10,3,18
6/25/2009,11,0,5,7,23
6/26/2009,5,0,7,0,12
6/27/2009,6,0,5,4,15
6/28/2009,6,0,7,3,16
6/29/2009,6,0,6,8,20
6/30/2009,5,0,5,8,18
7/1/2009,8,0,7,5,20
7/2/2009,10,0,3,1,14
7/3/2009,11,0,5,7,23
7/4/2009,5,0,7,10,22
7/5/2009,10,0,8,11,29
7/6/2009,9,0,6,7,22
7/7/2009,5,0,7,7,19
7/8/2009,7,0,9,9,25
7/9/2009,8,0,5,11,24
7/10/2009,10,0,6,0,16
7/11/2009,12,0,2,10,24
7/12/2009,4,0,2,6,12
7/13/2009,9,0,6,4,19
7/14/2009,7,0,8,8,23
7/15/2009,5,0,3,10,18
7/16/2009,4,0,10,1,15
7/17/2009,7,0,10,9,26
7/18/2009,6,0,9,10,25
7/19/2009,6,0,4,8,18
7/20/2009,11,0,9,11,31
7/21/2009,4,0,3,1,8
7/22/2009,11,0,3,5,19
7/23/2009,6,0,6,7,19
7/24/2009,10,0,5,4,19
7/25/2009,8,0,9,10,27
7/26/2009,4,0,3,10,17
7/27/2009,10,0,10,10,30
7/28/2009,7,0,9,1,17
7/29/2009,9,0,10,5,24
7/30/2009,7,0,9,11,27
7/31/2009,11,0,6,8,25
8/1/2009,9,0,8,8,25
8/2/2009,7,0,8,3,18
8/3/2009,9,0,2,9,20
8/4/2009,9,0,10,4,23
8/5/2009,12,0,7,9,28
8/6/2009,9,0,6,4,19
8/7/2009,12,0,10,7,29
8/8/2009,10,0,8,4,22
8/9/2009,8,0,4,8,20
8/10/2009,7,0,5,4,16
8/11/2009,12,0,3,5,20
8/12/2009,8,0,6,1,15
8/13/2009,9,0,4,7,20
8/14/2009,9,0,10,9,28
8/15/2009,7,0,7,2,16
8/16/2009,10,0,8,6,24
8/17/2009,8,0,2,11,21
8/18/2009,9,0,3,10,22
8/19/2009,12,0,5,1,18
8/20/2009,5,0,3,10,18
8/21/2009,9,0,10,1,20
8/22/2009,7,0,3,6,16
8/23/2009,10,0,5,9,24
8/24/2009,12,0,10,3,25
8/25/2009,6,0,9,11,26
8/26/2009,10,0,8,0,18
8/27/2009,6,0,5,8,19
8/28/2009,10,0,2,6,18
8/29/2009,11,0,2,7,20
8/30/2009,6,0,8,9,23
8/31/2009,6,0,9,6,21
9/1/2009,9,0,4,5,18
9/2/2009,11,0,4,1,16
9/3/2009,10,0,2,7,19
9/4/2009,8,0,3,9,20
9/5/2009,10,0,4,4,18
9/6/2009,4,0,5,9,18
9/7/2009,4,0,8,5,17
9/8/2009,11,0,10,9,30
9/9/2009,5,0,10,0,15
9/10/2009,6,0,9,3,18
9/11/2009,8,0,8,4,20
9/12/2009,11,0,7,6,24
9/13/2009,9,0,3,2,14
9/14/2009,12,0,8,3,23
9/15/2009,11,0,2,0,13
9/16/2009,8,0,3,8,19
9/17/2009,9,0,7,1,17
9/18/2009,9,0,8,0,17
9/19/2009,4,0,7,5,16
9/20/2009,12,0,4,6,22
9/21/2009,12,0,3,10,25
9/22/2009,11,0,7,1,19
9/23/2009,7,0,9,6,22
9/24/2009,10,0,7,7,24
9/25/2009,8,0,8,0,16
9/26/2009,8,0,7,0,15
9/27/2009,4,0,2,11,17
9/28/2009,10,0,4,5,19
9/29/2009,7,0,9,9,25
9/30/2009,12,0,8,1,21
10/1/2009,11,0,2,4,17
10/2/2009,10,0,7,4,21
10/3/2009,12,0,9,9,30
10/4/2009,11,0,3,0,14
10/5/2009,7,0,8,8,23
10/6/2009,11,0,2,8,21
10/7/2009,4,0,10,6,20
10/8/2009,12,0,7,3,22
10/9/2009,7,0,5,7,19
10/10/2009,10,0,8,7,25
10/11/2009,12,0,6,0,18
10/12/2009,7,0,7,2,16
10/13/2009,8,0,7,8,23
10/14/2009,7,0,2,6,15
10/15/2009,5,0,9,3,17
10/16/2009,12,0,4,2,18
10/17/2009,11,0,6,11,28
10/18/2009,4,0,4,6,14
10/19/2009,9,0,9,4,22
10/20/2009,5,0,10,4,19
10/21/2009,12,0,6,6,24
10/22/2009,9,0,10,1,20
10/23/2009,7,0,7,0,14
10/24/2009,10,0,6,11,27
10/25/2009,4,0,10,5,19
10/26/2009,7,0,4,4,15
10/27/2009,9,0,8,2,19
10/28/2009,8,0,7,1,16
10/29/2009,6,0,7,4,17
10/30/2009,5,0,8,11,24
10/31/2009,7,0,2,9,18
11/1/2009,10,0,10,7,27
11/2/2009,9,0,10,0,19
11/3/2009,7,0,9,6,22
11/4/2009,6,0,10,10,26
11/5/2009,4,0,8,0,12
11/6/2009,8,0,2,1,11
11/7/2009,11,0,10,0,21
11/8/2009,12,0,2,6,20
11/9/2009,8,0,8,6,22
11/10/2009,4,0,6,2,12
11/11/2009,9,0,3,6,18
11/12/2009,12,0,5,11,28
11/13/2009,7,0,8,5,20
11/14/2009,4,0,9,4,17
11/15/2009,10,0,6,9,25
11/16/2009,12,0,4,1,17
11/17/2009,12,0,7,11,30
11/18/2009,11,0,4,10,25
11/19/2009,4,0,2,0,6
11/20/2009,9,0,9,7,25
11/21/2009,6,0,6,11,23
11/22/2009,10,0,5,11,26
11/23/2009,11,0,3,0,14
11/24/2009,7,0,7,2,16
11/25/2009,10,0,7,1,18
11/26/2009,6,0,10,6,22
11/27/2009,4,0,9,1,14
11/28/2009,6,0,8,11,25
11/29/2009,6,0,3,11,20
11/30/2009,7,0,10,11,28
12/1/2009,12,0,3,6,21
12/2/2009,4,0,7,4,15
12/3/2009,12,0,10,11,33
12/4/2009,10,0,9,11,30
12/5/2009,6,0,9,3,18
12/6/2009,10,0,2,2,14
12/7/2009,12,0,5,8,25
12/8/2009,10,0,6,6,22
12/9/2009,5,0,2,7,14
12/10/2009,8,0,5,6,19
12/11/2009,8,0,5,11,24
12/12/2009,9,0,5,6,20
12/13/2009,5,0,3,10,18
12/14/2009,12,0,10,3,25
12/15/2009,6,0,9,1,16
12/16/2009,7,0,2,8,17
12/17/2009,4,0,2,3,9
12/18/2009,6,0,8,1,15
12/19/2009,10,0,4,10,24
12/20/2009,5,0,9,8,22
12/21/2009,6,0,8,5,19
12/22/2009,7,0,10,10,27
12/23/2009,12,0,6,2,20
12/24/2009,6,0,5,2,13
12/25/2009,12,0,5,7,24
12/26/2009,5,0,4,5,14
12/27/2009,9,0,6,6,21
12/28/2009,9,0,6,8,23
12/29/2009,8,0,3,10,21
12/30/2009,5,0,2,9,16
12/31/2009,7,0,9,0,16
1/1/2010,8,0,9,6,23
1/2/2010,8,0,3,4,15
1/3/2010,7,0,4,8,19
1/4/2010,11,0,10,1,22
1/5/2010,8,0,9,7,24
1/6/2010,6,0,7,11,24
1/7/2010,10,0,8,2,20
1/8/2010,9,0,7,6,22
1/9/2010,10,0,9,11,30
1/10/2010,10,0,10,9,29
1/11/2010,4,0,8,5,17
1/12/2010,11,0,6,1,18
1/13/2010,10,0,8,11,29
1/14/2010,10,0,6,0,16
1/15/2010,10,0,8,10,28
1/16/2010,9,0,10,7,26
1/17/2010,6,0,6,9,21
1/18/2010,12,0,3,2,17
1/19/2010,11,0,8,5,24
1/20/2010,9,0,2,8,19
1/21/2010,7,0,4,4,15
1/22/2010,5,0,4,7,16
1/23/2010,6,0,7,11,24
1/24/2010,11,0,7,9,27
1/25/2010,9,0,3,6,18
1/26/2010,6,0,3,7,16
1/27/2010,9,0,8,2,19
1/28/2010,12,0,3,1,16
1/29/2010,7,0,5,5,17
1/30/2010,8,0,5,2,15
1/31/2010,4,0,2,10,16
2/1/2010,6,0,8,3,17
2/2/2010,8,0,2,2,12
2/3/2010,4,0,5,3,12
2/4/2010,8,0,10,5,23
2/5/2010,12,0,8,5,25
2/6/2010,5,0,4,0,9
2/7/2010,4,0,5,8,17
2/8/2010,11,0,10,6,27
2/9/2010,10,0,8,4,22
2/10/2010,7,0,7,5,19
2/11/2010,11,0,7,11,29
2/12/2010,8,0,8,3,19
2/13/2010,7,0,3,6,16
2/14/2010,8,0,10,8,26
2/15/2010,12,0,10,2,24
2/16/2010,9,0,2,0,11
2/17/2010,7,0,9,2,18
2/18/2010,6,0,7,0,13
2/19/2010,11,0,4,1,16
2/20/2010,8,0,9,7,24
2/21/2010,6,0,3,1,10
2/22/2010,8,0,4,2,14
2/23/2010,11,0,3,5,19
2/24/2010,4,0,2,7,13
2/25/2010,10,0,4,6,20
2/26/2010,9,0,10,0,19
2/27/2010,6,0,5,7,18
2/28/2010,5,0,10,0,15
3/1/2010,11,0,10,10,31
3/2/2010,12,0,9,11,32
3/3/2010,7,0,6,0,13
3/4/2010,5,0,3,3,11
3/5/2010,11,0,10,0,21
3/6/2010,7,0,8,4,19
3/7/2010,4,0,10,8,22
3/8/2010,7,0,9,1,17
3/9/2010,4,0,2,7,13
3/10/2010,10,0,3,3,16
3/11/2010,9,0,3,0,12
3/12/2010,7,0,10,3,20
3/13/2010,8,0,7,4,19
3/14/2010,12,0,6,11,29
3/15/2010,10,0,6,11,27
3/16/2010,10,0,3,1,14
3/17/2010,4,0,6,9,19
3/18/2010,9,0,6,11,26
3/19/2010,8,0,10,7,25
3/20/2010,6,0,6,10,22
3/21/2010,12,0,7,7,26
3/22/2010,12,0,6,11,29
3/23/2010,5,0,10,9,24
3/24/2010,7,0,4,9,20
3/25/2010,9,0,9,5,23
3/26/2010,7,0,6,8,21
3/27/2010,12,0,3,7,22
3/28/2010,7,0,3,10,20
3/29/2010,12,0,8,10,30
3/30/2010,9,0,4,11,24
3/31/2010,6,0,7,6,19
4/1/2010,8,0,2,10,20
4/2/2010,8,0,3,2,13
4/3/2010,9,0,2,8,19
4/4/2010,4,0,5,7,16
4/5/2010,7,0,10,3,20
4/6/2010,6,0,7,8,21
4/7/2010,5,0,10,5,20
4/8/2010,9,0,8,6,23
4/9/2010,10,0,4,0,14
4/10/2010,6,0,3,0,9
4/11/2010,4,0,4,0,8
4/12/2010,8,0,10,0,18
4/13/2010,12,0,3,10,25
4/14/2010,12,0,3,0,15
4/15/2010,10,0,2,3,15
4/16/2010,11,0,8,3,22
4/17/2010,5,0,10,9,24
4/18/2010,4,0,4,9,17
4/19/2010,8,0,4,10,22
4/20/2010,5,0,2,2,9
4/21/2010,9,0,6,4,19
4/22/2010,11,0,3,4,18
4/23/2010,5,0,7,7,19
4/24/2010,11,0,5,10,26
4/25/2010,12,0,6,2,20
4/26/2010,11,0,3,0,14
4/27/2010,5,0,6,3,14
4/28/2010,5,0,3,1,9
4/29/2010,10,0,3,6,19
4/30/2010,4,0,2,10,16
5/1/2010,12,0,6,10,28
5/2/2010,11,0,4,2,17
5/3/2010,12,0,6,8,26
5/4/2010,7,0,10,10,27
5/5/2010,8,0,2,11,21
5/6/2010,4,0,6,6,16
5/7/2010,8,0,5,2,15
5/8/2010,12,0,5,6,23
5/9/2010,7,0,9,9,25
5/10/2010,7,0,2,8,17
5/11/2010,10,0,7,8,25
5/12/2010,7,0,9,2,18
5/13/2010,4,0,8,4,16
5/14/2010,4,0,7,2,13
5/15/2010,12,0,3,4,19
5/16/2010,10,0,3,7,20
5/17/2010,9,0,6,2,17
5/18/2010,12,0,9,6,27
5/19/2010,10,0,5,1,16
5/20/2010,10,0,7,6,23
5/21/2010,6,0,10,1,17
5/22/2010,4,0,8,10,22
5/23/2010,4,0,9,6,19
5/24/2010,6,0,3,5,14
5/25/2010,7,0,3,0,10
5/26/2010,4,0,2,11,17
5/27/2010,12,0,6,11,29
5/28/2010,7,0,8,0,15
5/29/2010,6,0,8,11,25
5/30/2010,6,0,8,2,16
5/31/2010,12,0,6,9,27
6/1/2010,5,0,7,6,18
6/2/2010,4,0,5,6,15
6/3/2010,11,0,9,9,29
6/4/2010,7,0,10,3,20
6/5/2010,5,0,8,10,23
6/6/2010,6,0,5,3,14
6/7/2010,6,0,5,11,22
6/8/2010,11,0,10,11,32
6/9/2010,6,0,7,3,16
6/10/2010,11,0,10,8,29
6/11/2010,12,0,10,8,30
6/12/2010,10,0,8,6,24
6/13/2010,8,0,2,5,15
6/14/2010,11,0,3,3,17
6/15/2010,10,0,3,11,24
6/16/2010,9,0,7,11,27
6/17/2010,11,0,10,3,24
6/18/2010,4,0,3,7,14
6/19/2010,10,0,3,5,18
6/20/2010,8,0,9,6,23
6/21/2010,9,0,4,8,21
6/22/2010,8,0,9,8,25
6/23/2010,5,0,4,5,14
6/24/2010,9,0,7,11,27
6/25/2010,6,0,3,9,18
6/26/2010,8,0,10,2,20
6/27/2010,12,0,10,11,33
6/28/2010,8,0,4,10,22
6/29/2010,4,0,5,0,9
6/30/2010,4,0,6,0,10
7/1/2010,5,0,2,2,9
7/2/2010,12,0,9,11,32
7/3/2010,7,0,2,11,20
7/4/2010,12,0,10,5,27
7/5/2010,7,0,8,7,22
7/6/2010,10,0,9,4,23
7/7/2010,10,0,4,7,21
7/8/2010,6,0,4,3,13
7/9/2010,5,0,3,11,19
7/10/2010,4,0,3,8,15
7/11/2010,12,0,9,3,24
7/12/2010,8,0,7,11,26
7/13/2010,11,0,4,2,17
7/14/2010,12,0,10,3,25
7/15/2010,4,0,5,0,9
7/16/2010,10,0,5,1,16
7/17/2010,10,0,8,9,27
7/18/2010,5,0,9,9,23
7/19/2010,4,0,2,5,11
7/20/2010,6,0,4,3,13
7/21/2010,9,0,8,5,22
7/22/2010,6,0,10,2,18
7/23/2010,8,0,6,5,19
7/24/2010,7,0,10,4,21
7/25/2010,12,0,7,3,22
7/26/2010,11,0,7,0,18
7/27/2010,4,0,10,5,19
7/28/2010,9,0,7,0,16
7/29/2010,7,0,5,8,20
7/30/2010,10,0,8,7,25
7/31/2010,12,0,4,1,17
8/1/2010,4,0,7,10,21
8/2/2010,6,0,3,10,19
8/3/2010,12,0,10,3,25
8/4/2010,4,0,2,4,10
8/5/2010,9,0,4,3,16
8/6/2010,7,0,4,0,11
8/7/2010,10,0,3,10,23
8/8/2010,11,0,2,0,13
8/9/2010,5,0,5,7,17
8/10/2010,10,0,2,10,22
8/11/2010,8,0,6,10,24
8/12/2010,8,0,5,6,19
8/13/2010,6,0,4,9,19
8/14/2010,12,0,7,10,29
8/15/2010,7,0,2,9,18
8/16/2010,9,0,3,2,14
8/17/2010,8,0,6,2,16
8/18/2010,12,0,10,11,33
8/19/2010,12,0,8,10,30
8/20/2010,9,0,5,6,20
8/21/2010,10,0,3,4,17
8/22/2010,7,0,5,2,14
8/23/2010,4,0,10,1,15
8/24/2010,10,0,3,4,17
8/25/2010,11,0,10,1,22
8/26/2010,4,0,3,3,10
8/27/2010,4,0,5,11,20
8/28/2010,4,0,2,7,13
8/29/2010,12,0,10,4,26
8/30/2010,10,0,6,3,19
8/31/2010,11,0,10,0,21
9/1/2010,9,0,3,1,13
9/2/2010,10,0,9,2,21
9/3/2010,10,0,9,5,24
9/4/2010,10,0,2,5,17
9/5/2010,4,0,6,7,17
9/6/2010,5,0,8,3,16
9/7/2010,12,0,2,6,20
9/8/2010,7,0,5,9,21
9/9/2010,11,0,8,2,21
9/10/2010,6,0,9,11,26
9/11/2010,4,0,10,8,22
9/12/2010,12,0,4,9,25
9/13/2010,4,0,9,4,17
9/14/2010,12,0,5,9,26
9/15/2010,9,0,4,5,18
9/16/2010,7,0,4,1,12
9/17/2010,5,0,9,2,16
9/18/2010,11,0,7,5,23
9/19/2010,8,0,8,8,24
9/20/2010,7,0,5,11,23
9/21/2010,10,0,3,4,17
9/22/2010,11,0,10,4,25
9/23/2010,7,0,9,7,23
9/24/2010,8,0,4,9,21
9/25/2010,10,0,5,10,25
9/26/2010,7,0,9,1,17
9/27/2010,12,0,8,11,31
9/28/2010,7,0,3,10,20
9/29/2010,10,0,10,2,22
9/30/2010,9,0,6,2,17
10/1/2010,12,0,2,8,22
10/2/2010,12,0,4,1,17
10/3/2010,8,0,5,6,19
10/4/2010,6,0,2,5,13
10/5/2010,9,0,6,8,23
10/6/2010,6,0,7,9,22
10/7/2010,12,0,9,5,26
10/8/2010,11,0,2,3,16
10/9/2010,5,0,3,7,15
10/10/2010,11,0,7,9,27
10/11/2010,10,0,8,5,23
10/12/2010,11,0,8,7,26
10/13/2010,6,0,9,7,22
10/14/2010,6,0,3,9,18
10/15/2010,12,0,4,7,23
10/16/2010,7,0,9,5,21
10/17/2010,12,0,6,5,23
10/18/2010,7,0,9,1,17
10/19/2010,9,0,3,5,17
10/20/2010,12,0,7,9,28
10/21/2010,10,0,8,0,18
10/22/2010,9,0,3,2,14
10/23/2010,10,0,5,3,18
10/24/2010,10,0,6,5,21
10/25/2010,12,0,4,9,25
10/26/2010,10,0,8,3,21
10/27/2010,9,0,4,7,20
10/28/2010,7,0,5,4,16
10/29/2010,6,0,9,10,25
10/30/2010,7,0,9,8,24
10/31/2010,6,0,2,5,13
11/1/2010,4,0,2,4,10
11/2/2010,10,0,4,1,15
11/3/2010,4,0,8,3,15
11/4/2010,6,0,3,7,16
11/5/2010,6,0,4,7,17
11/6/2010,8,0,8,7,23
11/7/2010,7,0,6,0,13
11/8/2010,6,0,7,1,14
11/9/2010,10,0,8,3,21
11/10/2010,9,0,5,7,21
11/11/2010,7,0,3,11,21
11/12/2010,7,0,2,6,15
11/13/2010,5,0,10,1,16
11/14/2010,7,0,5,6,18
11/15/2010,10,0,3,8,21
11/16/2010,12,0,3,9,24
11/17/2010,9,0,8,7,24
11/18/2010,8,0,10,0,18
11/19/2010,9,0,9,1,19
11/20/2010,12,0,9,0,21
11/21/2010,7,0,9,4,20
11/22/2010,8,0,5,6,19
11/23/2010,6,0,2,1,9
11/24/2010,4,0,4,4,12
11/25/2010,9,0,5,0,14
11/26/2010,7,0,6,9,22
11/27/2010,6,0,10,9,25
11/28/2010,10,0,4,4,18
11/29/2010,10,0,7,2,19
11/30/2010,11,0,4,6,21
12/1/2010,7,0,8,2,17
12/2/2010,5,0,8,1,14
12/3/2010,4,0,10,6,20
12/4/2010,7,0,5,3,15
12/5/2010,10,0,4,8,22
12/6/2010,11,0,9,7,27
12/7/2010,4,0,5,7,16
12/8/2010,5,0,5,3,13
12/9/2010,7,0,3,2,12
12/10/2010,8,0,3,5,16
12/11/2010,5,0,7,5,17
12/12/2010,4,0,9,5,18
12/13/2010,6,0,9,5,20
12/14/2010,6,0,8,1,15
12/15/2010,6,0,7,10,23
12/16/2010,12,0,4,9,25
12/17/2010,11,0,6,1,18
12/18/2010,5,0,2,4,11
12/19/2010,11,0,3,5,19
12/20/2010,11,0,3,7,21
12/21/2010,6,0,8,1,15
12/22/2010,12,0,4,4,20
12/23/2010,9,0,7,10,26
12/24/2010,12,0,9,4,25
12/25/2010,4,0,9,10,23
12/26/2010,8,0,4,5,17
12/27/2010,7,0,7,5,19
12/28/2010,9,0,7,10,26
12/29/2010,8,0,10,2,20
12/30/2010,10,0,4,9,23
12/31/2010,4,0,9,1,14
1/1/2011,5,0,5,4,14
1/2/2011,5,0,5,10,20
1/3/2011,6,0,9,4,19
1/4/2011,9,0,7,7,23
1/5/2011,5,0,2,2,9
1/6/2011,9,0,6,10,25
1/7/2011,6,0,2,3,11
1/8/2011,8,0,3,0,11
1/9/2011,11,0,10,1,22
1/10/2011,11,0,9,5,25
1/11/2011,10,0,10,9,29
1/12/2011,10,0,6,8,24
1/13/2011,4,0,6,10,20
1/14/2011,6,0,4,9,19
1/15/2011,10,0,9,1,20
1/16/2011,8,0,6,7,21
1/17/2011,12,0,4,8,24
1/18/2011,4,0,7,11,22
1/19/2011,5,0,5,2,12
1/20/2011,10,0,10,0,20
1/21/2011,8,0,10,8,26
1/22/2011,4,0,9,6,19
1/23/2011,7,0,6,6,19
1/24/2011,7,0,8,4,19
1/25/2011,11,0,9,6,26
1/26/2011,11,0,6,1,18
1/27/2011,9,0,8,7,24
1/28/2011,10,0,2,0,12
1/29/2011,12,0,10,11,33
1/30/2011,9,0,2,1,12
1/31/2011,10,0,4,11,25
2/1/2011,10,0,6,1,17
2/2/2011,7,0,10,10,27
2/3/2011,10,0,6,2,18
2/4/2011,6,0,4,1,11
2/5/2011,4,0,9,9,22
2/6/2011,11,0,7,3,21
2/7/2011,8,0,4,8,20
2/8/2011,11,0,5,11,27
2/9/2011,8,0,10,0,18
2/10/2011,5,0,8,4,17
2/11/2011,12,0,5,9,26
2/12/2011,11,0,10,5,26
2/13/2011,9,0,5,8,22
2/14/2011,5,0,4,10,19
2/15/2011,11,0,6,2,19
2/16/2011,6,0,7,9,22
2/17/2011,11,0,6,11,28
2/18/2011,5,0,10,1,16
2/19/2011,5,0,2,4,11
2/20/2011,8,0,9,2,19
2/21/2011,11,0,7,3,21
2/22/2011,11,0,7,4,22
2/23/2011,9,0,2,10,21
2/24/2011,5,0,5,0,10
2/25/2011,4,0,6,10,20
2/26/2011,6,0,10,8,24
2/27/2011,5,0,3,7,15
2/28/2011,11,0,6,6,23
3/1/2011,8,0,7,11,26
3/2/2011,4,0,7,8,19
3/3/2011,4,0,3,0,7
3/4/2011,11,0,7,0,18
3/5/2011,8,0,5,7,20
3/6/2011,10,0,3,0,13
3/7/2011,9,0,6,7,22
3/8/2011,11,0,8,0,19
3/9/2011,9,0,3,1,13
3/10/2011,11,0,8,1,20
3/11/2011,9,0,8,2,19
3/12/2011,10,0,3,6,19
3/13/2011,10,0,10,1,21
3/14/2011,7,0,8,4,19
3/15/2011,5,0,3,0,8
3/16/2011,8,0,9,6,23
3/17/2011,4,0,3,8,15
3/18/2011,9,0,3,2,14
3/19/2011,10,0,6,0,16
3/20/2011,9,0,8,7,24
3/21/2011,5,0,10,9,24
3/22/2011,4,0,7,11,22
3/23/2011,7,0,7,1,15
3/24/2011,8,0,10,2,20
3/25/2011,10,0,7,8,25
3/26/2011,5,0,6,11,22
3/27/2011,6,0,4,1,11
3/28/2011,10,0,4,4,18
3/29/2011,12,0,8,1,21
3/30/2011,10,0,6,3,19
3/31/2011,6,0,8,7,21
4/1/2011,11,0,4,1,16
4/2/2011,12,0,7,4,23
4/3/2011,9,0,4,10,23
4/4/2011,4,0,2,7,13
4/5/2011,11,0,8,7,26
4/6/2011,5,0,3,5,13
4/7/2011,9,0,6,6,21
4/8/2011,5,0,6,7,18
4/9/2011,7,0,6,1,14
4/10/2011,9,0,7,7,23
4/11/2011,9,0,5,1,15
4/12/2011,10,0,9,8,27
4/13/2011,10,0,3,2,15
4/14/2011,4,0,6,2,12
4/15/2011,5,0,4,3,12
4/16/2011,4,0,2,7,13
4/17/2011,12,0,5,5,22
4/18/2011,12,0,9,3,24
4/19/2011,7,0,10,1,18
4/20/2011,5,0,7,0,12
4/21/2011,12,0,5,10,27
4/22/2011,9,0,2,0,11
4/23/2011,7,0,7,4,18
4/24/2011,7,0,5,1,13
4/25/2011,12,0,8,3,23
4/26/2011,10,0,10,0,20
4/27/2011,10,0,10,9,29
4/28/2011,12,0,3,8,23
4/29/2011,10,0,9,1,20
4/30/2011,5,0,3,2,10
5/1/2011,12,0,3,0,15
5/2/2011,7,0,3,4,14
5/3/2011,12,0,5,0,17
5/4/2011,11,0,7,10,28
5/5/2011,10,0,3,8,21
5/6/2011,12,0,8,7,27
5/7/2011,5,0,6,11,22
5/8/2011,12,0,8,4,24
5/9/2011,5,0,10,4,19
5/10/2011,7,0,3,3,13
5/11/2011,5,0,2,0,7
5/12/2011,5,0,7,9,21
5/13/2011,12,0,8,6,26
5/14/2011,6,0,5,8,19
5/15/2011,7,0,6,9,22
5/16/2011,11,0,3,1,15
5/17/2011,6,0,9,0,15
5/18/2011,8,0,5,4,17
5/19/2011,6,0,4,10,20
5/20/2011,10,0,7,7,24
5/21/2011,8,0,3,4,15
5/22/2011,10,0,8,11,29
5/23/2011,8,0,6,5,19
5/24/2011,7,0,7,9,23
5/25/2011,5,0,6,8,19
5/26/2011,10,0,3,6,19
5/27/2011,12,0,9,5,26
5/28/2011,10,0,8,6,24
5/29/2011,5,0,5,10,20
5/30/2011,9,0,2,11,22
5/31/2011,5,0,7,9,21
6/1/2011,10,0,6,9,25
6/2/2011,5,0,3,0,8
6/3/2011,4,0,3,11,18
6/4/2011,9,0,8,6,23
6/5/2011,5,0,5,6,16
6/6/2011,5,0,8,4,17
6/7/2011,11,0,5,6,22
6/8/2011,6,0,5,6,17
6/9/2011,4,0,3,6,13
6/10/2011,6,0,8,2,16
6/11/2011,7,0,2,0,9
6/12/2011,10,0,4,8,22
6/13/2011,5,0,6,0,11
6/14/2011,11,0,6,3,20
6/15/2011,7,0,6,3,16
6/16/2011,6,0,4,0,10
6/17/2011,5,0,5,0,10
6/18/2011,5,0,4,4,13
6/19/2011,6,0,4,6,16
6/20/2011,4,0,5,5,14
6/21/2011,8,0,2,3,13
6/22/2011,5,0,5,5,15
6/23/2011,7,0,4,9,20
6/24/2011,7,0,10,9,26
6/25/2011,5,0,2,3,10
6/26/2011,8,0,5,0,13
6/27/2011,12,0,7,10,29
6/28/2011,5,0,4,3,12
6/29/2011,7,0,6,2,15
6/30/2011,6,0,8,6,20
7/1/2011,6,0,3,2,11
7/2/2011,8,0,4,11,23
7/3/2011,9,0,10,2,21
7/4/2011,8,0,5,8,21
7/5/2011,4,0,4,0,8
7/6/2011,8,0,4,7,19
7/7/2011,6,0,4,2,12
7/8/2011,4,0,6,1,11
7/9/2011,4,0,6,7,17
7/10/2011,4,0,3,2,9
7/11/2011,11,0,2,10,23
7/12/2011,8,0,5,8,21
7/13/2011,9,0,8,11,28
7/14/2011,10,0,2,6,18
7/15/2011,10,0,2,9,21
7/16/2011,10,0,9,8,27
7/17/2011,12,0,2,7,21
7/18/2011,11,0,2,1,14
7/19/2011,10,0,6,10,26
7/20/2011,8,0,2,8,18
7/21/2011,9,0,3,2,14
7/22/2011,5,0,9,2,16
7/23/2011,9,0,4,9,22
7/24/2011,5,0,9,0,14
7/25/2011,7,0,5,7,19
7/26/2011,9,0,4,10,23
7/27/2011,5,0,6,7,18
7/28/2011,11,0,10,9,30
7/29/2011,11,0,9,5,25
7/30/2011,7,0,5,7,19
7/31/2011,9,0,9,2,20
8/1/2011,4,0,2,8,14
8/2/2011,12,0,10,3,25
8/3/2011,7,0,6,8,21
8/4/2011,11,0,5,3,19
8/5/2011,7,0,5,2,14
8/6/2011,10,0,8,0,18
8/7/2011,5,0,9,9,23
8/8/2011,6,0,5,3,14
8/9/2011,7,0,4,4,15
8/10/2011,7,0,9,0,16
8/11/2011,8,0,7,2,17
8/12/2011,4,0,10,11,25
8/13/2011,10,0,7,4,21
8/14/2011,12,0,8,9,29
8/15/2011,5,0,10,6,21
8/16/2011,6,0,2,3,11
8/17/2011,9,0,9,2,20
8/18/2011,11,0,4,5,20
8/19/2011,10,0,7,8,25
8/20/2011,4,0,4,9,17
8/21/2011,7,0,7,7,21
8/22/2011,12,0,9,5,26
8/23/2011,6,0,4,0,10
8/24/2011,5,0,9,11,25
8/25/2011,6,0,7,11,24
8/26/2011,10,0,8,0,18
8/27/2011,5,0,6,0,11
8/28/2011,12,0,5,3,20
8/29/2011,10,0,2,9,21
8/30/2011,6,0,9,0,15
8/31/2011,7,0,3,4,14
9/1/2011,11,0,3,7,21
9/2/2011,10,0,4,4,18
9/3/2011,6,0,4,7,17
9/4/2011,5,0,9,1,15
9/5/2011,8,0,10,4,22
9/6/2011,11,0,4,0,15
9/7/2011,5,0,6,9,20
9/8/2011,6,0,7,7,20
9/9/2011,10,0,8,3,21
9/10/2011,6,0,10,10,26
9/11/2011,4,0,8,3,15
9/12/2011,4,0,3,3,10
9/13/2011,9,0,2,11,22
9/14/2011,8,0,8,9,25
9/15/2011,10,0,10,4,24
9/16/2011,10,0,4,6,20
9/17/2011,10,0,6,4,20
9/18/2011,11,0,10,4,25
9/19/2011,8,0,9,10,27
9/20/2011,6,0,8,9,23
9/21/2011,6,0,8,9,23
9/22/2011,6,0,6,9,21
9/23/2011,4,0,10,9,23
9/24/2011,7,0,2,2,11
9/25/2011,10,0,5,1,16
9/26/2011,7,0,4,0,11
9/27/2011,7,0,5,7,19
9/28/2011,10,0,4,1,15
9/29/2011,7,0,8,11,26
9/30/2011,6,0,5,11,22
10/1/2011,5,0,6,4,15
10/2/2011,4,0,8,11,23
10/3/2011,10,0,8,2,20
10/4/2011,12,0,3,4,19
10/5/2011,7,0,7,0,14
10/6/2011,11,0,5,3,19
10/7/2011,10,0,3,1,14
10/8/2011,8,0,3,3,14
10/9/2011,8,0,4,3,15
10/10/2011,4,0,3,5,12
10/11/2011,8,0,9,1,18
10/12/2011,9,0,6,5,20
10/13/2011,9,0,8,9,26
10/14/2011,8,0,4,2,14
10/15/2011,12,0,4,5,21
10/16/2011,11,0,8,7,26
10/17/2011,11,0,2,10,23
10/18/2011,11,0,5,6,22
10/19/2011,8,0,10,11,29
10/20/2011,10,0,10,1,21
10/21/2011,8,0,5,7,20
10/22/2011,12,0,6,7,25
10/23/2011,6,0,7,7,20
10/24/2011,11,0,5,6,22
10/25/2011,10,0,4,11,25
10/26/2011,7,0,7,11,25
10/27/2011,11,0,8,6,25
10/28/2011,9,0,8,2,19
10/29/2011,5,0,3,8,16
10/30/2011,5,0,8,5,18
10/31/2011,9,0,4,10,23
11/1/2011,6,0,3,8,17
11/2/2011,10,0,7,4,21
11/3/2011,10,0,5,8,23
11/4/2011,6,0,8,2,16
11/5/2011,4,0,9,2,15
11/6/2011,6,0,3,10,19
11/7/2011,9,0,7,9,25
11/8/2011,6,0,7,4,17
11/9/2011,10,0,5,1,16
11/10/2011,6,0,6,2,14
11/11/2011,11,0,9,5,25
11/12/2011,4,0,5,11,20
11/13/2011,12,0,5,0,17
11/14/2011,11,0,9,0,20
11/15/2011,12,0,6,5,23
11/16/2011,11,0,8,5,24
11/17/2011,10,0,3,9,22
11/18/2011,6,0,7,1,14
11/19/2011,5,0,4,1,10
11/20/2011,9,0,10,8,27
11/21/2011,6,0,4,5,15
11/22/2011,4,0,2,0,6
11/23/2011,11,0,2,9,22
11/24/2011,11,0,5,3,19
11/25/2011,11,0,10,7,28
11/26/2011,6,0,9,11,26
11/27/2011,10,0,2,3,15
11/28/2011,5,0,2,5,12
11/29/2011,4,0,7,9,20
11/30/2011,12,0,7,3,22
12/1/2011,8,0,9,1,18
12/2/2011,9,0,5,7,21
12/3/2011,7,0,5,10,22
12/4/2011,8,0,5,3,16
12/5/2011,5,0,2,2,9
12/6/2011,11,0,8,4,23
12/7/2011,12,0,8,11,31
12/8/2011,5,0,5,7,17
12/9/2011,9,0,5,9,23
12/10/2011,4,0,3,5,12
12/11/2011,9,0,8,9,26
12/12/2011,10,0,5,10,25
12/13/2011,10,0,8,9,27
12/14/2011,6,0,6,7,19
12/15/2011,5,0,3,4,12
12/16/2011,9,0,8,7,24
12/17/2011,11,0,10,11,32
12/18/2011,4,0,7,10,21
12/19/2011,7,0,4,3,14
12/20/2011,9,0,9,0,18
12/21/2011,6,0,2,3,11
12/22/2011,10,0,10,0,20
12/23/2011,10,0,5,11,26
12/24/2011,4,0,9,11,24
12/25/2011,6,0,10,9,25
12/26/2011,12,0,4,10,26
12/27/2011,9,0,3,11,23
12/28/2011,5,0,6,0,11
12/29/2011,5,0,6,2,13
12/30/2011,4,0,7,5,16
12/31/2011,4,0,5,10,19
1/1/2012,7,0,8,7,22
1/2/2012,6,0,3,9,18
1/3/2012,9,0,9,6,24
1/4/2012,9,0,10,5,24
1/5/2012,7,0,8,2,17
1/6/2012,10,0,10,11,31
1/7/2012,12,0,7,9,28
1/8/2012,12,0,6,6,24
1/9/2012,7,0,9,6,22
1/10/2012,8,0,3,2,13
1/11/2012,7,0,5,5,17
1/12/2012,6,0,6,10,22
1/13/2012,7,0,6,8,21
1/14/2012,9,0,4,4,17
1/15/2012,9,0,3,3,15
1/16/2012,4,0,10,5,19
1/17/2012,9,0,10,6,25
1/18/2012,5,0,10,8,23
1/19/2012,9,0,8,11,28
1/20/2012,4,0,6,6,16
1/21/2012,9,0,2,0,11
1/22/2012,8,0,4,11,23
1/23/2012,12,0,10,5,27
1/24/2012,5,0,5,1,11
1/25/2012,4,0,9,2,15
1/26/2012,12,0,6,3,21
1/27/2012,12,0,10,6,28
1/28/2012,10,0,7,1,18
1/29/2012,7,0,9,7,23
1/30/2012,6,0,9,8,23
1/31/2012,5,0,6,8,19
2/1/2012,6,0,5,1,12
2/2/2012,6,0,8,7,21
2/3/2012,12,0,4,10,26
2/4/2012,12,0,9,9,30
2/5/2012,5,0,7,2,14
2/6/2012,4,0,7,10,21
2/7/2012,11,0,9,0,20
2/8/2012,8,0,6,1,15
2/9/2012,8,0,4,4,16
2/10/2012,10,0,8,2,20
2/11/2012,6,0,4,1,11
2/12/2012,10,0,8,8,26
2/13/2012,8,0,2,9,19
2/14/2012,4,0,9,4,17
2/15/2012,11,0,7,6,24
2/16/2012,4,0,4,7,15
2/17/2012,5,0,8,2,15
2/18/2012,7,0,9,2,18
2/19/2012,7,0,10,5,22
2/20/2012,5,0,5,11,21
2/21/2012,8,0,2,11,21
2/22/2012,10,0,4,10,24
2/23/2012,6,0,4,3,13
2/24/2012,7,0,3,0,10
2/25/2012,6,0,3,5,14
2/26/2012,10,0,5,5,20
2/27/2012,12,0,3,6,21
2/28/2012,7,0,8,5,20
2/29/2012,8,0,7,9,24
3/1/2012,10,0,7,1,18
3/2/2012,6,0,7,9,22
3/3/2012,8,0,8,9,25
3/4/2012,4,0,5,2,11
3/5/2012,8,0,3,3,14
3/6/2012,7,0,9,7,23
3/7/2012,11,0,2,10,23
3/8/2012,9,0,10,6,25
3/9/2012,11,0,7,4,22
3/10/2012,7,0,4,7,18
3/11/2012,12,0,10,4,26
3/12/2012,10,0,2,11,23
3/13/2012,12,0,2,2,16
3/14/2012,9,0,2,2,13
3/15/2012,8,0,3,3,14
3/16/2012,12,0,8,10,30
3/17/2012,8,0,9,8,25
3/18/2012,4,0,10,11,25
3/19/2012,5,0,8,2,15
3/20/2012,9,0,9,11,29
3/21/2012,9,0,3,4,16
3/22/2012,5,0,8,5,18
3/23/2012,10,0,10,5,25
3/24/2012,4,0,3,10,17
3/25/2012,7,0,5,11,23
3/26/2012,6,0,3,11,20
3/27/2012,4,0,9,5,18
3/28/2012,5,0,3,10,18
3/29/2012,11,0,4,6,21
3/30/2012,10,0,8,11,29
3/31/2012,6,0,8,3,17
4/1/2012,6,0,9,1,16
4/2/2012,7,0,8,11,26
4/3/2012,7,0,8,6,21
4/4/2012,11,0,10,9,30
4/5/2012,7,0,8,4,19
4/6/2012,8,0,2,0,10
4/7/2012,8,0,9,7,24
4/8/2012,5,0,10,4,19
4/9/2012,6,0,5,3,14
4/10/2012,12,0,5,6,23
4/11/2012,7,0,7,3,17
4/12/2012,7,0,7,3,17
4/13/2012,9,0,7,3,19
4/14/2012,4,0,2,9,15
4/15/2012,6,0,3,6,15
4/16/2012,12,0,6,4,22
4/17/2012,6,0,4,9,19
4/18/2012,11,0,6,1,18
4/19/2012,5,0,2,9,16
4/20/2012,8,0,5,3,16
4/21/2012,9,0,9,5,23
4/22/2012,5,0,8,3,16
4/23/2012,4,0,4,7,15
4/24/2012,7,0,10,5,22
4/25/2012,11,0,6,10,27
4/26/2012,10,0,6,0,16
4/27/2012,10,0,8,6,24
4/28/2012,4,0,3,6,13
4/29/2012,11,0,9,8,28
4/30/2012,12,0,6,9,27
5/1/2012,8,0,6,2,16
5/2/2012,5,0,6,5,16
5/3/2012,6,0,6,10,22
5/4/2012,9,0,10,3,22
5/5/2012,6,0,5,4,15
5/6/2012,9,0,3,10,22
5/7/2012,10,0,6,10,26
5/8/2012,12,0,6,1,19
5/9/2012,8,0,9,0,17
5/10/2012,12,0,2,6,20
5/11/2012,11,0,8,6,25
5/12/2012,11,0,7,11,29
5/13/2012,8,0,3,0,11
5/14/2012,9,0,6,5,20
5/15/2012,7,0,9,0,16
5/16/2012,12,0,4,2,18
5/17/2012,9,0,7,3,19
5/18/2012,4,0,4,5,13
5/19/2012,10,0,2,9,21
5/20/2012,10,0,2,8,20
5/21/2012,4,0,8,10,22
5/22/2012,12,0,2,2,16
5/23/2012,4,0,4,4,12
5/24/2012,12,0,4,6,22
5/25/2012,4,0,3,6,13
5/26/2012,10,0,10,2,22
5/27/2012,4,0,6,3,13
5/28/2012,8,0,8,6,22
5/29/2012,12,0,9,7,28
5/30/2012,12,0,3,11,26
5/31/2012,10,0,7,4,21
6/1/2012,10,0,2,3,15
6/2/2012,11,0,3,11,25
6/3/2012,5,0,4,7,16
6/4/2012,6,0,5,2,13
6/5/2012,7,0,7,0,14
6/6/2012,4,0,9,2,15
6/7/2012,5,0,9,7,21
6/8/2012,8,0,3,5,16
6/9/2012,4,0,5,5,14
6/10/2012,4,0,2,6,12
6/11/2012,10,0,6,7,23
6/12/2012,7,0,9,3,19
6/13/2012,7,0,6,9,22
6/14/2012,6,0,7,8,21
6/15/2012,6,0,9,9,24
6/16/2012,12,0,5,5,22
6/17/2012,11,0,8,1,20
6/18/2012,12,0,3,10,25
6/19/2012,5,0,3,3,11
6/20/2012,8,0,2,3,13
6/21/2012,4,0,10,0,14
6/22/2012,5,0,6,7,18
6/23/2012,8,0,3,1,12
6/24/2012,6,0,6,2,14
6/25/2012,12,0,8,10,30
6/26/2012,5,0,10,0,15
6/27/2012,11,0,3,5,19
6/28/2012,12,0,4,3,19
6/29/2012,8,0,9,1,18
6/30/2012,7,0,8,11,26
7/1/2012,9,0,5,5,19
7/2/2012,6,0,3,6,15
7/3/2012,9,0,2,3,14
7/4/2012,12,0,7,2,21
7/5/2012,7,0,5,5,17
7/6/2012,6,0,7,4,17
7/7/2012,11,0,6,5,22
7/8/2012,10,0,10,3,23
7/9/2012,5,0,2,2,9
7/10/2012,5,0,5,3,13
7/11/2012,10,0,2,2,14
7/12/2012,8,0,4,1,13
7/13/2012,4,0,9,1,14
7/14/2012,6,0,8,1,15
7/15/2012,11,0,3,11,25
7/16/2012,12,0,6,0,18
7/17/2012,8,0,3,9,20
7/18/2012,5,0,10,5,20
7/19/2012,11,0,2,2,15
7/20/2012,6,0,5,8,19
7/21/2012,8,0,2,9,19
7/22/2012,4,0,3,7,14
7/23/2012,11,0,5,3,19
7/24/2012,12,0,5,8,25
7/25/2012,9,0,7,5,21
7/26/2012,12,0,5,9,26
7/27/2012,9,0,5,3,17
7/28/2012,10,0,8,4,22
7/29/2012,12,0,3,9,24
7/30/2012,12,0,9,3,24
7/31/2012,6,0,6,8,20
8/1/2012,10,0,7,1,18
8/2/2012,4,0,6,5,15
8/3/2012,11,0,2,5,18
8/4/2012,12,0,7,8,27
8/5/2012,11,0,9,10,30
8/6/2012,10,0,5,4,19
8/7/2012,9,0,2,3,14
8/8/2012,10,0,3,4,17
8/9/2012,6,0,9,10,25
8/10/2012,9,0,5,4,18
8/11/2012,4,0,9,5,18
8/12/2012,5,0,3,9,17
8/13/2012,9,0,6,8,23
8/14/2012,9,0,10,5,24
8/15/2012,8,0,5,7,20
8/16/2012,7,0,9,5,21
8/17/2012,9,0,4,10,23
8/18/2012,5,0,4,11,20
8/19/2012,4,0,3,9,16
8/20/2012,4,0,2,4,10
8/21/2012,7,0,9,9,25
8/22/2012,6,0,10,8,24
8/23/2012,8,0,10,9,27
8/24/2012,6,0,10,11,27
8/25/2012,4,0,5,7,16
8/26/2012,12,0,2,8,22
8/27/2012,10,0,3,9,22
8/28/2012,7,0,7,7,21
8/29/2012,8,0,4,4,16
8/30/2012,4,0,2,5,11
8/31/2012,10,0,5,9,24
9/1/2012,8,0,9,4,21
9/2/2012,10,0,2,1,13
9/3/2012,9,0,9,4,22
9/4/2012,7,0,7,2,16
9/5/2012,7,0,2,2,11
9/6/2012,6,0,4,5,15
9/7/2012,12,0,8,0,20
9/8/2012,8,0,4,5,17
9/9/2012,6,0,8,11,25
9/10/2012,6,0,5,6,17
9/11/2012,8,0,7,0,15
9/12/2012,8,0,6,7,21
9/13/2012,10,0,7,7,24
9/14/2012,12,0,3,6,21
9/15/2012,7,0,8,3,18
9/16/2012,5,0,8,7,20
9/17/2012,4,0,4,2,10
9/18/2012,7,0,3,0,10
9/19/2012,4,0,7,0,11
9/20/2012,7,0,9,9,25
9/21/2012,9,0,3,7,19
9/22/2012,8,0,8,5,21
9/23/2012,7,0,3,8,18
9/24/2012,5,0,8,11,24
9/25/2012,11,0,9,10,30
9/26/2012,7,0,2,8,17
9/27/2012,10,0,6,7,23
9/28/2012,4,0,4,7,15
9/29/2012,11,0,7,6,24
9/30/2012,12,0,3,10,25
10/1/2012,8,0,7,8,23
10/2/2012,10,0,9,5,24
10/3/2012,6,0,2,6,14
10/4/2012,8,0,9,5,22
10/5/2012,10,0,5,8,23
10/6/2012,5,0,6,11,22
10/7/2012,10,0,8,11,29
10/8/2012,11,0,6,5,22
10/9/2012,7,0,5,7,19
10/10/2012,6,0,9,5,20
10/11/2012,6,0,10,10,26
10/12/2012,4,0,5,0,9
10/13/2012,6,0,2,0,8
10/14/2012,4,0,6,1,11
10/15/2012,10,0,2,2,14
10/16/2012,6,0,4,8,18
10/17/2012,4,0,7,3,14
10/18/2012,10,0,9,3,22
10/19/2012,12,0,6,11,29
10/20/2012,8,0,5,10,23
10/21/2012,11,0,6,0,17
10/22/2012,10,0,5,5,20
10/23/2012,8,0,5,8,21
10/24/2012,12,0,5,8,25
10/25/2012,9,0,8,10,27
10/26/2012,10,0,8,5,23
10/27/2012,8,0,3,8,19
10/28/2012,12,0,9,10,31
10/29/2012,12,0,7,1,20
10/30/2012,5,0,6,7,18
10/31/2012,7,0,7,0,14
11/1/2012,7,0,5,9,21
11/2/2012,7,0,6,10,23
11/3/2012,9,0,6,6,21
11/4/2012,5,0,6,4,15
11/5/2012,8,0,8,11,27
11/6/2012,8,0,4,11,23
11/7/2012,7,0,5,9,21
11/8/2012,8,0,4,6,18
11/9/2012,6,0,5,8,19
11/10/2012,11,0,9,1,21
11/11/2012,12,0,8,11,31
11/12/2012,5,0,7,5,17
11/13/2012,8,0,2,11,21
11/14/2012,10,0,9,11,30
11/15/2012,5,0,2,8,15
11/16/2012,7,0,7,4,18
11/17/2012,7,0,6,0,13
11/18/2012,5,0,2,9,16
11/19/2012,8,0,3,9,20
11/20/2012,5,0,6,5,16
11/21/2012,12,0,2,8,22
11/22/2012,9,0,8,11,28
11/23/2012,11,0,6,0,17
11/24/2012,11,0,2,11,24
11/25/2012,4,0,8,2,14
11/26/2012,4,0,3,10,17
11/27/2012,10,0,3,5,18
11/28/2012,4,0,6,2,12
11/29/2012,9,0,5,4,18
11/30/2012,4,0,8,0,12
12/1/2012,8,0,8,1,17
12/2/2012,6,0,9,11,26
12/3/2012,12,0,2,3,17
12/4/2012,5,0,10,1,16
12/5/2012,10,0,6,8,24
12/6/2012,6,0,8,0,14
12/7/2012,11,0,3,5,19
12/8/2012,6,0,3,5,14
12/9/2012,10,0,8,10,28
12/10/2012,6,0,3,1,10
12/11/2012,10,0,9,2,21
12/12/2012,9,0,6,2,17
12/13/2012,9,0,6,1,16
12/14/2012,9,0,6,3,18
12/15/2012,6,0,5,7,18
12/16/2012,10,0,8,5,23
12/17/2012,11,0,7,5,23
12/18/2012,12,0,8,5,25
12/19/2012,4,0,8,11,23
12/20/2012,5,0,9,10,24
12/21/2012,8,0,6,5,19
12/22/2012,5,0,2,6,13
12/23/2012,12,0,7,9,28
12/24/2012,9,0,9,7,25
12/25/2012,11,0,4,7,22
12/26/2012,9,0,9,0,18
12/27/2012,12,0,10,8,30
12/28/2012,5,0,4,0,9
12/29/2012,4,0,9,1,14
12/30/2012,5,0,8,10,23
12/31/2012,9,0,7,4,20
1/1/2013,4,0,6,3,13
1/2/2013,4,0,8,10,22
1/3/2013,7,0,3,4,14
1/4/2013,11,0,6,8,25
1/5/2013,11,0,6,11,28
1/6/2013,4,0,8,5,17
1/7/2013,11,0,4,4,19
1/8/2013,11,0,2,0,13
1/9/2013,8,0,5,2,15
1/10/2013,12,0,5,3,20
1/11/2013,11,0,6,9,26
1/12/2013,8,0,6,8,22
1/13/2013,9,0,10,6,25
1/14/2013,5,0,8,8,21
1/15/2013,6,0,4,4,14
1/16/2013,10,0,6,2,18
1/17/2013,10,0,3,2,15
1/18/2013,11,0,5,8,24
1/19/2013,5,0,3,3,11
1/20/2013,12,0,5,5,22
1/21/2013,9,0,9,2,20
1/22/2013,12,0,4,1,17
1/23/2013,10,0,8,7,25
1/24/2013,5,0,5,8,18
1/25/2013,8,0,10,3,21
1/26/2013,9,0,5,5,19
1/27/2013,9,0,10,1,20
1/28/2013,7,0,3,3,13
1/29/2013,8,0,7,10,25
1/30/2013,8,0,7,9,24
1/31/2013,12,0,8,10,30
2/1/2013,11,0,6,9,26
2/2/2013,6,0,6,1,13
2/3/2013,12,0,7,4,23
2/4/2013,12,0,2,6,20
2/5/2013,7,0,4,10,21
2/6/2013,9,0,8,3,20
2/7/2013,7,0,5,8,20
2/8/2013,9,0,9,1,19
2/9/2013,7,0,4,5,16
2/10/2013,4,0,10,0,14
2/11/2013,12,0,3,10,25
2/12/2013,7,0,3,10,20
2/13/2013,12,0,3,10,25
2/14/2013,4,0,5,10,19
2/15/2013,7,0,3,0,10
2/16/2013,9,0,3,7,19
2/17/2013,9,0,7,5,21
2/18/2013,9,0,6,0,15
2/19/2013,8,0,3,9,20
2/20/2013,6,0,7,1,14
2/21/2013,7,0,3,3,13
2/22/2013,7,0,8,8,23
2/23/2013,6,0,6,10,22
2/24/2013,7,0,6,1,14
2/25/2013,11,0,10,5,26
2/26/2013,9,0,10,5,24
2/27/2013,5,0,10,0,15
2/28/2013,4,0,4,2,10
3/1/2013,9,0,8,0,17
3/2/2013,6,0,4,6,16
3/3/2013,12,0,10,4,26
3/4/2013,10,0,2,5,17
3/5/2013,7,0,9,1,17
3/6/2013,5,0,5,3,13
3/7/2013,7,0,7,4,18
3/8/2013,7,0,7,3,17
3/9/2013,11,0,2,8,21
3/10/2013,11,0,5,0,16
3/11/2013,7,0,8,5,20
3/12/2013,9,0,7,1,17
3/13/2013,9,0,3,9,21
3/14/2013,8,0,5,9,22
3/15/2013,12,0,10,1,23
3/16/2013,6,0,6,4,16
3/17/2013,6,0,5,4,15
3/18/2013,10,0,7,3,20
3/19/2013,11,0,2,5,18
3/20/2013,9,0,7,6,22
3/21/2013,12,0,9,8,29
3/22/2013,9,0,9,0,18
3/23/2013,6,0,8,3,17
3/24/2013,12,0,10,1,23
3/25/2013,4,0,5,11,20
3/26/2013,10,0,9,7,26
3/27/2013,5,0,5,3,13
3/28/2013,10,0,10,10,30
3/29/2013,4,0,9,2,15
3/30/2013,12,0,7,2,21
3/31/2013,12,0,7,3,22
4/1/2013,10,0,2,3,15
4/2/2013,8,0,5,3,16
4/3/2013,7,0,8,6,21
4/4/2013,11,0,2,11,24
4/5/2013,5,0,6,2,13
4/6/2013,12,0,8,11,31
4/7/2013,11,0,10,8,29
4/8/2013,10,0,4,2,16
4/9/2013,4,0,4,10,18
4/10/2013,8,0,10,5,23
4/11/2013,12,0,7,8,27
4/12/2013,7,0,2,2,11
4/13/2013,11,0,2,7,20
4/14/2013,6,0,5,7,18
4/15/2013,10,0,4,8,22
4/16/2013,5,0,4,0,9
4/17/2013,12,0,9,10,31
4/18/2013,11,0,4,10,25
4/19/2013,5,0,5,7,17
4/20/2013,5,0,8,11,24
4/21/2013,10,0,8,7,25
4/22/2013,7,0,3,11,21
4/23/2013,10,0,8,8,26
4/24/2013,9,0,6,11,26
4/25/2013,4,0,8,2,14
4/26/2013,10,0,5,2,17
4/27/2013,6,0,8,8,22
4/28/2013,11,0,5,11,27
4/29/2013,8,0,3,4,15
4/30/2013,10,0,6,4,20
5/1/2013,6,0,9,9,24
5/2/2013,8,0,10,8,26
5/3/2013,8,0,6,11,25
5/4/2013,7,0,8,1,16
5/5/2013,9,0,4,11,24
5/6/2013,7,0,8,3,18
5/7/2013,11,0,8,9,28
5/8/2013,4,0,7,8,19
5/9/2013,11,0,7,4,22
5/10/2013,6,0,7,10,23
5/11/2013,11,0,6,5,22
5/12/2013,9,0,2,8,19
5/13/2013,6,0,7,3,16
5/14/2013,7,0,8,9,24
5/15/2013,6,0,9,10,25
5/16/2013,11,0,10,4,25
5/17/2013,5,0,10,5,20
5/18/2013,7,0,10,2,19
5/19/2013,10,0,4,11,25
5/20/2013,10,0,10,4,24
5/21/2013,7,0,8,11,26
5/22/2013,12,0,7,11,30
5/23/2013,10,0,7,1,18
5/24/2013,5,0,7,3,15
5/25/2013,8,0,3,6,17
5/26/2013,11,0,2,8,21
5/27/2013,7,0,7,1,15
5/28/2013,7,0,6,7,20
5/29/2013,10,0,7,1,18
5/30/2013,9,0,3,9,21
5/31/2013,9,0,2,9,20
6/1/2013,11,0,8,8,27
6/2/2013,7,0,10,0,17
6/3/2013,5,0,7,9,21
6/4/2013,4,0,6,0,10
6/5/2013,9,0,6,10,25
6/6/2013,8,0,7,3,18
6/7/2013,5,0,9,5,19
6/8/2013,12,0,9,5,26
6/9/2013,12,0,7,0,19
6/10/2013,4,0,2,2,8
6/11/2013,10,0,5,2,17
6/12/2013,4,0,7,11,22
6/13/2013,12,0,4,9,25
6/14/2013,12,0,2,5,19
6/15/2013,10,0,8,9,27
6/16/2013,4,0,2,9,15
6/17/2013,7,0,8,5,20
6/18/2013,4,0,2,3,9
6/19/2013,8,0,8,8,24
6/20/2013,12,0,5,11,28
6/21/2013,12,0,9,10,31
6/22/2013,6,0,9,5,20
6/23/2013,7,0,4,9,20
6/24/2013,10,0,9,8,27
6/25/2013,10,0,2,1,13
6/26/2013,11,0,8,1,20
6/27/2013,4,0,3,5,12
6/28/2013,6,0,9,0,15
6/29/2013,12,0,9,11,32
6/30/2013,5,0,7,7,19
7/1/2013,7,0,6,8,21
7/2/2013,7,0,8,2,17
7/3/2013,8,0,2,8,18
7/4/2013,7,0,10,7,24
7/5/2013,6,0,4,11,21
7/6/2013,12,0,9,6,27
7/7/2013,12,0,6,0,18
7/8/2013,9,0,3,5,17
7/9/2013,4,0,7,6,17
7/10/2013,5,0,6,8,19
7/11/2013,6,0,10,9,25
7/12/2013,4,0,7,5,16
7/13/2013,10,0,7,0,17
7/14/2013,11,0,9,1,21
7/15/2013,5,0,10,3,18
7/16/2013,8,0,5,0,13
7/17/2013,8,0,2,7,17
7/18/2013,9,0,2,9,20
7/19/2013,7,0,3,9,19
7/20/2013,6,0,2,3,11
7/21/2013,6,0,3,7,16
7/22/2013,11,0,5,7,23
7/23/2013,4,0,9,8,21
7/24/2013,8,0,5,3,16
7/25/2013,10,0,2,11,23
7/26/2013,12,0,4,11,27
7/27/2013,5,0,5,9,19
7/28/2013,10,0,9,7,26
7/29/2013,10,0,10,10,30
7/30/2013,7,0,9,0,16
7/31/2013,10,0,9,7,26
8/1/2013,9,0,5,1,15
8/2/2013,9,0,4,11,24
8/3/2013,4,0,6,2,12
8/4/2013,11,0,8,2,21
8/5/2013,4,0,7,4,15
8/6/2013,12,0,5,9,26
8/7/2013,9,0,6,10,25
8/8/2013,6,0,5,6,17
8/9/2013,12,0,7,8,27
8/10/2013,8,0,3,5,16
8/11/2013,7,0,3,1,11
8/12/2013,6,0,3,1,10
8/13/2013,12,0,7,7,26
8/14/2013,5,0,10,11,26
8/15/2013,5,0,10,2,17
8/16/2013,5,0,3,6,14
8/17/2013,5,0,6,10,21
8/18/2013,9,0,2,3,14
8/19/2013,12,0,4,9,25
8/20/2013,9,0,9,3,21
8/21/2013,11,0,10,0,21
8/22/2013,11,0,9,8,28
8/23/2013,10,0,9,5,24
8/24/2013,8,0,2,2,12
8/25/2013,4,0,10,1,15
8/26/2013,6,0,8,2,16
8/27/2013,5,0,10,7,22
8/28/2013,10,0,6,4,20
8/29/2013,12,0,9,4,25
8/30/2013,7,0,4,0,11
8/31/2013,6,0,7,6,19
9/1/2013,7,0,5,8,20
9/2/2013,5,0,6,6,17
9/3/2013,5,0,2,11,18
9/4/2013,4,0,4,0,8
9/5/2013,11,0,10,7,28
9/6/2013,4,0,9,5,18
9/7/2013,10,0,8,8,26
9/8/2013,6,0,8,9,23
9/9/2013,7,0,6,8,21
9/10/2013,6,0,4,0,10
9/11/2013,8,0,7,3,18
9/12/2013,12,0,2,0,14
9/13/2013,9,0,2,5,16
9/14/2013,12,0,3,7,22
9/15/2013,5,0,10,11,26
9/16/2013,9,0,9,4,22
9/17/2013,7,0,4,9,20
9/18/2013,11,0,3,11,25
9/19/2013,9,0,2,0,11
9/20/2013,6,0,8,7,21
9/21/2013,8,0,8,3,19
9/22/2013,8,0,10,4,22
9/23/2013,11,0,2,3,16
9/24/2013,10,0,10,7,27
9/25/2013,5,0,10,4,19
9/26/2013,4,0,10,8,22
9/27/2013,10,0,3,11,24
9/28/2013,5,0,8,2,15
9/29/2013,5,0,10,7,22
9/30/2013,11,0,5,9,25
10/1/2013,5,0,4,10,19
10/2/2013,5,0,9,1,15
10/3/2013,8,0,5,5,18
10/4/2013,12,0,4,2,18
10/5/2013,6,0,6,4,16
10/6/2013,10,0,2,1,13
10/7/2013,9,0,9,1,19
10/8/2013,11,0,4,3,18
10/9/2013,4,0,3,7,14
10/10/2013,7,0,7,10,24
10/11/2013,4,0,2,10,16
10/12/2013,7,0,6,8,21
10/13/2013,12,0,6,3,21
10/14/2013,10,0,10,10,30
10/15/2013,10,0,5,10,25
10/16/2013,10,0,8,1,19
10/17/2013,9,0,9,8,26
10/18/2013,5,0,5,8,18
10/19/2013,7,0,6,9,22
10/20/2013,6,0,2,7,15
10/21/2013,8,0,5,11,24
10/22/2013,7,0,5,3,15
10/23/2013,12,0,7,0,19
10/24/2013,5,0,2,11,18
10/25/2013,9,0,2,2,13
10/26/2013,12,0,2,7,21
10/27/2013,5,0,5,1,11
10/28/2013,4,0,5,11,20
10/29/2013,4,0,4,3,11
10/30/2013,6,0,9,0,15
10/31/2013,6,0,10,4,20
11/1/2013,4,0,4,7,15
11/2/2013,8,0,2,1,11
11/3/2013,10,0,4,2,16
11/4/2013,4,0,5,1,10
11/5/2013,7,0,3,5,15
11/6/2013,12,0,2,4,18
11/7/2013,4,0,5,0,9
11/8/2013,6,0,6,6,18
11/9/2013,4,0,2,10,16
11/10/2013,12,0,4,7,23
11/11/2013,8,0,3,7,18
11/12/2013,6,0,4,5,15
11/13/2013,5,0,7,10,22
11/14/2013,6,0,6,5,17
11/15/2013,8,0,8,8,24
11/16/2013,6,0,5,11,22
11/17/2013,11,0,10,6,27
11/18/2013,7,0,8,2,17
11/19/2013,7,0,6,2,15
11/20/2013,8,0,6,8,22
11/21/2013,10,0,9,0,19
11/22/2013,12,0,8,11,31
11/23/2013,4,0,6,8,18
11/24/2013,10,0,2,2,14
11/25/2013,10,0,10,4,24
11/26/2013,8,0,8,11,27
11/27/2013,5,0,6,2,13
11/28/2013,12,0,9,7,28
11/29/2013,7,0,8,10,25
11/30/2013,12,0,10,0,22
12/1/2013,4,0,7,7,18
12/2/2013,12,0,6,2,20
12/3/2013,10,0,3,5,18
12/4/2013,6,0,7,11,24
12/5/2013,7,0,9,10,26
12/6/2013,7,0,6,1,14
12/7/2013,4,0,6,1,11
12/8/2013,5,0,8,6,19
12/9/2013,5,0,4,8,17
12/10/2013,10,0,4,2,16
12/11/2013,4,0,5,4,13
12/12/2013,5,0,6,6,17
12/13/2013,4,0,8,4,16
12/14/2013,9,0,2,6,17
12/15/2013,9,0,5,2,16
12/16/2013,8,0,8,11,27
12/17/2013,7,0,3,5,15
12/18/2013,9,0,9,6,24
12/19/2013,11,0,7,7,25
12/20/2013,11,0,6,10,27
12/21/2013,11,0,5,1,17
12/22/2013,10,0,8,5,23
12/23/2013,12,0,3,11,26
12/24/2013,6,0,2,5,13
12/25/2013,6,0,8,4,18
12/26/2013,5,0,2,8,15
12/27/2013,9,0,5,2,16
12/28/2013,9,0,3,10,22
12/29/2013,5,0,2,11,18
12/30/2013,5,0,3,4,12
12/31/2013,9,0,9,8,26
1/1/2014,6,0,2,2,10
1/2/2014,10,0,8,3,21
1/3/2014,10,0,6,4,20
1/4/2014,4,0,2,2,8
1/5/2014,7,0,3,8,18
1/6/2014,10,0,8,8,26
1/7/2014,10,0,5,0,15
1/8/2014,12,0,5,0,17
1/9/2014,10,0,7,4,21
1/10/2014,4,0,10,9,23
1/11/2014,4,0,10,5,19
1/12/2014,5,0,4,10,19
1/13/2014,12,0,7,1,20
1/14/2014,4,0,10,2,16
1/15/2014,8,0,3,2,13
1/16/2014,7,0,5,6,18
1/17/2014,11,0,9,5,25
1/18/2014,11,0,6,4,21
1/19/2014,12,0,10,6,28
1/20/2014,9,0,4,6,19
1/21/2014,10,0,7,0,17
1/22/2014,11,0,10,7,28
1/23/2014,12,0,2,1,15
1/24/2014,4,0,3,4,11
1/25/2014,5,0,3,6,14
1/26/2014,4,0,8,2,14
1/27/2014,11,0,2,2,15
1/28/2014,6,0,2,9,17
1/29/2014,8,0,6,8,22
1/30/2014,11,0,10,1,22
1/31/2014,9,0,2,11,22
2/1/2014,6,0,5,2,13
2/2/2014,6,0,6,10,22
2/3/2014,8,0,4,9,21
2/4/2014,4,0,10,8,22
2/5/2014,6,0,7,2,15
2/6/2014,10,0,6,8,24
2/7/2014,4,0,7,9,20
2/8/2014,6,0,7,5,18
2/9/2014,9,0,3,3,15
2/10/2014,10,0,7,0,17
2/11/2014,6,0,9,11,26
2/12/2014,8,0,2,9,19
2/13/2014,7,0,3,11,21
2/14/2014,12,0,6,11,29
2/15/2014,6,0,7,7,20
2/16/2014,9,0,2,3,14
2/17/2014,11,0,10,0,21
2/18/2014,9,0,5,7,21
2/19/2014,11,0,7,2,20
2/20/2014,4,0,5,8,17
2/21/2014,4,0,5,10,19
2/22/2014,4,0,2,2,8
2/23/2014,11,0,7,9,27
2/24/2014,4,0,7,10,21
2/25/2014,9,0,7,4,20
2/26/2014,10,0,4,8,22
2/27/2014,10,0,3,5,18
2/28/2014,8,0,4,10,22
3/1/2014,9,0,9,8,26
3/2/2014,7,0,9,5,21
3/3/2014,12,0,5,3,20
3/4/2014,11,0,4,4,19
3/5/2014,11,0,9,6,26
3/6/2014,7,0,10,9,26
3/7/2014,9,0,10,6,25
3/8/2014,12,0,9,3,24
3/9/2014,8,0,3,9,20
3/10/2014,9,0,2,9,20
3/11/2014,4,0,4,11,19
3/12/2014,6,0,2,11,19
3/13/2014,12,0,2,7,21
3/14/2014,10,0,4,7,21
3/15/2014,5,0,7,10,22
3/16/2014,6,0,8,5,19
3/17/2014,11,0,7,5,23
3/18/2014,8,0,10,11,29
3/19/2014,9,0,8,11,28
3/20/2014,7,0,8,3,18
3/21/2014,12,0,4,9,25
3/22/2014,12,0,6,2,20
3/23/2014,4,0,8,6,18
3/24/2014,11,0,6,3,20
3/25/2014,9,0,4,10,23
3/26/2014,5,0,7,10,22
3/27/2014,10,0,10,8,28
3/28/2014,6,0,3,4,13
3/29/2014,6,0,8,8,22
3/30/2014,5,0,8,4,17
3/31/2014,12,0,3,0,15
4/1/2014,11,0,8,9,28
4/2/2014,7,0,7,8,22
4/3/2014,4,0,4,8,16
4/4/2014,5,0,7,10,22
4/5/2014,4,0,4,3,11
4/6/2014,8,0,6,9,23
4/7/2014,9,0,7,0,16
4/8/2014,5,0,8,7,20
4/9/2014,12,0,10,7,29
4/10/2014,11,0,2,6,19
4/11/2014,6,0,10,10,26
4/12/2014,12,0,6,2,20
4/13/2014,12,0,3,5,20
4/14/2014,11,0,6,0,17
4/15/2014,12,0,4,0,16
4/16/2014,6,0,6,1,13
4/17/2014,4,0,5,2,11
4/18/2014,11,0,9,0,20
4/19/2014,12,0,6,10,28
4/20/2014,9,0,8,8,25
4/21/2014,9,0,3,1,13
4/22/2014,12,0,8,1,21
4/23/2014,4,0,10,2,16
4/24/2014,12,0,6,8,26
4/25/2014,11,0,10,4,25
4/26/2014,4,0,5,7,16
4/27/2014,12,0,8,2,22
4/28/2014,4,0,7,10,21
4/29/2014,10,0,8,10,28
4/30/2014,8,0,6,8,22
5/1/2014,11,0,7,3,21
5/2/2014,9,0,10,5,24
5/3/2014,8,0,9,5,22
5/4/2014,8,0,6,0,14
5/5/2014,10,0,10,1,21
5/6/2014,6,0,9,0,15
5/7/2014,11,0,4,4,19
5/8/2014,11,0,7,6,24
5/9/2014,4,0,4,3,11
5/10/2014,8,0,3,6,17
5/11/2014,9,0,7,6,22
5/12/2014,10,0,9,8,27
5/13/2014,12,0,7,9,28
5/14/2014,12,0,8,0,20
5/15/2014,6,0,10,9,25
5/16/2014,6,0,3,11,20
5/17/2014,11,0,9,5,25
5/18/2014,4,0,5,4,13
5/19/2014,4,0,8,0,12
5/20/2014,11,0,10,2,23
5/21/2014,12,0,10,2,24
5/22/2014,12,0,4,5,21
5/23/2014,8,0,9,7,24
5/24/2014,4,0,5,5,14
5/25/2014,11,0,10,6,27
5/26/2014,12,0,3,2,17
5/27/2014,7,0,4,9,20
5/28/2014,6,0,5,1,12
5/29/2014,7,0,5,0,12
5/30/2014,9,0,6,0,15
5/31/2014,8,0,5,6,19
6/1/2014,4,0,5,4,13
6/2/2014,4,0,9,1,14
6/3/2014,5,0,2,9,16
6/4/2014,6,0,6,0,12
6/5/2014,5,0,5,1,11
6/6/2014,10,0,10,11,31
6/7/2014,7,0,10,11,28
6/8/2014,11,0,9,9,29
6/9/2014,5,0,10,5,20
6/10/2014,4,0,8,9,21
6/11/2014,9,0,5,3,17
6/12/2014,4,0,2,0,6
6/13/2014,4,0,8,7,19
6/14/2014,10,0,8,4,22
6/15/2014,10,0,6,10,26
6/16/2014,9,0,8,5,22
6/17/2014,8,0,9,4,21
6/18/2014,12,0,6,4,22
6/19/2014,10,0,9,5,24
6/20/2014,8,0,9,8,25
6/21/2014,6,0,7,8,21
6/22/2014,11,0,7,2,20
6/23/2014,4,0,5,4,13
6/24/2014,5,0,3,0,8
6/25/2014,10,0,8,4,22
6/26/2014,7,0,7,0,14
6/27/2014,7,0,3,8,18
6/28/2014,11,0,5,9,25
6/29/2014,8,0,3,8,19
6/30/2014,12,0,5,1,18
7/1/2014,12,0,9,7,28
7/2/2014,7,0,3,6,16
7/3/2014,4,0,5,5,14
7/4/2014,12,0,5,9,26
7/5/2014,11,0,9,4,24
7/6/2014,5,0,7,2,14
7/7/2014,11,0,10,11,32
7/8/2014,8,0,9,11,28
7/9/2014,8,0,5,5,18
7/10/2014,8,0,3,6,17
7/11/2014,11,0,10,6,27
7/12/2014,9,0,2,8,19
7/13/2014,5,0,2,6,13
7/14/2014,6,0,6,5,17
7/15/2014,6,0,2,0,8
7/16/2014,11,0,5,5,21
7/17/2014,12,0,6,10,28
7/18/2014,9,0,6,3,18
7/19/2014,10,0,9,4,23
7/20/2014,6,0,3,8,17
7/21/2014,8,0,8,1,17
7/22/2014,9,0,7,8,24
7/23/2014,6,0,6,9,21
7/24/2014,8,0,3,10,21
7/25/2014,8,0,8,1,17
7/26/2014,7,0,5,11,23
7/27/2014,10,0,5,8,23
7/28/2014,5,0,3,10,18
7/29/2014,7,0,5,8,20
7/30/2014,5,0,4,0,9
7/31/2014,10,0,7,1,18
8/1/2014,5,0,10,1,16
8/2/2014,9,0,2,1,12
8/3/2014,9,0,3,6,18
8/4/2014,8,0,6,11,25
8/5/2014,5,0,6,10,21
8/6/2014,5,0,10,2,17
8/7/2014,4,0,2,1,7
8/8/2014,4,0,9,5,18
8/9/2014,5,0,3,4,12
8/10/2014,9,0,6,5,20
8/11/2014,10,0,4,3,17
8/12/2014,5,0,5,6,16
8/13/2014,9,0,5,0,14
8/14/2014,10,0,2,1,13
8/15/2014,9,0,9,8,26
8/16/2014,6,0,2,5,13
8/17/2014,7,0,6,6,19
8/18/2014,10,0,2,9,21
8/19/2014,12,0,3,2,17
8/20/2014,5,0,7,5,17
8/21/2014,5,0,7,1,13
8/22/2014,9,0,6,4,19
8/23/2014,6,0,5,3,14
8/24/2014,10,0,3,5,18
8/25/2014,11,0,10,11,32
8/26/2014,11,0,7,7,25
8/27/2014,9,0,8,0,17
8/28/2014,8,0,4,2,14
8/29/2014,9,0,7,7,23
8/30/2014,6,0,10,6,22
8/31/2014,9,0,2,1,12
9/1/2014,10,0,2,8,20
9/2/2014,10,0,7,11,28
9/3/2014,9,0,3,4,16
9/4/2014,4,0,6,9,19
9/5/2014,6,0,6,9,21
9/6/2014,12,0,5,2,19
9/7/2014,12,0,7,7,26
9/8/2014,4,0,6,10,20
9/9/2014,7,0,3,6,16
9/10/2014,12,0,2,8,22
9/11/2014,4,0,2,7,13
9/12/2014,11,0,4,9,24
9/13/2014,12,0,7,3,22
9/14/2014,8,0,3,8,19
9/15/2014,10,0,4,8,22
9/16/2014,6,0,2,9,17
9/17/2014,8,0,4,9,21
9/18/2014,10,0,2,9,21
9/19/2014,7,0,7,5,19
9/20/2014,11,0,2,1,14
9/21/2014,11,0,4,8,23
9/22/2014,4,0,6,2,12
9/23/2014,6,0,2,4,12
9/24/2014,8,0,4,8,20
9/25/2014,4,0,6,11,21
9/26/2014,11,0,4,4,19
9/27/2014,5,0,6,4,15
9/28/2014,5,0,5,9,19
9/29/2014,7,0,8,8,23
9/30/2014,4,0,2,5,11
10/1/2014,10,0,5,0,15
10/2/2014,7,0,6,4,17
10/3/2014,9,0,10,3,22
10/4/2014,9,0,4,4,17
10/5/2014,9,0,8,9,26
10/6/2014,12,0,9,9,30
10/7/2014,6,0,8,3,17
10/8/2014,9,0,10,0,19
10/9/2014,7,0,5,2,14
10/10/2014,11,0,4,9,24
10/11/2014,5,0,9,4,18
10/12/2014,6,0,4,9,19
10/13/2014,6,0,6,3,15
10/14/2014,6,0,3,11,20
10/15/2014,4,0,5,11,20
10/16/2014,4,0,7,9,20
10/17/2014,12,0,5,2,19
10/18/2014,7,0,10,8,25
10/19/2014,6,0,3,5,14
10/20/2014,11,0,6,11,28
10/21/2014,10,0,6,2,18
10/22/2014,6,0,7,1,14
10/23/2014,8,0,9,3,20
10/24/2014,11,0,9,11,31
10/25/2014,8,0,5,3,16
10/26/2014,10,0,7,11,28
10/27/2014,7,0,7,11,25
10/28/2014,12,0,9,7,28
10/29/2014,11,0,10,7,28
10/30/2014,6,0,2,7,15
10/31/2014,8,0,6,7,21
11/1/2014,10,0,4,11,25
11/2/2014,5,0,5,7,17
11/3/2014,11,0,2,8,21
11/4/2014,9,0,6,7,22
11/5/2014,5,0,9,6,20
11/6/2014,9,0,3,10,22
11/7/2014,9,0,9,11,29
11/8/2014,7,0,9,0,16
11/9/2014,12,0,5,7,24
11/10/2014,8,0,7,8,23
11/11/2014,11,0,9,7,27
11/12/2014,5,0,8,0,13
11/13/2014,11,0,9,0,20
11/14/2014,11,0,8,5,24
11/15/2014,7,0,6,5,18
11/16/2014,4,0,4,9,17
11/17/2014,5,0,7,7,19
11/18/2014,12,0,2,9,23
11/19/2014,9,0,4,2,15
11/20/2014,11,0,3,11,25
11/21/2014,10,0,5,9,24
11/22/2014,7,0,6,1,14
11/23/2014,5,0,8,10,23
11/24/2014,8,0,5,9,22
11/25/2014,7,0,5,0,12
11/26/2014,10,0,2,5,17
11/27/2014,4,0,2,9,15
11/28/2014,5,0,7,2,14
11/29/2014,12,0,2,2,16
11/30/2014,12,0,5,4,21
12/1/2014,9,0,5,3,17
12/2/2014,7,0,5,5,17
12/3/2014,7,0,7,6,20
12/4/2014,10,0,4,2,16
12/5/2014,5,0,7,11,23
12/6/2014,8,0,9,4,21
12/7/2014,6,0,5,4,15
12/8/2014,8,0,4,11,23
12/9/2014,6,0,6,2,14
12/10/2014,11,0,5,10,26
12/11/2014,8,0,4,1,13
12/12/2014,4,0,9,9,22
12/13/2014,10,0,8,10,28
12/14/2014,11,0,8,11,30
12/15/2014,7,0,9,7,23
12/16/2014,7,0,10,11,28
12/17/2014,11,0,2,9,22
12/18/2014,11,0,3,5,19
12/19/2014,6,0,2,0,8
12/20/2014,9,0,4,3,16
12/21/2014,12,0,5,9,26
12/22/2014,9,0,4,3,16
12/23/2014,7,0,8,11,26
12/24/2014,7,0,8,6,21
12/25/2014,8,0,10,7,25
12/26/2014,4,0,8,1,13
12/27/2014,11,0,8,7,26
12/28/2014,11,0,6,0,17
12/29/2014,12,0,10,1,23
12/30/2014,9,0,2,0,11
12/31/2014,10,0,2,1,13
1/1/2015,6,0,8,10,24
1/2/2015,11,0,5,10,26
1/3/2015,5,0,3,4,12
1/4/2015,5,0,7,0,12
1/5/2015,11,0,4,8,23
1/6/2015,9,0,3,4,16
1/7/2015,12,0,10,7,29
1/8/2015,8,0,8,11,27
1/9/2015,9,0,10,3,22
1/10/2015,8,0,5,3,16
1/11/2015,12,0,8,5,25
1/12/2015,4,0,3,3,10
1/13/2015,10,0,9,4,23
1/14/2015,7,0,9,7,23
1/15/2015,7,0,6,3,16
1/16/2015,6,0,3,10,19
1/17/2015,7,0,9,8,24
1/18/2015,12,0,8,10,30
1/19/2015,11,0,5,9,25
1/20/2015,12,0,8,2,22
1/21/2015,9,0,6,2,17
1/22/2015,10,0,10,10,30
1/23/2015,9,0,5,7,21
1/24/2015,5,0,7,7,19
1/25/2015,5,0,2,0,7
1/26/2015,6,0,7,7,20
1/27/2015,5,0,5,4,14
1/28/2015,5,0,2,0,7
1/29/2015,10,0,7,3,20
1/30/2015,8,0,7,3,18
1/31/2015,10,0,4,7,21
2/1/2015,10,0,10,4,24
2/2/2015,9,0,3,11,23
2/3/2015,8,0,2,8,18
2/4/2015,12,0,10,6,28
2/5/2015,10,0,8,5,23
2/6/2015,11,0,7,4,22
2/7/2015,8,0,6,2,16
2/8/2015,10,0,10,6,26
2/9/2015,9,0,8,2,19
2/10/2015,5,0,4,7,16
2/11/2015,6,0,10,5,21
2/12/2015,12,0,9,6,27
2/13/2015,4,0,7,1,12
2/14/2015,11,0,5,10,26
2/15/2015,5,0,2,3,10
2/16/2015,7,0,8,7,22
2/17/2015,6,0,3,11,20
2/18/2015,10,0,7,3,20
2/19/2015,7,0,6,1,14
2/20/2015,7,0,10,10,27
2/21/2015,9,0,8,9,26
2/22/2015,10,0,9,8,27
2/23/2015,5,0,10,1,16
2/24/2015,6,0,10,2,18
2/25/2015,12,0,9,5,26
2/26/2015,8,0,8,5,21
2/27/2015,9,0,4,7,20
2/28/2015,11,0,2,5,18
3/1/2015,11,0,2,10,23
3/2/2015,9,0,5,4,18
3/3/2015,11,0,8,10,29
3/4/2015,5,0,3,4,12
3/5/2015,12,0,4,1,17
3/6/2015,11,0,3,6,20
3/7/2015,12,0,4,8,24
3/8/2015,4,0,5,7,16
3/9/2015,7,0,7,0,14
3/10/2015,7,0,5,9,21
3/11/2015,5,0,6,7,18
3/12/2015,7,0,5,3,15
3/13/2015,7,0,9,7,23
3/14/2015,5,0,5,10,20
3/15/2015,8,0,10,6,24
3/16/2015,10,0,6,4,20
3/17/2015,9,0,5,9,23
3/18/2015,6,0,6,7,19
3/19/2015,8,0,6,2,16
3/20/2015,4,0,10,3,17
3/21/2015,11,0,2,0,13
3/22/2015,5,0,3,10,18
3/23/2015,6,0,7,5,18
3/24/2015,5,0,9,4,18
3/25/2015,9,0,7,10,26
3/26/2015,10,0,3,4,17
3/27/2015,11,0,5,5,21
3/28/2015,5,0,7,1,13
3/29/2015,10,0,9,4,23
3/30/2015,6,0,7,10,23
3/31/2015,8,0,2,6,16
4/1/2015,5,0,9,9,23
4/2/2015,5,0,2,5,12
4/3/2015,12,0,6,6,24
4/4/2015,6,0,5,0,11
4/5/2015,11,0,4,6,21
4/6/2015,7,0,2,7,16
4/7/2015,7,0,9,6,22
4/8/2015,5,0,2,6,13
4/9/2015,8,0,10,9,27
4/10/2015,11,0,2,11,24
4/11/2015,4,0,5,1,10
4/12/2015,5,0,10,10,25
4/13/2015,9,0,10,0,19
4/14/2015,11,0,2,10,23
4/15/2015,10,0,2,7,19
4/16/2015,9,0,9,4,22
4/17/2015,12,0,9,11,32
4/18/2015,5,0,9,7,21
4/19/2015,12,0,3,9,24
4/20/2015,10,0,5,10,25
4/21/2015,4,0,9,4,17
4/22/2015,5,0,10,6,21
4/23/2015,10,0,9,4,23
4/24/2015,6,0,2,8,16
4/25/2015,11,0,9,2,22
4/26/2015,9,0,10,1,20
4/27/2015,4,0,8,5,17
4/28/2015,10,0,7,6,23
4/29/2015,7,0,8,2,17
4/30/2015,8,0,9,3,20
5/1/2015,9,0,3,1,13
5/2/2015,9,0,6,8,23
5/3/2015,11,0,2,5,18
5/4/2015,5,0,5,7,17
5/5/2015,6,0,3,8,17
5/6/2015,9,0,10,6,25
5/7/2015,5,0,2,9,16
5/8/2015,12,0,9,6,27
5/9/2015,8,0,9,2,19
5/10/2015,12,0,3,0,15
5/11/2015,12,0,2,10,24
5/12/2015,9,0,5,2,16
5/13/2015,8,0,6,9,23
5/14/2015,7,0,8,8,23
5/15/2015,8,0,7,7,22
5/16/2015,12,0,7,5,24
5/17/2015,5,0,5,10,20
5/18/2015,8,0,4,10,22
5/19/2015,8,0,3,7,18
5/20/2015,11,0,8,4,23
5/21/2015,6,0,10,0,16
5/22/2015,11,0,5,9,25
5/23/2015,10,0,3,8,21
5/24/2015,8,0,10,6,24
5/25/2015,12,0,8,9,29
5/26/2015,8,0,5,4,17
5/27/2015,10,0,4,5,19
5/28/2015,7,0,7,3,17
5/29/2015,5,0,5,6,16
5/30/2015,11,0,4,6,21
5/31/2015,8,0,2,8,18
6/1/2015,10,0,3,9,22
6/2/2015,10,0,6,2,18
6/3/2015,9,0,8,11,28
6/4/2015,8,0,8,1,17
6/5/2015,5,0,2,4,11
6/6/2015,7,0,9,11,27
6/7/2015,4,0,6,2,12
6/8/2015,4,0,10,0,14
6/9/2015,9,0,7,6,22
6/10/2015,11,0,5,5,21
6/11/2015,11,0,3,9,23
6/12/2015,6,0,7,4,17
6/13/2015,8,0,8,9,25
6/14/2015,10,0,8,7,25
6/15/2015,10,0,5,3,18
6/16/2015,12,0,7,8,27
6/17/2015,4,0,6,7,17
6/18/2015,8,0,7,5,20
6/19/2015,5,0,3,0,8
6/20/2015,4,0,10,7,21
6/21/2015,5,0,6,11,22
6/22/2015,4,0,9,4,17
6/23/2015,6,0,8,8,22
6/24/2015,11,0,6,7,24
6/25/2015,8,0,8,11,27
6/26/2015,4,0,2,8,14
6/27/2015,12,0,10,11,33
6/28/2015,8,0,10,0,18
6/29/2015,11,0,2,2,15
6/30/2015,6,0,6,11,23
7/1/2015,4,0,2,4,10
7/2/2015,7,0,7,6,20
7/3/2015,7,0,8,10,25
7/4/2015,4,0,7,5,16
7/5/2015,5,0,8,7,20
7/6/2015,10,0,2,5,17
7/7/2015,11,0,9,0,20
7/8/2015,5,0,6,6,17
7/9/2015,11,0,2,9,22
7/10/2015,10,0,10,1,21
7/11/2015,12,0,3,5,20
7/12/2015,5,0,6,4,15
7/13/2015,11,0,2,9,22
7/14/2015,9,0,7,11,27
7/15/2015,5,0,10,2,17
7/16/2015,10,0,2,0,12
7/17/2015,6,0,4,6,16
7/18/2015,10,0,3,6,19
7/19/2015,9,0,6,9,24
7/20/2015,11,0,10,0,21
7/21/2015,12,0,5,10,27
7/22/2015,4,0,9,11,24
7/23/2015,9,0,4,7,20
7/24/2015,7,0,6,2,15
7/25/2015,8,0,9,11,28
7/26/2015,5,0,2,5,12
7/27/2015,12,0,9,4,25
7/28/2015,7,0,7,9,23
7/29/2015,11,0,2,5,18
7/30/2015,4,0,3,10,17
7/31/2015,11,0,3,8,22
8/1/2015,4,0,9,0,13
8/2/2015,10,0,9,9,28
8/3/2015,9,0,4,2,15
8/4/2015,11,0,6,2,19
8/5/2015,10,0,10,1,21
8/6/2015,5,0,3,10,18
8/7/2015,6,0,10,1,17
8/8/2015,8,0,3,11,22
8/9/2015,10,0,8,2,20
8/10/2015,11,0,9,1,21
8/11/2015,10,0,5,1,16
8/12/2015,10,0,8,0,18
8/13/2015,9,0,7,11,27
8/14/2015,6,0,9,11,26
8/15/2015,10,0,6,4,20
8/16/2015,8,0,8,9,25
8/17/2015,12,0,4,8,24
8/18/2015,6,0,6,11,23
8/19/2015,10,0,8,4,22
8/20/2015,12,0,8,11,31
8/21/2015,7,0,6,0,13
8/22/2015,5,0,3,3,11
8/23/2015,7,0,8,11,26
8/24/2015,6,0,10,11,27
8/25/2015,11,0,9,11,31
8/26/2015,11,0,5,5,21
8/27/2015,12,0,2,10,24
8/28/2015,7,0,7,2,16
8/29/2015,5,0,7,9,21
8/30/2015,11,0,7,7,25
8/31/2015,7,0,6,7,20
9/1/2015,5,0,6,10,21
9/2/2015,4,0,7,9,20
9/3/2015,12,0,2,9,23
9/4/2015,4,0,5,10,19
9/5/2015,12,0,7,6,25
9/6/2015,5,0,8,1,14
9/7/2015,9,0,3,3,15
9/8/2015,5,0,4,6,15
9/9/2015,5,0,7,2,14
9/10/2015,12,0,8,2,22
9/11/2015,12,0,7,4,23
9/12/2015,5,0,9,0,14
9/13/2015,9,0,3,4,16
9/14/2015,6,0,10,5,21
9/15/2015,4,0,7,7,18
9/16/2015,8,0,9,8,25
9/17/2015,8,0,10,7,25
9/18/2015,5,0,10,7,22
9/19/2015,7,0,9,5,21
9/20/2015,5,0,5,8,18
9/21/2015,9,0,9,5,23
9/22/2015,10,0,10,2,22
9/23/2015,10,0,9,6,25
9/24/2015,10,0,6,6,22
9/25/2015,6,0,9,9,24
9/26/2015,11,0,8,11,30
9/27/2015,8,0,8,10,26
9/28/2015,9,0,7,10,26
9/29/2015,7,0,3,5,15
9/30/2015,7,0,7,11,25
10/1/2015,10,0,6,5,21
10/2/2015,11,0,9,7,27
10/3/2015,11,0,8,10,29
10/4/2015,8,0,8,2,18
10/5/2015,8,0,8,5,21
10/6/2015,4,0,5,5,14
10/7/2015,12,0,10,10,32
10/8/2015,4,0,6,7,17
10/9/2015,4,0,7,3,14
10/10/2015,8,0,9,3,20
10/11/2015,12,0,6,2,20
10/12/2015,9,0,8,1,18
10/13/2015,7,0,8,5,20
10/14/2015,6,0,9,6,21
10/15/2015,4,0,9,8,21
10/16/2015,7,0,8,5,20
10/17/2015,11,0,10,7,28
10/18/2015,4,0,7,11,22
10/19/2015,10,0,4,7,21
10/20/2015,10,0,5,8,23
10/21/2015,10,0,3,11,24
10/22/2015,12,0,2,5,19
10/23/2015,11,0,8,3,22
10/24/2015,5,0,2,2,9
10/25/2015,7,0,6,6,19
10/26/2015,4,0,2,3,9
10/27/2015,4,0,2,3,9
10/28/2015,4,0,9,4,17
10/29/2015,7,0,6,10,23
10/30/2015,4,0,7,9,20
10/31/2015,10,0,9,6,25
11/1/2015,11,0,10,4,25
11/2/2015,12,0,7,11,30
11/3/2015,4,0,9,1,14
11/4/2015,6,0,9,1,16
11/5/2015,12,0,2,0,14
11/6/2015,10,0,6,5,21
11/7/2015,10,0,8,5,23
11/8/2015,12,0,5,0,17
11/9/2015,6,0,5,8,19
11/10/2015,8,0,10,1,19
11/11/2015,6,0,7,1,14
11/12/2015,7,0,5,1,13
11/13/2015,4,0,8,2,14
11/14/2015,8,0,4,8,20
11/15/2015,12,0,10,0,22
11/16/2015,9,0,4,10,23
11/17/2015,7,0,7,0,14
11/18/2015,5,0,3,0,8
11/19/2015,6,0,7,4,17
11/20/2015,7,0,4,3,14
11/21/2015,11,0,7,3,21
11/22/2015,12,0,3,10,25
11/23/2015,4,0,7,7,18
11/24/2015,11,0,10,9,30
11/25/2015,10,0,8,8,26
11/26/2015,4,0,9,6,19
11/27/2015,9,0,9,5,23
11/28/2015,9,0,5,10,24
11/29/2015,4,0,2,1,7
11/30/2015,7,0,8,11,26
12/1/2015,12,0,7,1,20
12/2/2015,10,0,3,0,13
12/3/2015,6,0,8,3,17
12/4/2015,12,0,6,7,25
12/5/2015,6,0,8,11,25
12/6/2015,6,0,2,3,11
12/7/2015,8,0,8,11,27
12/8/2015,8,0,9,10,27
12/9/2015,4,0,3,6,13
12/10/2015,4,0,9,3,16
12/11/2015,10,0,10,7,27
12/12/2015,6,0,5,7,18
12/13/2015,12,0,4,1,17
12/14/2015,12,0,10,9,31
12/15/2015,11,0,8,7,26
12/16/2015,12,0,4,2,18
12/17/2015,12,0,7,7,26
12/18/2015,8,0,3,7,18
12/19/2015,7,0,10,5,22
12/20/2015,10,0,10,6,26
12/21/2015,8,0,2,3,13
12/22/2015,9,0,6,7,22
12/23/2015,4,0,7,2,13
12/24/2015,8,0,4,1,13
12/25/2015,4,0,6,1,11
12/26/2015,6,0,7,2,15
12/27/2015,5,0,10,5,20
12/28/2015,4,0,7,10,21
12/29/2015,8,0,4,0,12
12/30/2015,12,0,7,8,27
12/31/2015,5,0,6,5,16
1/1/2016,7,0,7,3,17
1/2/2016,6,0,6,4,16
1/3/2016,5,0,3,7,15
1/4/2016,11,0,8,0,19
1/5/2016,4,0,7,9,20
1/6/2016,6,0,9,8,23
1/7/2016,7,0,6,8,21
1/8/2016,12,0,5,3,20
1/9/2016,4,0,6,1,11
1/10/2016,12,0,3,6,21
1/11/2016,6,0,5,2,13
1/12/2016,7,0,6,2,15
1/13/2016,7,0,7,11,25
1/14/2016,12,0,5,1,18
1/15/2016,11,0,4,3,18
1/16/2016,5,0,10,8,23
1/17/2016,12,0,2,4,18
1/18/2016,10,0,10,3,23
1/19/2016,6,0,9,10,25
1/20/2016,5,0,5,0,10
1/21/2016,12,0,2,6,20
1/22/2016,8,0,10,11,29
1/23/2016,10,0,3,1,14
1/24/2016,9,0,8,6,23
1/25/2016,12,0,7,2,21
1/26/2016,12,0,2,7,21
1/27/2016,12,0,2,8,22
1/28/2016,7,0,9,11,27
1/29/2016,12,0,10,6,28
1/30/2016,9,0,5,6,20
1/31/2016,7,0,7,6,20
2/1/2016,7,0,10,11,28
2/2/2016,6,0,8,7,21
2/3/2016,5,0,4,6,15
2/4/2016,4,0,9,3,16
2/5/2016,5,0,3,4,12
2/6/2016,6,0,10,1,17
2/7/2016,10,0,5,0,15
2/8/2016,6,0,6,1,13
2/9/2016,11,0,9,10,30
2/10/2016,8,0,5,6,19
2/11/2016,10,0,3,7,20
2/12/2016,11,0,7,8,26
2/13/2016,7,0,9,7,23
2/14/2016,12,0,4,10,26
2/15/2016,12,0,10,5,27
2/16/2016,12,0,3,4,19
2/17/2016,4,0,5,6,15
2/18/2016,6,0,5,2,13
2/19/2016,12,0,6,9,27
2/20/2016,12,0,7,9,28
2/21/2016,4,0,5,7,16
2/22/2016,11,0,3,9,23
2/23/2016,7,0,10,7,24
2/24/2016,4,0,10,5,19
2/25/2016,12,0,8,5,25
2/26/2016,5,0,10,4,19
2/27/2016,10,0,7,0,17
2/28/2016,10,0,4,8,22
2/29/2016,10,0,2,4,16
3/1/2016,4,0,2,5,11
3/2/2016,5,0,4,5,14
3/3/2016,12,0,9,8,29
3/4/2016,10,0,7,2,19
3/5/2016,10,0,7,1,18
3/6/2016,10,0,7,2,19
3/7/2016,4,0,10,8,22
3/8/2016,8,0,9,5,22
3/9/2016,11,0,8,8,27
3/10/2016,8,0,8,7,23
3/11/2016,5,0,8,1,14
3/12/2016,10,0,9,2,21
3/13/2016,12,0,7,0,19
3/14/2016,5,0,6,7,18
3/15/2016,7,0,7,11,25
3/16/2016,12,0,2,6,20
3/17/2016,6,0,5,3,14
3/18/2016,11,0,2,0,13
3/19/2016,11,0,2,4,17
3/20/2016,5,0,9,7,21
3/21/2016,12,0,7,3,22
3/22/2016,7,0,10,4,21
3/23/2016,7,0,9,5,21
3/24/2016,7,0,3,4,14
3/25/2016,4,0,9,9,22
3/26/2016,8,0,6,4,18
3/27/2016,8,0,6,8,22
3/28/2016,6,0,8,11,25
3/29/2016,4,0,9,2,15
3/30/2016,6,0,6,6,18
3/31/2016,4,0,6,2,12
4/1/2016,8,0,4,7,19
4/2/2016,9,0,5,1,15
4/3/2016,11,0,7,6,24
4/4/2016,10,0,4,5,19
4/5/2016,11,0,9,2,22
4/6/2016,6,0,10,4,20
4/7/2016,4,0,3,3,10
4/8/2016,7,0,6,7,20
4/9/2016,6,0,7,10,23
4/10/2016,9,0,8,6,23
4/11/2016,11,0,8,2,21
4/12/2016,7,0,6,1,14
4/13/2016,9,0,3,9,21
4/14/2016,8,0,5,5,18
4/15/2016,5,0,2,6,13
4/16/2016,6,0,5,11,22
4/17/2016,11,0,3,11,25
4/18/2016,8,0,2,0,10
4/19/2016,9,0,6,6,21
4/20/2016,7,0,2,0,9
4/21/2016,11,0,10,1,22
4/22/2016,9,0,3,1,13
4/23/2016,4,0,6,5,15
4/24/2016,7,0,7,8,22
4/25/2016,10,0,4,8,22
4/26/2016,7,0,7,2,16
4/27/2016,4,0,4,1,9
4/28/2016,12,0,2,9,23
4/29/2016,10,0,7,2,19
4/30/2016,6,0,2,4,12
5/1/2016,12,0,6,8,26
5/2/2016,9,0,3,4,16
5/3/2016,10,0,6,11,27
5/4/2016,9,0,3,7,19
5/5/2016,4,0,10,5,19
5/6/2016,12,0,4,6,22
5/7/2016,7,0,4,7,18
5/8/2016,11,0,7,9,27
5/9/2016,10,0,5,9,24
5/10/2016,9,0,4,8,21
5/11/2016,7,0,8,8,23
5/12/2016,12,0,10,1,23
5/13/2016,9,0,5,9,23
5/14/2016,6,0,10,11,27
5/15/2016,12,0,4,8,24
5/16/2016,6,0,3,6,15
5/17/2016,9,0,9,5,23
5/18/2016,11,0,8,9,28
5/19/2016,8,0,7,9,24
5/20/2016,11,0,9,6,26
5/21/2016,10,0,9,3,22
5/22/2016,7,0,10,4,21
5/23/2016,10,0,5,9,24
5/24/2016,6,0,9,5,20
5/25/2016,5,0,4,8,17
5/26/2016,11,0,3,11,25
5/27/2016,12,0,7,7,26
5/28/2016,10,0,6,9,25
5/29/2016,7,0,3,11,21
5/30/2016,10,0,8,7,25
5/31/2016,11,0,6,11,28
6/1/2016,5,0,7,10,22
6/2/2016,12,0,2,10,24
6/3/2016,10,0,8,2,20
6/4/2016,9,0,8,6,23
6/5/2016,11,0,7,4,22
6/6/2016,7,0,5,11,23
6/7/2016,6,0,2,5,13
6/8/2016,6,0,3,5,14
6/9/2016,5,0,5,11,21
6/10/2016,7,0,2,10,19
6/11/2016,12,0,10,7,29
6/12/2016,6,0,2,8,16
6/13/2016,7,0,8,5,20
6/14/2016,11,0,9,5,25
6/15/2016,11,0,9,6,26
6/16/2016,4,0,5,5,14
6/17/2016,5,0,3,9,17
6/18/2016,8,0,9,3,20
6/19/2016,4,0,4,7,15
6/20/2016,8,0,3,11,22
6/21/2016,7,0,10,7,24
6/22/2016,9,0,7,1,17
6/23/2016,7,0,10,11,28
6/24/2016,9,0,8,2,19
6/25/2016,6,0,5,0,11
6/26/2016,9,0,9,5,23
6/27/2016,8,0,10,8,26
6/28/2016,4,0,9,4,17
6/29/2016,7,0,2,3,12
6/30/2016,5,0,7,1,13
7/1/2016,4,0,6,0,10
7/2/2016,7,0,5,7,19
7/3/2016,9,0,3,4,16
7/4/2016,5,0,10,11,26
7/5/2016,6,0,5,10,21
7/6/2016,10,0,7,7,24
7/7/2016,9,0,5,3,17
7/8/2016,4,0,10,8,22
7/9/2016,8,0,5,8,21
7/10/2016,12,0,10,5,27
7/11/2016,12,0,8,10,30
7/12/2016,11,0,9,1,21
7/13/2016,4,0,7,1,12
7/14/2016,8,0,4,0,12
7/15/2016,5,0,8,9,22
7/16/2016,8,0,8,8,24
7/17/2016,8,0,5,11,24
7/18/2016,7,0,10,9,26
7/19/2016,6,0,10,5,21
7/20/2016,9,0,10,10,29
7/21/2016,11,0,10,11,32
7/22/2016,11,0,9,2,22
7/23/2016,12,0,5,8,25
7/24/2016,12,0,4,6,22
7/25/2016,12,0,2,6,20
7/26/2016,12,0,5,10,27
7/27/2016,10,0,7,5,22
7/28/2016,12,0,5,11,28
7/29/2016,10,0,6,0,16
7/30/2016,11,0,10,3,24
7/31/2016,10,0,10,5,25
8/1/2016,6,0,3,11,20
8/2/2016,12,0,2,9,23
8/3/2016,11,0,8,2,21
8/4/2016,4,0,8,8,20
8/5/2016,7,0,5,6,18
8/6/2016,12,0,9,6,27
8/7/2016,9,0,9,9,27
8/8/2016,4,0,2,9,15
8/9/2016,8,0,5,7,20
8/10/2016,10,0,9,10,29
8/11/2016,4,0,3,10,17
8/12/2016,6,0,2,5,13
8/13/2016,9,0,10,3,22
8/14/2016,8,0,5,2,15
8/15/2016,7,0,3,4,14
8/16/2016,8,0,2,11,21
8/17/2016,11,0,7,5,23
8/18/2016,8,0,7,7,22
8/19/2016,8,0,2,10,20
8/20/2016,8,0,9,1,18
8/21/2016,9,0,4,4,17
8/22/2016,5,0,9,4,18
8/23/2016,11,0,10,5,26
8/24/2016,4,0,2,9,15
8/25/2016,10,0,3,4,17
8/26/2016,9,0,10,3,22
8/27/2016,7,0,9,4,20
8/28/2016,4,0,10,5,19
8/29/2016,5,0,2,10,17
8/30/2016,5,0,3,2,10
8/31/2016,12,0,5,0,17
9/1/2016,12,0,10,11,33
9/2/2016,8,0,6,10,24
9/3/2016,9,0,8,2,19
9/4/2016,6,0,6,4,16
9/5/2016,10,0,10,11,31
9/6/2016,8,0,4,9,21
9/7/2016,8,0,3,3,14
9/8/2016,6,0,3,5,14
9/9/2016,11,0,5,4,20
9/10/2016,4,0,10,1,15
9/11/2016,8,0,2,3,13
9/12/2016,9,0,9,5,23
9/13/2016,4,0,5,8,17
9/14/2016,11,0,5,2,18
9/15/2016,10,0,6,2,18
9/16/2016,6,0,6,6,18
9/17/2016,7,0,2,4,13
9/18/2016,5,0,8,8,21
9/19/2016,10,0,6,3,19
9/20/2016,8,0,7,0,15
9/21/2016,11,0,7,9,27
9/22/2016,10,0,8,4,22
9/23/2016,8,0,6,7,21
9/24/2016,9,0,10,2,21
9/25/2016,5,0,4,9,18
9/26/2016,9,0,10,7,26
9/27/2016,10,0,6,8,24
9/28/2016,10,0,5,5,20
9/29/2016,10,0,7,10,27
9/30/2016,6,0,2,6,14
10/1/2016,12,0,8,1,21
10/2/2016,11,0,10,4,25
10/3/2016,9,0,2,1,12
10/4/2016,10,0,5,9,24
10/5/2016,7,0,5,6,18
10/6/2016,4,0,7,11,22
10/7/2016,10,0,8,11,29
10/8/2016,12,0,4,3,19
10/9/2016,7,0,10,0,17
10/10/2016,9,0,7,1,17
10/11/2016,10,0,8,2,20
10/12/2016,7,0,7,2,16
10/13/2016,4,0,2,8,14
10/14/2016,10,0,9,4,23
10/15/2016,4,0,2,10,16
10/16/2016,6,0,8,4,18
10/17/2016,11,0,7,2,20
10/18/2016,7,0,7,6,20
10/19/2016,5,0,4,10,19
10/20/2016,11,0,4,7,22
10/21/2016,6,0,9,11,26
10/22/2016,5,0,8,5,18
10/23/2016,6,0,7,10,23
10/24/2016,10,0,6,3,19
10/25/2016,4,0,6,8,18
10/26/2016,8,0,2,11,21
10/27/2016,7,0,4,1,12
10/28/2016,10,0,4,11,25
10/29/2016,7,0,5,7,19
10/30/2016,4,0,3,2,9
10/31/2016,10,0,7,2,19
11/1/2016,4,0,9,1,14
11/2/2016,9,0,6,5,20
11/3/2016,6,0,6,2,14
11/4/2016,8,0,3,3,14
11/5/2016,8,0,7,2,17
11/6/2016,11,0,9,11,31
11/7/2016,9,0,9,10,28
11/8/2016,10,0,7,3,20
11/9/2016,12,0,7,1,20
11/10/2016,9,0,2,2,13
11/11/2016,7,0,10,7,24
11/12/2016,5,0,8,9,22
11/13/2016,10,0,2,4,16
11/14/2016,7,0,3,5,15
11/15/2016,7,0,4,2,13
11/16/2016,6,0,10,1,17
11/17/2016,7,0,4,0,11
11/18/2016,11,0,8,6,25
11/19/2016,4,0,8,6,18
11/20/2016,11,0,2,1,14
11/21/2016,4,0,7,8,19
11/22/2016,6,0,8,10,24
11/23/2016,9,0,4,1,14
11/24/2016,4,0,2,7,13
11/25/2016,9,0,2,4,15
11/26/2016,6,0,4,6,16
11/27/2016,5,0,7,4,16
11/28/2016,6,0,10,5,21
11/29/2016,5,0,2,9,16
11/30/2016,11,0,8,1,20
12/1/2016,11,0,5,0,16
12/2/2016,12,0,8,7,27
12/3/2016,12,0,8,1,21
12/4/2016,6,0,7,1,14
12/5/2016,10,0,4,6,20
12/6/2016,10,0,6,8,24
12/7/2016,6,0,10,9,25
12/8/2016,7,0,5,3,15
12/9/2016,11,0,10,6,27
12/10/2016,5,0,2,9,16
12/11/2016,11,0,2,1,14
12/12/2016,7,0,2,1,10
12/13/2016,4,0,9,8,21
12/14/2016,8,0,10,8,26
12/15/2016,11,0,2,4,17
12/16/2016,6,0,9,0,15
12/17/2016,5,0,5,6,16
12/18/2016,8,0,3,4,15
12/19/2016,7,0,8,5,20
12/20/2016,4,0,9,0,13
12/21/2016,10,0,3,11,24
12/22/2016,7,0,7,7,21
12/23/2016,5,0,2,3,10
12/24/2016,8,0,10,8,26
12/25/2016,9,0,9,6,24
12/26/2016,4,0,10,5,19
12/27/2016,11,0,9,0,20
12/28/2016,6,0,2,3,11
12/29/2016,7,0,8,9,24
12/30/2016,8,0,4,9,21
12/31/2016,11,0,5,4,20
1/1/2017,10,0,5,2,17
1/2/2017,7,0,4,7,18
1/3/2017,6,0,6,10,22
1/4/2017,7,0,6,9,22
1/5/2017,11,0,4,11,26
1/6/2017,7,0,3,2,12
1/7/2017,6,0,5,1,12
1/8/2017,6,0,6,0,12
1/9/2017,6,0,3,11,20
1/10/2017,5,0,6,8,19
1/11/2017,10,0,6,1,17
1/12/2017,11,0,8,8,27
1/13/2017,10,0,3,9,22
1/14/2017,5,0,9,4,18
1/15/2017,7,0,3,5,15
1/16/2017,5,0,6,9,20
1/17/2017,5,0,3,8,16
1/18/2017,6,0,6,5,17
1/19/2017,6,0,10,7,23
1/20/2017,4,0,8,1,13
1/21/2017,12,0,3,0,15
1/22/2017,12,0,10,10,32
1/23/2017,7,0,5,3,15
1/24/2017,11,0,8,10,29
1/25/2017,5,0,6,4,15
1/26/2017,10,0,8,11,29
1/27/2017,7,0,6,3,16
1/28/2017,11,0,3,5,19
1/29/2017,7,0,2,4,13
1/30/2017,10,0,10,7,27
1/31/2017,11,0,9,5,25
2/1/2017,8,0,9,10,27
2/2/2017,6,0,2,1,9
2/3/2017,10,0,7,8,25
2/4/2017,7,0,2,9,18
2/5/2017,5,0,4,2,11
2/6/2017,12,0,9,1,22
2/7/2017,8,0,3,8,19
2/8/2017,12,0,3,11,26
2/9/2017,10,0,2,10,22
2/10/2017,6,0,5,7,18
2/11/2017,10,0,8,8,26
2/12/2017,11,0,9,0,20
2/13/2017,8,0,2,10,20
2/14/2017,9,0,5,6,20
2/15/2017,6,0,5,3,14
2/16/2017,9,0,7,3,19
2/17/2017,5,0,7,0,12
2/18/2017,8,0,4,6,18
2/19/2017,10,0,6,4,20
2/20/2017,11,0,8,8,27
2/21/2017,4,0,4,2,10
2/22/2017,9,0,6,7,22
2/23/2017,11,0,3,10,24
2/24/2017,5,0,9,3,17
2/25/2017,4,0,2,0,6
2/26/2017,12,0,9,5,26
2/27/2017,11,0,3,9,23
2/28/2017,4,0,2,6,12
3/1/2017,5,0,5,10,20
3/2/2017,7,0,7,10,24
3/3/2017,10,0,8,4,22
3/4/2017,6,0,8,1,15
3/5/2017,4,0,6,5,15
3/6/2017,6,0,5,8,19
3/7/2017,6,0,2,8,16
3/8/2017,10,0,8,8,26
3/9/2017,12,0,8,1,21
3/10/2017,8,0,4,9,21
3/11/2017,5,0,5,8,18
3/12/2017,9,0,10,6,25
3/13/2017,9,0,5,6,20
3/14/2017,4,0,10,4,18
3/15/2017,6,0,7,8,21
3/16/2017,12,0,6,6,24
3/17/2017,10,0,8,4,22
3/18/2017,8,0,8,10,26
3/19/2017,5,0,2,7,14
3/20/2017,6,0,7,8,21
3/21/2017,11,0,7,6,24
3/22/2017,6,0,10,6,22
3/23/2017,7,0,10,1,18
3/24/2017,9,0,10,0,19
3/25/2017,4,0,5,4,13
3/26/2017,6,0,9,9,24
3/27/2017,5,0,8,4,17
3/28/2017,8,0,2,3,13
3/29/2017,11,0,6,3,20
3/30/2017,4,0,7,5,16
3/31/2017,12,0,7,5,24
4/1/2017,8,0,5,10,23
4/2/2017,8,0,5,3,16
4/3/2017,4,0,10,7,21
4/4/2017,5,0,7,7,19
4/5/2017,6,0,10,0,16
4/6/2017,12,0,7,4,23
4/7/2017,10,0,10,10,30
4/8/2017,10,0,2,5,17
4/9/2017,12,0,7,8,27
4/10/2017,8,0,7,10,25
4/11/2017,12,0,2,5,19
4/12/2017,10,0,2,5,17
4/13/2017,10,0,8,6,24
4/14/2017,9,0,5,7,21
4/15/2017,12,0,2,10,24
4/16/2017,12,0,4,4,20
4/17/2017,5,0,10,4,19
4/18/2017,10,0,6,11,27
4/19/2017,11,0,2,5,18
4/20/2017,12,0,3,6,21
4/21/2017,12,0,7,7,26
4/22/2017,11,0,6,4,21
4/23/2017,5,0,8,11,24
4/24/2017,8,0,4,7,19
4/25/2017,12,0,2,5,19
4/26/2017,12,0,7,8,27
4/27/2017,5,0,8,2,15
4/28/2017,7,0,10,1,18
4/29/2017,12,0,7,2,21
4/30/2017,8,0,6,9,23
5/1/2017,12,0,10,10,32
5/2/2017,6,0,3,4,13
5/3/2017,4,0,10,10,24
5/4/2017,8,0,8,1,17
5/5/2017,8,0,2,5,15
5/6/2017,4,0,8,7,19
5/7/2017,5,0,3,9,17
5/8/2017,4,0,9,5,18
5/9/2017,7,0,10,7,24
5/10/2017,12,0,10,9,31
5/11/2017,11,0,4,5,20
5/12/2017,10,0,5,10,25
5/13/2017,6,0,7,2,15
5/14/2017,10,0,9,2,21
5/15/2017,12,0,9,4,25
5/16/2017,12,0,9,3,24
5/17/2017,10,0,8,10,28
5/18/2017,5,0,10,0,15
5/19/2017,9,0,6,7,22
5/20/2017,8,0,10,8,26
5/21/2017,5,0,4,5,14
5/22/2017,7,0,7,8,22
5/23/2017,4,0,9,0,13
5/24/2017,6,0,2,1,9
5/25/2017,10,0,10,7,27
5/26/2017,9,0,3,2,14
5/27/2017,10,0,6,4,20
5/28/2017,9,0,3,5,17
5/29/2017,10,0,7,0,17
5/30/2017,5,0,4,1,10
5/31/2017,11,0,5,4,20
6/1/2017,6,0,4,9,19
6/2/2017,11,0,5,11,27
6/3/2017,8,0,8,11,27
6/4/2017,8,0,3,8,19
6/5/2017,6,0,4,4,14
6/6/2017,12,0,2,4,18
6/7/2017,10,0,5,1,16
6/8/2017,11,0,7,6,24
6/9/2017,11,0,9,3,23
6/10/2017,7,0,2,4,13
6/11/2017,9,0,4,3,16
6/12/2017,8,0,7,6,21
6/13/2017,9,0,7,8,24
6/14/2017,4,0,9,6,19
6/15/2017,11,0,2,7,20
6/16/2017,11,0,5,2,18
6/17/2017,5,0,9,3,17
6/18/2017,10,0,2,8,20
6/19/2017,10,0,7,7,24
6/20/2017,9,0,3,9,21
6/21/2017,12,0,5,9,26
6/22/2017,5,0,5,9,19
6/23/2017,5,0,4,3,12
6/24/2017,9,0,10,3,22
6/25/2017,12,0,5,4,21
6/26/2017,4,0,5,8,17
6/27/2017,9,0,2,11,22
6/28/2017,7,0,3,1,11
6/29/2017,8,0,5,3,16
6/30/2017,4,0,2,0,6
7/1/2017,4,0,3,8,15
7/2/2017,7,0,3,8,18
7/3/2017,4,0,4,7,15
7/4/2017,4,0,3,3,10
7/5/2017,5,0,4,1,10
7/6/2017,7,0,2,6,15
7/7/2017,6,0,3,11,20
7/8/2017,9,0,3,4,16
7/9/2017,8,0,4,3,15
7/10/2017,6,0,4,1,11
7/11/2017,8,0,3,10,21
7/12/2017,10,0,6,7,23
7/13/2017,11,0,8,9,28
7/14/2017,7,0,9,9,25
7/15/2017,9,0,8,11,28
7/16/2017,7,0,9,1,17
7/17/2017,7,0,8,4,19
7/18/2017,10,0,7,0,17
7/19/2017,11,0,2,2,15
7/20/2017,8,0,6,11,25
7/21/2017,12,0,8,5,25
7/22/2017,5,0,9,10,24
7/23/2017,8,0,7,8,23
7/24/2017,4,0,3,4,11
7/25/2017,6,0,3,5,14
7/26/2017,5,0,3,5,13
7/27/2017,4,0,3,10,17
7/28/2017,9,0,2,9,20
7/29/2017,12,0,6,2,20
7/30/2017,8,0,3,0,11
7/31/2017,4,0,3,7,14
8/1/2017,12,0,4,2,18
8/2/2017,5,0,4,11,20
8/3/2017,6,0,4,2,12
8/4/2017,10,0,10,3,23
8/5/2017,7,0,4,10,21
8/6/2017,12,0,3,6,21
8/7/2017,4,0,10,11,25
8/8/2017,10,0,9,0,19
8/9/2017,9,0,6,8,23
8/10/2017,12,0,3,2,17
8/11/2017,12,0,10,8,30
8/12/2017,9,0,6,1,16
8/13/2017,9,0,5,11,25
8/14/2017,5,0,6,0,11
8/15/2017,11,0,8,11,30
8/16/2017,12,0,4,11,27
8/17/2017,12,0,8,6,26
8/18/2017,9,0,7,5,21
8/19/2017,4,0,3,0,7
8/20/2017,4,0,2,2,8
8/21/2017,10,0,5,10,25
8/22/2017,7,0,9,1,17
8/23/2017,8,0,5,11,24
8/24/2017,11,0,5,7,23
8/25/2017,7,0,7,9,23
8/26/2017,8,0,9,5,22
8/27/2017,6,0,10,5,21
8/28/2017,6,0,10,7,23
8/29/2017,12,0,7,5,24
8/30/2017,7,0,2,11,20
8/31/2017,11,0,8,4,23
9/1/2017,4,0,10,4,18
9/2/2017,10,0,10,2,22
9/3/2017,12,0,3,9,24
9/4/2017,5,0,5,7,17
9/5/2017,5,0,2,5,12
9/6/2017,12,0,10,8,30
9/7/2017,10,0,7,2,19
9/8/2017,11,0,9,9,29
9/9/2017,8,0,2,0,10
9/10/2017,8,0,8,5,21
9/11/2017,7,0,10,8,25
9/12/2017,7,0,6,3,16
9/13/2017,4,0,8,9,21
9/14/2017,12,0,10,0,22
9/15/2017,7,0,2,5,14
9/16/2017,8,0,9,5,22
9/17/2017,9,0,8,4,21
9/18/2017,9,0,8,6,23
9/19/2017,12,0,10,10,32
9/20/2017,9,0,2,10,21
9/21/2017,8,0,10,4,22
9/22/2017,6,0,10,5,21
9/23/2017,5,0,5,7,17
9/24/2017,10,0,6,3,19
9/25/2017,4,0,7,0,11
9/26/2017,7,0,2,6,15
9/27/2017,9,0,4,11,24
9/28/2017,6,0,8,7,21
9/29/2017,11,0,3,4,18
9/30/2017,5,0,6,10,21
10/1/2017,8,0,8,11,27
10/2/2017,5,0,7,7,19
10/3/2017,4,0,6,7,17
10/4/2017,11,0,8,7,26
10/5/2017,10,0,10,3,23
10/6/2017,12,0,9,1,22
10/7/2017,5,0,5,6,16
10/8/2017,8,0,5,2,15
10/9/2017,12,0,8,11,31
10/10/2017,10,0,3,5,18
10/11/2017,9,0,6,3,18
10/12/2017,5,0,10,4,19
10/13/2017,6,0,3,0,9
10/14/2017,6,0,4,9,19
10/15/2017,4,0,10,1,15
10/16/2017,8,0,7,5,20
10/17/2017,7,0,6,6,19
10/18/2017,4,0,5,0,9
10/19/2017,12,0,7,7,26
10/20/2017,11,0,9,11,31
10/21/2017,12,0,8,11,31
10/22/2017,5,0,2,5,12
10/23/2017,12,0,4,9,25
10/24/2017,12,0,7,10,29
10/25/2017,11,0,4,6,21
10/26/2017,10,0,7,8,25
10/27/2017,6,0,7,4,17
10/28/2017,6,0,5,7,18
10/29/2017,6,0,6,8,20
10/30/2017,9,0,2,5,16
10/31/2017,9,0,3,11,23
11/1/2017,7,0,2,4,13
11/2/2017,10,0,9,2,21
11/3/2017,4,0,8,7,19
11/4/2017,4,0,2,11,17
11/5/2017,6,0,2,8,16
11/6/2017,12,0,10,0,22
11/7/2017,10,0,7,1,18
11/8/2017,8,0,2,2,12
11/9/2017,8,0,7,1,16
11/10/2017,8,0,3,9,20
11/11/2017,6,0,4,11,21
11/12/2017,5,0,6,5,16
11/13/2017,12,0,7,11,30
11/14/2017,8,0,2,0,10
11/15/2017,6,0,10,9,25
11/16/2017,5,0,7,1,13
11/17/2017,11,0,2,6,19
11/18/2017,6,0,3,1,10
11/19/2017,6,0,7,4,17
11/20/2017,4,0,9,10,23
11/21/2017,12,0,7,6,25
11/22/2017,11,0,10,3,24
11/23/2017,12,0,9,0,21
11/24/2017,5,0,2,7,14
11/25/2017,5,0,3,0,8
11/26/2017,7,0,3,6,16
11/27/2017,10,0,6,6,22
11/28/2017,11,0,10,3,24
11/29/2017,7,0,7,0,14
11/30/2017,9,0,10,0,19
12/1/2017,7,0,9,8,24
12/2/2017,5,0,5,5,15
12/3/2017,7,0,4,9,20
12/4/2017,9,0,3,0,12
12/5/2017,10,0,9,11,30
12/6/2017,9,0,3,8,20
12/7/2017,4,0,2,4,10
12/8/2017,7,0,4,5,16
12/9/2017,9,0,10,7,26
12/10/2017,9,0,9,7,25
12/11/2017,11,0,3,6,20
12/12/2017,7,0,10,3,20
12/13/2017,5,0,10,4,19
12/14/2017,6,0,10,8,24
12/15/2017,8,0,6,5,19
12/16/2017,6,0,7,0,13
12/17/2017,5,0,3,1,9
12/18/2017,12,0,8,7,27
12/19/2017,8,0,9,0,17
12/20/2017,9,0,3,11,23
12/21/2017,10,0,3,9,22
12/22/2017,8,0,8,11,27
12/23/2017,12,0,6,9,27
12/24/2017,7,0,9,3,19
12/25/2017,9,0,7,4,20
12/26/2017,10,0,9,4,23
12/27/2017,9,0,9,4,22
12/28/2017,5,0,10,10,25
12/29/2017,9,0,2,7,18
12/30/2017,5,0,7,0,12
12/31/2017,11,0,9,9,29
1/1/2018,8,0,6,7,21
1/2/2018,10,0,10,2,22
1/3/2018,9,0,4,2,15
1/4/2018,11,0,4,10,25
1/5/2018,11,0,10,0,21
1/6/2018,8,0,5,9,22
1/7/2018,8,0,4,9,21
1/8/2018,8,0,10,5,23
1/9/2018,7,0,9,7,23
1/10/2018,8,0,2,0,10
1/11/2018,6,0,8,9,23
1/12/2018,9,0,5,9,23
1/13/2018,4,0,10,6,20
1/14/2018,8,0,4,9,21
1/15/2018,8,0,10,0,18
1/16/2018,10,0,6,8,24
1/17/2018,10,0,2,5,17
1/18/2018,4,0,8,8,20
1/19/2018,7,0,4,6,17
1/20/2018,4,0,6,2,12
1/21/2018,12,0,3,2,17
1/22/2018,9,0,3,3,15
1/23/2018,9,0,6,6,21
1/24/2018,4,0,5,7,16
1/25/2018,4,0,9,5,18
1/26/2018,12,0,7,11,30
1/27/2018,4,0,8,6,18
1/28/2018,5,0,2,4,11
1/29/2018,7,0,2,4,13
1/30/2018,11,0,6,11,28
1/31/2018,4,0,2,4,10
2/1/2018,6,0,9,5,20
2/2/2018,5,0,3,1,9
2/3/2018,9,0,3,8,20
2/4/2018,11,0,9,6,26
2/5/2018,11,0,7,9,27
2/6/2018,5,0,4,8,17
2/7/2018,9,0,5,10,24
2/8/2018,4,0,9,7,20
2/9/2018,6,0,6,3,15
2/10/2018,12,0,8,11,31
2/11/2018,11,0,2,1,14
2/12/2018,10,0,3,8,21
2/13/2018,10,0,5,3,18
2/14/2018,10,0,10,6,26
2/15/2018,12,0,10,6,28
2/16/2018,11,0,3,3,17
2/17/2018,5,0,8,6,19
2/18/2018,11,0,7,8,26
2/19/2018,8,0,5,10,23
2/20/2018,4,0,2,0,6
2/21/2018,9,0,5,8,22
2/22/2018,8,0,2,7,17
2/23/2018,6,0,10,2,18
2/24/2018,8,0,8,4,20
2/25/2018,7,0,5,3,15
2/26/2018,7,0,4,0,11
2/27/2018,4,0,5,9,18
2/28/2018,7,0,7,11,25
3/1/2018,9,0,2,0,11
3/2/2018,7,0,2,7,16
3/3/2018,9,0,8,10,27
3/4/2018,12,0,9,0,21
3/5/2018,6,0,2,8,16
3/6/2018,9,0,5,8,22
3/7/2018,9,0,5,1,15
3/8/2018,5,0,8,10,23
3/9/2018,8,0,3,11,22
3/10/2018,7,0,8,5,20
3/11/2018,7,0,4,8,19
3/12/2018,4,0,3,10,17
3/13/2018,4,0,4,11,19
3/14/2018,4,0,9,9,22
3/15/2018,9,0,8,8,25
3/16/2018,10,0,8,1,19
3/17/2018,8,0,8,7,23
3/18/2018,9,0,3,3,15
3/19/2018,4,0,10,4,18
3/20/2018,8,0,3,7,18
3/21/2018,9,0,6,9,24
3/22/2018,5,0,8,2,15
3/23/2018,5,0,2,1,8
3/24/2018,10,0,5,10,25
3/25/2018,8,0,7,10,25
3/26/2018,12,0,4,7,23
3/27/2018,6,0,2,7,15
3/28/2018,7,0,5,7,19
3/29/2018,8,0,10,7,25
3/30/2018,12,0,2,6,20
3/31/2018,8,0,7,10,25
4/1/2018,11,0,7,9,27
4/2/2018,5,0,3,4,12
4/3/2018,12,0,7,1,20
4/4/2018,7,0,3,10,20
4/5/2018,6,0,3,11,20
4/6/2018,10,0,8,6,24
4/7/2018,8,0,8,11,27
4/8/2018,9,0,10,10,29
4/9/2018,11,0,8,7,26
4/10/2018,11,0,6,2,19
4/11/2018,7,0,3,10,20
4/12/2018,8,0,10,11,29
4/13/2018,11,0,9,5,25
4/14/2018,7,0,6,10,23
4/15/2018,10,0,10,6,26
4/16/2018,4,0,2,10,16
4/17/2018,7,0,5,2,14
4/18/2018,8,0,7,5,20
4/19/2018,6,0,2,8,16
4/20/2018,4,0,9,8,21
4/21/2018,6,0,5,11,22
4/22/2018,8,0,5,2,15
4/23/2018,5,0,7,5,17
4/24/2018,12,0,4,4,20
4/25/2018,8,0,2,7,17
4/26/2018,8,0,6,11,25
4/27/2018,8,0,8,1,17
4/28/2018,9,0,5,1,15
4/29/2018,10,0,8,10,28
4/30/2018,12,0,10,10,32
5/1/2018,10,0,2,7,19
5/2/2018,5,0,4,0,9
5/3/2018,12,0,9,3,24
5/4/2018,6,0,7,11,24
5/5/2018,12,0,7,3,22
5/6/2018,6,0,10,9,25
5/7/2018,7,0,10,2,19
5/8/2018,8,0,5,2,15
5/9/2018,4,0,5,3,12
5/10/2018,10,0,5,1,16
5/11/2018,9,0,6,10,25
5/12/2018,4,0,5,8,17
5/13/2018,6,0,2,7,15
5/14/2018,10,0,6,0,16
5/15/2018,6,0,7,5,18
5/16/2018,4,0,10,11,25
5/17/2018,11,0,6,4,21
5/18/2018,9,0,3,2,14
5/19/2018,5,0,9,0,14
5/20/2018,4,0,3,6,13
5/21/2018,7,0,9,11,27
5/22/2018,8,0,8,5,21
5/23/2018,4,0,4,11,19
5/24/2018,5,0,10,5,20
5/25/2018,12,0,10,11,33
5/26/2018,7,0,6,8,21
5/27/2018,6,0,3,10,19
5/28/2018,9,0,6,1,16
5/29/2018,12,0,4,11,27
5/30/2018,5,0,3,8,16
5/31/2018,11,0,3,7,21
6/1/2018,9,0,6,10,25
6/2/2018,11,0,6,10,27
6/3/2018,8,0,9,4,21
6/4/2018,9,0,3,2,14
6/5/2018,10,0,7,2,19
6/6/2018,10,0,8,4,22
6/7/2018,6,0,2,5,13
6/8/2018,12,0,4,4,20
6/9/2018,8,0,5,1,14
6/10/2018,6,0,5,9,20
6/11/2018,9,0,5,9,23
6/12/2018,4,0,5,0,9
6/13/2018,10,0,6,9,25
6/14/2018,11,0,5,5,21
6/15/2018,7,0,4,8,19
6/16/2018,12,0,4,0,16
6/17/2018,4,0,5,6,15
6/18/2018,8,0,8,5,21
6/19/2018,8,0,7,4,19
6/20/2018,7,0,2,7,16
6/21/2018,12,0,2,3,17
6/22/2018,11,0,10,5,26
6/23/2018,5,0,6,9,20
6/24/2018,11,0,5,5,21
6/25/2018,4,0,5,0,9
6/26/2018,8,0,6,3,17
6/27/2018,4,0,2,7,13
6/28/2018,4,0,2,9,15
6/29/2018,12,0,5,3,20
6/30/2018,6,0,6,5,17
7/1/2018,4,0,4,1,9
7/2/2018,10,0,2,9,21
7/3/2018,12,0,6,6,24
7/4/2018,12,0,3,5,20
7/5/2018,10,0,2,3,15
7/6/2018,8,0,7,1,16
7/7/2018,6,0,10,4,20
7/8/2018,9,0,8,3,20
7/9/2018,10,0,8,1,19
7/10/2018,7,0,3,10,20
7/11/2018,7,0,7,5,19
7/12/2018,4,0,3,11,18
7/13/2018,7,0,9,7,23
7/14/2018,11,0,8,7,26
7/15/2018,11,0,8,1,20
7/16/2018,5,0,6,9,20
7/17/2018,9,0,8,0,17
7/18/2018,4,0,4,4,12
7/19/2018,5,0,7,7,19
7/20/2018,8,0,5,5,18
7/21/2018,4,0,9,11,24
7/22/2018,7,0,3,11,21
7/23/2018,8,0,4,11,23
7/24/2018,7,0,8,11,26
7/25/2018,8,0,6,0,14
7/26/2018,6,0,5,6,17
7/27/2018,12,0,9,5,26
7/28/2018,6,0,4,0,10
7/29/2018,12,0,5,3,20
7/30/2018,5,0,10,11,26
7/31/2018,4,0,9,8,21
8/1/2018,5,0,2,4,11
8/2/2018,8,0,9,0,17
8/3/2018,4,0,6,1,11
8/4/2018,7,0,4,8,19
8/5/2018,11,0,6,3,20
8/6/2018,9,0,6,8,23
8/7/2018,8,0,6,8,22
8/8/2018,5,0,8,7,20
8/9/2018,4,0,5,6,15
8/10/2018,11,0,10,9,30
8/11/2018,11,0,10,11,32
8/12/2018,9,0,10,3,22
8/13/2018,8,0,9,1,18
8/14/2018,6,0,9,2,17
8/15/2018,12,0,9,0,21
8/16/2018,8,0,8,0,16
8/17/2018,6,0,3,9,18
8/18/2018,7,0,4,9,20
8/19/2018,8,0,2,3,13
8/20/2018,10,0,10,8,28
8/21/2018,4,0,2,1,7
8/22/2018,6,0,7,1,14
8/23/2018,8,0,2,11,21
8/24/2018,8,0,6,2,16
8/25/2018,8,0,9,10,27
8/26/2018,12,0,6,6,24
8/27/2018,10,0,3,4,17
8/28/2018,7,0,10,3,20
8/29/2018,11,0,9,0,20
8/30/2018,11,0,10,11,32
8/31/2018,7,0,4,5,16
9/1/2018,12,0,6,1,19
9/2/2018,6,0,9,3,18
9/3/2018,9,0,10,1,20
9/4/2018,4,0,7,6,17
9/5/2018,10,0,2,10,22
9/6/2018,7,0,9,7,23
9/7/2018,9,0,9,10,28
9/8/2018,7,0,10,5,22
9/9/2018,10,0,3,2,15
9/10/2018,8,0,6,1,15
9/11/2018,7,0,9,3,19
9/12/2018,4,0,4,1,9
9/13/2018,8,0,3,3,14
9/14/2018,12,0,6,11,29
9/15/2018,7,0,5,5,17
9/16/2018,11,0,2,10,23
9/17/2018,12,0,4,11,27
9/18/2018,9,0,5,3,17
9/19/2018,4,0,10,11,25
9/20/2018,9,0,5,8,22
9/21/2018,8,0,3,7,18
9/22/2018,9,0,5,3,17
9/23/2018,11,0,9,11,31
9/24/2018,11,0,7,10,28
9/25/2018,4,0,4,10,18
9/26/2018,5,0,2,6,13
9/27/2018,6,0,5,1,12
9/28/2018,10,0,8,5,23
9/29/2018,5,0,3,4,12
9/30/2018,7,0,2,7,16
10/1/2018,6,0,3,7,16
10/2/2018,12,0,8,2,22
10/3/2018,8,0,10,9,27
10/4/2018,6,0,6,0,12
10/5/2018,7,0,4,2,13
10/6/2018,11,0,5,3,19
10/7/2018,9,0,5,0,14
10/8/2018,4,0,4,5,13
10/9/2018,9,0,6,4,19
10/10/2018,10,0,7,4,21
10/11/2018,5,0,8,2,15
10/12/2018,11,0,7,10,28
10/13/2018,6,0,7,10,23
10/14/2018,12,0,5,5,22
10/15/2018,5,0,10,7,22
10/16/2018,5,0,4,5,14
10/17/2018,5,0,10,6,21
10/18/2018,7,0,5,1,13
10/19/2018,10,0,6,4,20
10/20/2018,8,0,7,0,15
10/21/2018,10,0,7,4,21
10/22/2018,6,0,4,4,14
10/23/2018,11,0,10,3,24
10/24/2018,6,0,6,10,22
10/25/2018,5,0,5,0,10
10/26/2018,7,0,10,6,23
10/27/2018,4,0,5,11,20
10/28/2018,8,0,7,6,21
10/29/2018,12,0,8,1,21
10/30/2018,10,0,6,9,25
10/31/2018,6,0,8,2,16
11/1/2018,9,0,10,5,24
11/2/2018,10,0,10,8,28
11/3/2018,6,0,4,4,14
11/4/2018,5,0,5,11,21
11/5/2018,7,0,7,0,14
11/6/2018,12,0,6,6,24
11/7/2018,12,0,3,2,17
11/8/2018,10,0,7,11,28
11/9/2018,9,0,2,0,11
11/10/2018,5,0,10,7,22
11/11/2018,12,0,2,7,21
11/12/2018,5,0,4,11,20
11/13/2018,7,0,7,2,16
11/14/2018,8,0,2,10,20
11/15/2018,11,0,8,6,25
11/16/2018,12,0,3,10,25
11/17/2018,7,0,3,5,15
11/18/2018,5,0,3,9,17
11/19/2018,6,0,8,7,21
11/20/2018,7,0,7,11,25
11/21/2018,8,0,10,9,27
11/22/2018,4,0,6,1,11
11/23/2018,9,0,2,1,12
11/24/2018,10,0,3,9,22
11/25/2018,11,0,6,2,19
11/26/2018,6,0,3,9,18
11/27/2018,6,0,5,10,21
11/28/2018,6,0,9,9,24
11/29/2018,6,0,6,7,19
11/30/2018,6,0,10,1,17
12/1/2018,5,0,2,10,17
12/2/2018,12,0,9,8,29
12/3/2018,9,0,10,2,21
12/4/2018,11,0,4,9,24
12/5/2018,4,0,3,1,8
12/6/2018,7,0,9,7,23
12/7/2018,12,0,7,7,26
12/8/2018,11,0,9,3,23
12/9/2018,11,0,5,6,22
12/10/2018,11,0,10,7,28
12/11/2018,8,0,3,11,22
12/12/2018,10,0,3,1,14
12/13/2018,7,0,9,7,23
12/14/2018,10,0,3,9,22
12/15/2018,11,0,8,5,24
12/16/2018,7,0,8,7,22
12/17/2018,10,0,8,11,29
12/18/2018,9,0,5,11,25
12/19/2018,10,0,7,2,19
12/20/2018,6,0,4,0,10
12/21/2018,4,0,2,11,17
12/22/2018,7,0,3,8,18
12/23/2018,12,0,6,3,21
12/24/2018,11,0,4,9,24
12/25/2018,9,0,4,1,14
12/26/2018,8,0,9,2,19
12/27/2018,11,0,7,4,22
12/28/2018,7,0,9,5,21
12/29/2018,4,0,6,5,15
12/30/2018,11,0,3,3,17
12/31/2018,9,0,2,5,16
1/1/2019,10,0,5,8,23
1/2/2019,12,0,10,8,30
1/3/2019,6,0,10,3,19
1/4/2019,12,0,5,6,23
1/5/2019,5,0,3,6,14
1/6/2019,4,0,10,7,21
1/7/2019,5,0,9,6,20
1/8/2019,6,0,8,4,18
1/9/2019,10,0,8,11,29
1/10/2019,4,0,5,7,16
1/11/2019,5,0,8,5,18
1/12/2019,5,0,3,5,13
1/13/2019,4,0,4,3,11
1/14/2019,12,0,3,7,22
1/15/2019,11,0,9,10,30
1/16/2019,8,0,2,1,11
1/17/2019,5,0,10,6,21
1/18/2019,7,0,10,0,17
1/19/2019,10,0,4,9,23
1/20/2019,4,0,4,3,11
1/21/2019,5,0,10,4,19
1/22/2019,5,0,5,8,18
1/23/2019,5,0,2,3,10
1/24/2019,10,0,3,10,23
1/25/2019,4,0,7,5,16
1/26/2019,11,0,4,4,19
1/27/2019,4,0,9,9,22
1/28/2019,7,0,2,7,16
1/29/2019,8,0,10,10,28
1/30/2019,6,0,5,4,15
1/31/2019,9,0,6,0,15
2/1/2019,10,0,8,5,23
2/2/2019,11,0,5,9,25
2/3/2019,12,0,10,10,32
2/4/2019,6,0,2,9,17
2/5/2019,9,0,10,3,22
2/6/2019,5,0,5,1,11
2/7/2019,6,0,10,6,22
2/8/2019,10,0,9,9,28
2/9/2019,8,0,2,7,17
2/10/2019,7,0,10,1,18
2/11/2019,11,0,2,5,18
2/12/2019,8,0,9,3,20
2/13/2019,9,0,6,2,17
2/14/2019,9,0,6,5,20
2/15/2019,5,0,9,11,25
2/16/2019,7,0,4,4,15
2/17/2019,9,0,9,2,20
2/18/2019,5,0,9,11,25
2/19/2019,9,0,5,2,16
2/20/2019,6,0,5,10,21
2/21/2019,5,0,6,9,20
2/22/2019,7,0,5,5,17
2/23/2019,12,0,8,11,31
2/24/2019,10,0,5,7,22
2/25/2019,10,0,6,8,24
2/26/2019,11,0,9,9,29
2/27/2019,5,0,4,9,18
2/28/2019,11,0,7,2,20
3/1/2019,6,0,9,6,21
3/2/2019,5,0,3,11,19
3/3/2019,6,0,9,1,16
3/4/2019,4,0,9,8,21
3/5/2019,7,0,4,9,20
3/6/2019,10,0,5,1,16
3/7/2019,10,0,2,6,18
3/8/2019,6,0,9,1,16
3/9/2019,12,0,2,4,18
3/10/2019,5,0,5,1,11
3/11/2019,10,0,2,9,21
3/12/2019,5,0,2,9,16
3/13/2019,9,0,4,5,18
3/14/2019,5,0,9,9,23
3/15/2019,8,0,7,3,18
3/16/2019,10,0,6,9,25
3/17/2019,6,0,7,9,22
3/18/2019,4,0,8,3,15
3/19/2019,12,0,6,6,24
3/20/2019,12,0,8,6,26
3/21/2019,11,0,6,0,17
3/22/2019,11,0,2,7,20
3/23/2019,10,0,8,0,18
3/24/2019,11,0,8,3,22
3/25/2019,5,0,4,7,16
3/26/2019,6,0,6,2,14
3/27/2019,9,0,9,7,25
3/28/2019,10,0,3,0,13
3/29/2019,6,0,7,2,15
3/30/2019,9,0,3,3,15
3/31/2019,9,0,7,8,24
4/1/2019,8,0,9,3,20
4/2/2019,5,0,4,2,11
4/3/2019,12,0,7,1,20
4/4/2019,4,0,2,8,14
4/5/2019,8,0,10,1,19
4/6/2019,11,0,8,8,27
4/7/2019,12,0,10,5,27
4/8/2019,7,0,2,4,13
4/9/2019,7,0,10,0,17
4/10/2019,6,0,7,5,18
4/11/2019,8,0,4,3,15
4/12/2019,9,0,9,10,28
4/13/2019,5,0,7,0,12
4/14/2019,7,0,2,7,16
4/15/2019,7,0,8,3,18
4/16/2019,10,0,2,0,12
4/17/2019,5,0,6,8,19
4/18/2019,5,0,8,1,14
4/19/2019,10,0,5,5,20
4/20/2019,8,0,10,7,25
4/21/2019,11,0,6,8,25
4/22/2019,9,0,2,8,19
4/23/2019,9,0,8,0,17
4/24/2019,12,0,6,11,29
4/25/2019,4,0,3,7,14
4/26/2019,5,0,10,1,16
4/27/2019,9,0,8,3,20
4/28/2019,5,0,6,9,20
4/29/2019,6,0,9,8,23
4/30/2019,12,0,3,4,19
5/1/2019,9,0,4,3,16
5/2/2019,9,0,4,10,23
5/3/2019,10,0,3,4,17
5/4/2019,12,0,3,10,25
5/5/2019,9,0,4,7,20
5/6/2019,12,0,10,4,26
5/7/2019,12,0,10,7,29
5/8/2019,12,0,10,5,27
5/9/2019,7,0,5,4,16
5/10/2019,8,0,10,10,28
5/11/2019,5,0,6,9,20
5/12/2019,11,0,3,11,25
5/13/2019,8,0,5,4,17
5/14/2019,9,0,7,8,24
5/15/2019,9,0,10,6,25
5/16/2019,9,0,5,2,16
5/17/2019,5,0,6,2,13
5/18/2019,12,0,8,3,23
5/19/2019,7,0,9,2,18
5/20/2019,5,0,2,2,9
5/21/2019,4,0,7,2,13
5/22/2019,6,0,6,8,20
5/23/2019,8,0,5,2,15
5/24/2019,6,0,2,1,9
5/25/2019,11,0,10,11,32
5/26/2019,4,0,3,7,14
5/27/2019,10,0,6,5,21
5/28/2019,5,0,6,9,20
5/29/2019,11,0,4,7,22
5/30/2019,7,0,6,1,14
5/31/2019,4,0,8,0,12
6/1/2019,4,0,4,3,11
6/2/2019,11,0,10,6,27
6/3/2019,9,0,10,4,23
6/4/2019,9,0,5,3,17
6/5/2019,5,0,3,11,19
6/6/2019,6,0,5,0,11
6/7/2019,9,0,8,2,19
6/8/2019,8,0,9,6,23
6/9/2019,8,0,7,9,24
6/10/2019,12,0,5,3,20
6/11/2019,8,0,2,8,18
6/12/2019,12,0,10,4,26
6/13/2019,7,0,2,11,20
6/14/2019,9,0,9,3,21
6/15/2019,7,0,5,3,15
6/16/2019,7,0,3,8,18
6/17/2019,12,0,7,0,19
6/18/2019,10,0,8,8,26
6/19/2019,6,0,3,2,11
6/20/2019,5,0,7,10,22
6/21/2019,9,0,9,3,21
6/22/2019,8,0,6,5,19
6/23/2019,8,0,10,9,27
6/24/2019,4,0,3,2,9
6/25/2019,8,0,10,7,25
6/26/2019,11,0,8,9,28
6/27/2019,7,0,8,10,25
6/28/2019,7,0,4,0,11
6/29/2019,4,0,5,4,13
6/30/2019,8,0,9,6,23
7/1/2019,5,0,5,1,11
7/2/2019,10,0,8,11,29
7/3/2019,7,0,9,7,23
7/4/2019,10,0,3,11,24
7/5/2019,7,0,3,7,17
7/6/2019,11,0,6,11,28
7/7/2019,7,0,3,9,19
7/8/2019,8,0,2,9,19
7/9/2019,5,0,3,6,14
7/10/2019,5,0,3,1,9
7/11/2019,6,0,8,9,23
7/12/2019,8,0,5,8,21
7/13/2019,7,0,9,2,18
7/14/2019,8,0,6,9,23
7/15/2019,8,0,6,7,21
7/16/2019,10,0,3,2,15
7/17/2019,6,0,10,9,25
7/18/2019,11,0,9,2,22
7/19/2019,8,0,9,10,27
7/20/2019,7,0,5,3,15
7/21/2019,5,0,5,2,12
7/22/2019,8,0,10,0,18
7/23/2019,9,0,2,2,13
7/24/2019,6,0,6,0,12
7/25/2019,4,0,3,8,15
7/26/2019,11,0,4,8,23
7/27/2019,9,0,6,3,18
7/28/2019,9,0,3,6,18
7/29/2019,4,0,8,6,18
7/30/2019,7,0,10,2,19
7/31/2019,4,0,6,5,15
8/1/2019,11,0,9,2,22
8/2/2019,7,0,7,11,25
8/3/2019,8,0,7,0,15
8/4/2019,12,0,6,10,28
8/5/2019,8,0,2,5,15
8/6/2019,5,0,9,7,21
8/7/2019,6,0,6,11,23
8/8/2019,10,0,7,11,28
8/9/2019,8,0,4,11,23
8/10/2019,4,0,2,11,17
8/11/2019,11,0,4,4,19
8/12/2019,7,0,10,1,18
8/13/2019,9,0,10,9,28
8/14/2019,9,0,7,9,25
8/15/2019,6,0,4,6,16
8/16/2019,5,0,4,7,16
8/17/2019,11,0,9,6,26
8/18/2019,8,0,8,1,17
8/19/2019,6,0,7,4,17
8/20/2019,4,0,10,8,22
8/21/2019,8,0,3,1,12
8/22/2019,10,0,3,5,18
8/23/2019,9,0,2,9,20
8/24/2019,7,0,6,3,16
8/25/2019,5,0,7,2,14
8/26/2019,12,0,9,0,21
8/27/2019,6,0,7,7,20
8/28/2019,12,0,6,6,24
8/29/2019,7,0,6,5,18
8/30/2019,4,0,6,3,13
8/31/2019,10,0,10,8,28
9/1/2019,8,0,2,0,10
9/2/2019,12,0,10,9,31
9/3/2019,4,0,3,6,13
9/4/2019,12,0,4,3,19
9/5/2019,7,0,7,2,16
9/6/2019,8,0,9,7,24
9/7/2019,10,0,7,9,26
9/8/2019,10,0,6,8,24
9/9/2019,11,0,3,0,14
9/10/2019,12,0,8,3,23
9/11/2019,10,0,9,3,22
9/12/2019,12,0,10,8,30
9/13/2019,7,0,3,1,11
9/14/2019,9,0,9,8,26
9/15/2019,8,0,4,6,18
9/16/2019,7,0,7,8,22
9/17/2019,6,0,7,6,19
9/18/2019,9,0,8,0,17
9/19/2019,8,0,7,5,20
9/20/2019,9,0,9,3,21
9/21/2019,9,0,9,4,22
9/22/2019,10,0,4,3,17
9/23/2019,6,0,10,7,23
9/24/2019,4,0,5,0,9
9/25/2019,5,0,2,4,11
9/26/2019,5,0,8,7,20
9/27/2019,8,0,8,7,23
9/28/2019,8,0,6,10,24
9/29/2019,8,0,8,11,27
9/30/2019,10,0,6,10,26
10/1/2019,6,0,8,5,19
10/2/2019,9,0,5,9,23
10/3/2019,12,0,2,0,14
10/4/2019,6,0,5,6,17
10/5/2019,12,0,5,7,24
10/6/2019,8,0,6,7,21
10/7/2019,12,0,9,9,30
10/8/2019,6,0,7,0,13
10/9/2019,11,0,2,11,24
10/10/2019,7,0,9,6,22
10/11/2019,4,0,2,1,7
10/12/2019,6,0,6,7,19
10/13/2019,12,0,2,0,14
10/14/2019,12,0,3,4,19
10/15/2019,4,0,5,3,12
10/16/2019,9,0,7,2,18
10/17/2019,11,0,3,2,16
10/18/2019,12,0,10,3,25
10/19/2019,12,0,10,7,29
10/20/2019,6,0,3,1,10
10/21/2019,5,0,8,6,19
10/22/2019,8,0,10,10,28
10/23/2019,10,0,7,7,24
10/24/2019,5,0,7,7,19
10/25/2019,8,0,10,11,29
10/26/2019,4,0,5,11,20
10/27/2019,11,0,9,6,26
10/28/2019,10,0,7,1,18
10/29/2019,4,0,7,5,16
10/30/2019,4,0,2,8,14
10/31/2019,4,0,2,6,12
11/1/2019,8,0,7,2,17
11/2/2019,8,0,3,7,18
11/3/2019,5,0,4,5,14
11/4/2019,9,0,8,3,20
11/5/2019,8,0,8,4,20
11/6/2019,6,0,7,3,16
11/7/2019,4,0,9,3,16
11/8/2019,9,0,6,7,22
11/9/2019,10,0,3,8,21
11/10/2019,11,0,3,10,24
11/11/2019,5,0,10,8,23
11/12/2019,4,0,9,9,22
11/13/2019,5,0,6,11,22
11/14/2019,7,0,9,1,17
11/15/2019,11,0,9,6,26
11/16/2019,5,0,2,3,10
11/17/2019,4,0,5,4,13
11/18/2019,6,0,5,5,16
11/19/2019,4,0,8,2,14
11/20/2019,7,0,8,11,26
11/21/2019,7,0,3,1,11
11/22/2019,12,0,10,8,30
11/23/2019,7,0,3,8,18
11/24/2019,7,0,3,10,20
11/25/2019,10,0,5,8,23
11/26/2019,7,0,4,5,16
11/27/2019,11,0,4,8,23
11/28/2019,11,0,3,3,17
11/29/2019,6,0,6,3,15
11/30/2019,4,0,8,3,15
12/1/2019,11,0,5,8,24
12/2/2019,8,0,2,0,10
12/3/2019,11,0,5,10,26
12/4/2019,9,0,5,10,24
12/5/2019,4,0,7,11,22
12/6/2019,7,0,3,2,12
12/7/2019,7,0,6,5,18
12/8/2019,11,0,9,9,29
12/9/2019,9,0,5,3,17
12/10/2019,7,0,3,4,14
12/11/2019,10,0,6,0,16
12/12/2019,9,0,3,11,23
12/13/2019,4,0,9,0,13
12/14/2019,6,0,8,5,19
12/15/2019,7,0,9,9,25
12/16/2019,7,0,9,6,22
12/17/2019,7,0,7,8,22
12/18/2019,9,0,10,9,28
12/19/2019,11,0,6,7,24
12/20/2019,7,0,10,1,18
12/21/2019,10,0,9,0,19
12/22/2019,11,0,4,1,16
12/23/2019,11,0,8,0,19
12/24/2019,8,0,5,7,20
12/25/2019,9,0,10,5,24
12/26/2019,6,0,10,2,18
12/27/2019,10,0,9,11,30
12/28/2019,5,0,10,2,17
12/29/2019,6,0,2,6,14
12/30/2019,8,0,8,11,27
12/31/2019,9,0,9,8,26
1/1/2020,12,0,7,1,20
1/2/2020,12,0,2,9,23
1/3/2020,11,0,10,8,29
1/4/2020,4,0,10,7,21
1/5/2020,8,0,7,10,25
1/6/2020,12,0,9,3,24
1/7/2020,10,0,3,10,23
1/8/2020,8,0,7,1,16
1/9/2020,8,0,4,1,13
1/10/2020,11,0,5,7,23
1/11/2020,9,0,8,3,20
1/12/2020,10,0,6,1,17
1/13/2020,6,0,9,2,17
1/14/2020,11,0,10,8,29
1/15/2020,5,0,10,2,17
1/16/2020,7,0,4,8,19
1/17/2020,7,0,5,7,19
1/18/2020,12,0,3,10,25
1/19/2020,6,0,9,5,20
1/20/2020,7,0,3,0,10
1/21/2020,4,0,6,9,19
1/22/2020,11,0,10,10,31
1/23/2020,12,0,10,8,30
1/24/2020,5,0,4,2,11
1/25/2020,8,0,9,3,20
1/26/2020,6,0,4,2,12
1/27/2020,9,0,8,8,25
1/28/2020,4,0,2,11,17
1/29/2020,4,0,7,8,19
1/30/2020,8,0,9,2,19
1/31/2020,10,0,5,11,26
2/1/2020,11,0,8,5,24
2/2/2020,6,0,3,11,20
2/3/2020,11,0,5,4,20
2/4/2020,12,0,9,9,30
2/5/2020,9,0,5,4,18
2/6/2020,10,0,8,5,23
2/7/2020,10,0,5,3,18
2/8/2020,6,0,5,11,22
2/9/2020,11,0,7,8,26
2/10/2020,8,0,4,11,23
2/11/2020,5,0,9,11,25
2/12/2020,12,0,6,9,27
2/13/2020,9,0,10,2,21
2/14/2020,4,0,5,8,17
2/15/2020,7,0,8,7,22
2/16/2020,5,0,8,2,15
2/17/2020,10,0,9,6,25
2/18/2020,9,0,7,9,25
2/19/2020,6,0,5,10,21
2/20/2020,8,0,2,8,18
2/21/2020,11,0,2,10,23
2/22/2020,11,0,3,9,23
2/23/2020,10,0,7,10,27
2/24/2020,5,0,6,8,19
2/25/2020,9,0,2,8,19
2/26/2020,12,0,5,11,28
2/27/2020,7,0,6,5,18
2/28/2020,5,0,6,5,16
2/29/2020,11,0,2,6,19
3/1/2020,11,6,7,6,30
3/2/2020,7,10,5,9,31
3/3/2020,10,4,5,11,30
3/4/2020,4,12,3,9,28
3/5/2020,5,6,3,8,22
3/6/2020,8,5,7,0,20
3/7/2020,5,2,10,4,21
3/8/2020,4,9,10,0,23
3/9/2020,8,10,8,8,34
3/10/2020,4,9,4,9,26
3/11/2020,10,9,5,10,34
3/12/2020,8,5,7,10,30
3/13/2020,12,3,3,3,21
3/14/2020,9,12,10,2,33
3/15/2020,10,4,6,4,24
3/16/2020,4,9,3,4,20
3/17/2020,10,1,7,10,28
3/18/2020,8,2,6,8,24
3/19/2020,5,4,2,6,17
3/20/2020,7,7,9,10,33
3/21/2020,5,12,3,5,25
3/22/2020,11,7,10,6,34
3/23/2020,8,2,8,10,28
3/24/2020,8,13,9,8,38
3/25/2020,10,7,8,10,35
3/26/2020,7,6,5,10,28
3/27/2020,12,5,3,4,24
3/28/2020,8,5,10,9,32
3/29/2020,11,13,3,1,28
3/30/2020,6,1,2,7,16
3/31/2020,4,11,5,7,27
4/1/2020,7,23,3,4,37
4/2/2020,11,24,6,10,51
4/3/2020,6,23,6,11,46
4/4/2020,11,17,2,4,34
4/5/2020,12,24,6,3,45
4/6/2020,6,18,6,5,35
4/7/2020,7,19,5,2,33
4/8/2020,8,14,7,11,40
4/9/2020,6,24,3,11,44
4/10/2020,9,23,5,6,43
4/11/2020,12,21,6,3,42
4/12/2020,6,12,10,1,29
4/13/2020,12,18,4,7,41
4/14/2020,9,13,7,8,37
4/15/2020,10,22,9,1,42
4/16/2020,4,21,9,1,35
4/17/2020,5,18,2,0,25
4/18/2020,7,13,9,10,39
4/19/2020,5,16,6,8,35
4/20/2020,10,24,10,5,49
4/21/2020,6,15,3,8,32
4/22/2020,5,22,5,8,40
4/23/2020,12,24,8,4,48
4/24/2020,8,15,2,11,36
4/25/2020,6,12,9,1,28
4/26/2020,6,12,7,7,32
4/27/2020,5,25,5,5,40
4/28/2020,5,18,6,7,36
4/29/2020,9,17,9,4,39
4/30/2020,6,14,10,3,33
5/1/2020,9,16,7,2,34
5/2/2020,9,21,7,6,43
5/3/2020,8,24,4,9,45
5/4/2020,11,18,8,6,43
5/5/2020,7,13,8,1,29
5/6/2020,6,15,2,6,29
5/7/2020,9,18,6,11,44
5/8/2020,6,23,10,7,46
5/9/2020,10,21,4,11,46
5/10/2020,5,17,7,5,34
5/11/2020,5,17,4,11,37
5/12/2020,11,15,6,0,32
5/13/2020,11,19,4,4,38
5/14/2020,7,23,4,9,43
5/15/2020,6,16,8,1,31
5/16/2020,7,12,2,2,23
5/17/2020,11,15,7,9,42
5/18/2020,10,24,9,6,49
5/19/2020,12,12,2,5,31
5/20/2020,12,24,5,0,41
5/21/2020,7,22,5,9,43
5/22/2020,8,23,5,1,37
5/23/2020,6,13,3,4,26
5/24/2020,10,25,8,2,45
5/25/2020,9,19,8,8,44
5/26/2020,4,12,7,5,28
5/27/2020,5,21,4,1,31
5/28/2020,4,13,2,7,26
5/29/2020,9,16,4,6,35
5/30/2020,7,22,3,9,41
5/31/2020,11,14,9,4,38
6/1/2020,4,25,3,11,43
6/2/2020,12,37,10,5,64
6/3/2020,8,31,8,4,51
6/4/2020,12,50,2,8,72
6/5/2020,11,31,4,11,57
6/6/2020,7,43,10,5,65
6/7/2020,11,50,2,3,66
6/8/2020,9,44,8,11,72
6/9/2020,8,32,8,7,55
6/10/2020,6,28,5,1,40
6/11/2020,7,49,8,1,65
6/12/2020,7,40,6,4,57
6/13/2020,7,36,6,11,60
6/14/2020,4,51,5,4,64
6/15/2020,4,44,10,3,61
6/16/2020,6,52,8,9,75
6/17/2020,11,35,8,8,62
6/18/2020,11,47,4,8,70
6/19/2020,11,33,8,4,56
6/20/2020,12,43,9,1,65
6/21/2020,9,31,9,5,54
6/22/2020,10,40,9,10,69
6/23/2020,4,31,3,5,43
6/24/2020,11,51,5,7,74
6/25/2020,8,37,5,2,52
6/26/2020,7,29,3,11,50
6/27/2020,8,46,5,0,59
6/28/2020,5,36,10,0,51
6/29/2020,12,31,2,3,48
6/30/2020,4,25,6,0,35
7/1/2020,8,44,10,6,68
7/2/2020,5,43,9,4,61
7/3/2020,8,50,8,5,71
7/4/2020,9,40,7,7,63
7/5/2020,10,28,4,5,47
7/6/2020,9,25,6,7,47
7/7/2020,7,25,2,7,41
7/8/2020,8,35,9,10,62
7/9/2020,12,47,3,7,69
7/10/2020,5,25,9,6,45
7/11/2020,6,52,4,10,72
7/12/2020,12,34,3,8,57
7/13/2020,4,52,2,5,63
7/14/2020,5,41,9,4,59
7/15/2020,8,36,10,6,60
7/16/2020,6,27,4,5,42
7/17/2020,9,50,8,6,73
7/18/2020,9,47,10,7,73
7/19/2020,8,29,9,1,47
7/20/2020,4,30,2,4,40
7/21/2020,4,26,3,7,40
7/22/2020,8,26,5,5,44
7/23/2020,11,46,5,9,71
7/24/2020,7,52,3,7,69
7/25/2020,10,32,9,4,55
7/26/2020,10,49,4,3,66
7/27/2020,9,36,4,1,50
7/28/2020,9,42,2,11,64
7/29/2020,4,27,8,6,45
7/30/2020,4,55,5,0,64
7/31/2020,11,29,10,0,50
8/1/2020,5,43,8,9,65
8/2/2020,8,54,9,4,75
8/3/2020,5,55,8,5,73
8/4/2020,12,48,3,7,70
8/5/2020,4,47,10,0,61
8/6/2020,5,31,5,4,45
8/7/2020,7,38,4,5,54
8/8/2020,5,28,2,5,40
8/9/2020,11,35,2,6,54
8/10/2020,9,33,2,7,51
8/11/2020,10,32,3,3,48
8/12/2020,10,50,6,9,75
8/13/2020,7,25,6,1,39
8/14/2020,4,36,5,2,47
8/15/2020,4,54,8,5,71
8/16/2020,11,39,5,8,63
8/17/2020,11,48,2,2,63
8/18/2020,7,27,7,0,41
8/19/2020,9,30,10,6,55
8/20/2020,12,41,6,11,70
8/21/2020,5,29,6,10,50
8/22/2020,5,26,3,10,44
8/23/2020,9,39,8,11,67
8/24/2020,6,53,4,3,66
8/25/2020,9,26,10,3,48
8/26/2020,11,50,2,10,73
8/27/2020,12,54,7,2,75
8/28/2020,12,51,2,2,67
8/29/2020,4,42,2,5,53
8/30/2020,7,49,5,7,68
8/31/2020,9,31,4,8,52
9/1/2020,5,25,7,2,39
9/2/2020,9,49,3,4,65
9/3/2020,11,52,3,10,76
9/4/2020,7,49,8,9,73
9/5/2020,11,51,3,4,69
9/6/2020,5,50,8,1,64
9/7/2020,7,26,2,0,35
9/8/2020,10,30,5,3,48
9/9/2020,7,40,5,11,63
9/10/2020,4,42,10,2,58
9/11/2020,7,47,9,6,69
9/12/2020,4,34,9,0,47
9/13/2020,10,46,7,8,71
9/14/2020,8,35,10,10,63
9/15/2020,10,50,9,9,78
9/16/2020,12,37,6,7,62
9/17/2020,6,30,5,2,43
9/18/2020,11,40,7,7,65
9/19/2020,10,35,4,1,50
9/20/2020,5,36,10,10,61
9/21/2020,5,55,4,5,69
9/22/2020,5,52,7,11,75
9/23/2020,7,27,7,7,48
9/24/2020,6,48,4,8,66
9/25/2020,5,55,6,9,75
9/26/2020,9,53,4,7,73
9/27/2020,7,40,5,11,63
9/28/2020,10,52,10,3,75
9/29/2020,10,45,8,10,73
9/30/2020,4,31,8,2,45
10/1/2020,7,49,2,9,67
10/2/2020,10,41,5,0,56
10/3/2020,12,37,7,6,62
10/4/2020,4,35,3,3,45
10/5/2020,4,25,10,3,42
10/6/2020,9,28,2,11,50
10/7/2020,9,51,6,7,73
10/8/2020,4,52,5,9,70
10/9/2020,12,48,2,5,67
10/10/2020,10,28,3,1,42
10/11/2020,10,41,9,6,66
10/12/2020,6,50,9,8,73
10/13/2020,6,29,9,6,50
10/14/2020,10,42,10,9,71
10/15/2020,11,37,2,2,52
10/16/2020,9,37,3,2,51
10/17/2020,12,41,5,8,66
10/18/2020,9,32,9,9,59
10/19/2020,5,45,8,6,64
10/20/2020,6,26,7,0,39
10/21/2020,5,45,5,9,64
10/22/2020,5,52,9,1,67
10/23/2020,6,41,5,7,59
10/24/2020,12,55,2,3,72
10/25/2020,10,37,4,5,56
10/26/2020,11,39,6,2,58
10/27/2020,4,35,3,5,47
10/28/2020,9,51,4,7,71
10/29/2020,9,54,9,4,76
10/30/2020,4,43,7,6,60
10/31/2020,12,36,5,3,56
11/1/2020,12,109,7,11,139
11/2/2020,7,125,2,1,135
11/3/2020,8,129,4,4,145
11/4/2020,8,113,7,4,132
11/5/2020,8,125,6,6,145
11/6/2020,9,126,3,11,149
11/7/2020,8,130,3,10,151
11/8/2020,9,124,6,5,144
11/9/2020,10,133,9,1,153
11/10/2020,11,124,4,8,147
11/11/2020,9,128,7,11,155
11/12/2020,8,133,7,10,158
11/13/2020,9,133,8,5,155
11/14/2020,11,103,7,3,124
11/15/2020,10,135,2,11,158
11/16/2020,4,128,6,5,143
11/17/2020,6,133,9,9,157
11/18/2020,5,129,5,6,145
11/19/2020,12,121,5,7,145
11/20/2020,5,105,5,3,118
11/21/2020,7,107,6,6,126
11/22/2020,11,112,2,7,132
11/23/2020,5,120,9,11,145
11/24/2020,5,119,5,3,132
11/25/2020,12,117,5,6,140
11/26/2020,4,110,2,6,122
11/27/2020,7,123,5,0,135
11/28/2020,4,103,7,8,122
11/29/2020,12,102,7,8,129
11/30/2020,4,123,10,2,139
12/1/2020,7,108,6,7,128
12/2/2020,8,112,6,10,136
12/3/2020,4,132,3,5,144
12/4/2020,10,130,6,6,152
12/5/2020,7,119,8,6,140
12/6/2020,12,128,6,1,147
12/7/2020,7,134,4,4,149
12/8/2020,4,122,5,1,132
12/9/2020,11,123,9,8,151
12/10/2020,11,102,10,9,132
12/11/2020,10,101,3,0,114
12/12/2020,9,126,7,0,142
12/13/2020,5,105,7,7,124
12/14/2020,12,127,9,1,149
12/15/2020,9,134,6,3,152
12/16/2020,6,100,8,9,123
12/17/2020,11,128,6,11,156
12/18/2020,8,126,8,2,144
12/19/2020,9,134,3,7,153
12/20/2020,8,123,4,10,145
12/21/2020,10,121,7,9,147
12/22/2020,7,106,8,2,123
12/23/2020,12,105,10,3,130
12/24/2020,7,124,10,0,141
12/25/2020,4,113,7,11,135
12/26/2020,9,105,7,6,127
12/27/2020,7,127,5,4,143
12/28/2020,6,128,10,9,153
12/29/2020,11,134,10,8,163
12/30/2020,7,106,7,5,125
12/31/2020,12,106,8,10,136
1/1/2021,4,171,4,4,183
1/2/2021,11,147,7,10,175
1/3/2021,7,145,3,8,163
1/4/2021,12,157,4,1,174
1/5/2021,5,180,6,11,202
1/6/2021,6,160,5,3,174
1/7/2021,12,164,4,0,180
1/8/2021,10,173,3,4,190
1/9/2021,7,137,5,10,159
1/10/2021,9,137,2,1,149
1/11/2021,11,172,7,3,193
1/12/2021,11,158,2,3,174
1/13/2021,6,152,2,7,167
1/14/2021,8,163,5,5,181
1/15/2021,12,166,2,9,189
1/16/2021,12,161,2,2,177
1/17/2021,11,158,8,10,187
1/18/2021,4,145,10,0,159
1/19/2021,5,165,5,3,178
1/20/2021,10,145,10,4,169
1/21/2021,6,133,8,0,147
1/22/2021,11,184,3,5,203
1/23/2021,8,180,3,6,197
1/24/2021,7,189,4,3,203
1/25/2021,5,189,4,7,205
1/26/2021,8,195,3,2,208
1/27/2021,10,186,7,7,210
1/28/2021,4,167,3,6,180
1/29/2021,10,174,6,2,192
1/30/2021,4,196,2,10,212
1/31/2021,11,184,7,10,212
2/1/2021,4,181,9,1,195
2/2/2021,7,172,2,7,188
2/3/2021,10,153,7,1,171
2/4/2021,8,140,10,5,163
2/5/2021,5,180,9,10,204
2/6/2021,7,177,5,11,200
2/7/2021,8,133,2,6,149
2/8/2021,9,144,9,1,163
2/9/2021,8,130,6,4,148
2/10/2021,9,184,8,6,207
2/11/2021,4,196,2,1,203
2/12/2021,11,150,9,2,172
2/13/2021,4,156,7,6,173
2/14/2021,6,165,8,0,179
2/15/2021,8,187,9,7,211
2/16/2021,11,160,6,9,186
2/17/2021,4,146,4,3,157
2/18/2021,5,130,10,8,153
2/19/2021,6,150,10,5,171
2/20/2021,8,157,6,3,174
2/21/2021,10,144,5,10,169
2/22/2021,4,173,9,1,187
2/23/2021,11,195,2,10,218
2/24/2021,11,154,4,9,178
2/25/2021,11,169,4,8,192
2/26/2021,6,163,9,10,188
2/27/2021,4,134,10,9,157
2/28/2021,10,166,3,3,182
3/1/2021,8,157,7,9,181
3/2/2021,11,140,6,7,164
3/3/2021,4,144,10,9,167
3/4/2021,8,186,5,0,199
3/5/2021,6,178,9,7,200
3/6/2021,8,136,5,1,150
3/7/2021,4,172,7,5,188
3/8/2021,4,187,4,6,201
3/9/2021,4,164,7,4,179
3/10/2021,9,186,2,3,200
3/11/2021,6,139,9,3,157
3/12/2021,10,178,6,8,202
3/13/2021,5,163,6,11,185
3/14/2021,7,145,9,11,172
3/15/2021,5,167,3,11,186
3/16/2021,12,182,3,2,199
3/17/2021,6,194,10,7,217
3/18/2021,10,136,5,0,151
3/19/2021,10,194,3,10,217
3/20/2021,9,171,2,3,185
3/21/2021,10,135,10,0,155
3/22/2021,11,174,10,6,201
3/23/2021,4,159,8,11,182
3/24/2021,10,195,5,11,221
3/25/2021,7,146,5,9,167
3/26/2021,9,195,2,7,213
3/27/2021,5,193,2,3,203
3/28/2021,5,199,8,7,219
3/29/2021,5,182,9,10,206
3/30/2021,4,180,5,4,193
3/31/2021,6,187,7,11,211
4/1/2021,12,132,4,11,159
4/2/2021,5,134,6,0,145
4/3/2021,7,159,2,8,176
4/4/2021,10,160,7,1,178
4/5/2021,7,169,8,3,187
4/6/2021,4,167,9,10,190
4/7/2021,9,177,6,2,194
4/8/2021,7,141,8,0,156
4/9/2021,12,192,2,2,208
4/10/2021,8,187,4,1,200
4/11/2021,12,149,10,11,182
4/12/2021,12,158,3,9,182
4/13/2021,4,176,7,6,193
4/14/2021,12,177,6,4,199
4/15/2021,5,174,8,7,194
4/16/2021,12,157,6,4,179
4/17/2021,9,191,2,8,210
4/18/2021,12,151,4,3,170
4/19/2021,7,188,8,7,210
4/20/2021,12,138,2,2,154
4/21/2021,5,145,3,9,162
4/22/2021,9,193,7,11,220
4/23/2021,7,167,7,9,190
4/24/2021,11,161,10,10,192
4/25/2021,8,138,4,4,154
4/26/2021,5,141,6,1,153
4/27/2021,12,179,9,6,206
4/28/2021,10,168,6,1,185
4/29/2021,12,148,5,5,170
4/30/2021,10,163,4,1,178
5/1/2021,5,166,10,3,184
5/2/2021,9,147,6,6,168
5/3/2021,10,175,4,11,200
5/4/2021,12,194,7,0,213
5/5/2021,6,177,5,3,191
5/6/2021,7,170,6,2,185
5/7/2021,10,164,7,7,188
5/8/2021,6,186,10,0,202
5/9/2021,8,198,3,1,210
5/10/2021,10,158,9,0,177
5/11/2021,4,180,5,10,199
5/12/2021,7,154,7,2,170
5/13/2021,7,146,5,10,168
5/14/2021,5,169,8,11,193
5/15/2021,11,145,10,2,168
5/16/2021,8,154,3,11,176
5/17/2021,8,163,2,0,173
5/18/2021,8,191,10,0,209
5/19/2021,8,136,10,11,165
5/20/2021,6,170,6,4,186
5/21/2021,5,158,5,6,174
5/22/2021,7,199,5,2,213
5/23/2021,5,192,9,6,212
5/24/2021,8,142,7,5,162
5/25/2021,9,193,9,8,219
5/26/2021,4,146,10,3,163
5/27/2021,12,169,7,11,199
5/28/2021,12,133,4,7,156
5/29/2021,5,196,6,6,213
5/30/2021,7,183,2,8,200
5/31/2021,12,162,5,3,182
6/1/2021,10,138,4,2,154
6/2/2021,12,142,8,6,168
6/3/2021,6,156,5,7,174
6/4/2021,6,200,6,4,216
6/5/2021,12,141,6,1,160
6/6/2021,9,140,2,6,157
6/7/2021,12,137,8,7,164
6/8/2021,10,132,6,1,149
6/9/2021,10,163,6,4,183
6/10/2021,9,135,3,7,154
6/11/2021,9,163,6,0,178
6/12/2021,12,199,8,2,221
6/13/2021,8,180,7,0,195
6/14/2021,7,163,8,2,180
6/15/2021,4,151,2,3,160
6/16/2021,12,152,5,5,174
6/17/2021,8,165,3,4,180
6/18/2021,6,137,8,4,155
6/19/2021,9,184,4,11,208
6/20/2021,9,146,6,10,171
6/21/2021,8,170,8,3,189
6/22/2021,9,132,7,1,149
6/23/2021,12,151,6,10,179
6/24/2021,6,175,4,8,193
6/25/2021,10,197,4,7,218
6/26/2021,10,190,8,11,219
6/27/2021,8,135,2,7,152
6/28/2021,5,143,7,2,157
6/29/2021,12,178,8,11,209
6/30/2021,4,161,8,3,176
7/1/2021,9,186,5,6,206
7/2/2021,7,130,7,4,148
7/3/2021,10,164,6,7,187
7/4/2021,11,184,8,6,209
7/5/2021,8,199,5,3,215
7/6/2021,6,156,10,11,183
7/7/2021,9,144,9,11,173
7/8/2021,11,141,6,10,168
7/9/2021,12,154,8,11,185
7/10/2021,11,142,6,5,164
7/11/2021,8,165,9,9,191
7/12/2021,12,155,4,0,171
7/13/2021,9,177,6,10,202
7/14/2021,10,180,7,8,205
7/15/2021,7,200,3,9,219
7/16/2021,6,151,3,1,161
7/17/2021,11,186,5,8,210
7/18/2021,5,178,6,7,196
7/19/2021,5,195,7,3,210
7/20/2021,9,146,7,10,172
7/21/2021,10,193,4,8,215
7/22/2021,6,186,7,6,205
7/23/2021,10,150,9,6,175
7/24/2021,5,175,8,8,196
7/25/2021,7,194,3,5,209
7/26/2021,9,195,2,9,215
7/27/2021,4,196,10,10,220
7/28/2021,7,163,6,3,179
7/29/2021,9,176,6,4,195
7/30/2021,9,156,7,10,182
7/31/2021,12,141,3,11,167
8/1/2021,5,171,4,0,180
8/2/2021,6,164,8,2,180
8/3/2021,10,175,2,11,198
8/4/2021,4,195,8,7,214
8/5/2021,9,151,8,10,178
8/6/2021,5,168,3,2,178
8/7/2021,10,140,6,9,165
8/8/2021,11,172,2,8,193
8/9/2021,12,157,7,7,183
8/10/2021,5,186,5,9,205
8/11/2021,4,173,8,7,192
8/12/2021,9,136,6,7,158
8/13/2021,9,163,3,11,186
8/14/2021,4,168,4,5,181
8/15/2021,6,174,6,4,190
8/16/2021,5,171,8,8,192
8/17/2021,6,167,8,6,187
8/18/2021,4,138,10,2,154
8/19/2021,4,153,3,8,168
8/20/2021,4,132,4,0,140
8/21/2021,8,158,5,1,172
8/22/2021,6,150,10,8,174
8/23/2021,8,141,5,3,157
8/24/2021,4,153,7,2,166
8/25/2021,5,144,9,3,161
8/26/2021,5,170,3,10,188
8/27/2021,5,191,5,1,202
8/28/2021,9,163,7,7,186
8/29/2021,6,139,9,1,155
8/30/2021,12,186,7,5,210
8/31/2021,5,193,2,4,204
9/1/2021,4,150,6,5,165
9/2/2021,12,133,4,8,157
9/3/2021,8,190,9,6,213
9/4/2021,7,171,9,3,190
9/5/2021,9,133,2,2,146
9/6/2021,5,133,4,3,145
9/7/2021,6,165,3,2,176
9/8/2021,7,169,5,9,190
9/9/2021,6,166,5,6,183
9/10/2021,7,183,3,1,194
9/11/2021,9,155,5,10,179
9/12/2021,6,144,10,2,162
9/13/2021,4,180,5,2,191
9/14/2021,9,156,6,2,173
9/15/2021,12,148,3,9,172
9/16/2021,10,199,4,7,220
9/17/2021,8,184,6,11,209
9/18/2021,9,143,7,2,161
9/19/2021,11,139,9,1,160
9/20/2021,10,180,4,3,197
9/21/2021,8,191,4,2,205
9/22/2021,12,138,2,4,156
9/23/2021,5,180,10,1,196
9/24/2021,9,156,5,4,174
9/25/2021,4,193,3,3,203
9/26/2021,5,194,4,4,207
9/27/2021,11,193,9,8,221
9/28/2021,5,157,10,0,172
9/29/2021,7,171,6,11,195
9/30/2021,12,150,9,1,172
10/1/2021,10,193,4,10,217
10/2/2021,4,139,2,3,148
10/3/2021,5,172,10,0,187
10/4/2021,11,195,5,5,216
10/5/2021,12,165,9,7,193
10/6/2021,4,191,4,1,200
10/7/2021,5,162,7,10,184
10/8/2021,4,162,8,4,178
10/9/2021,6,167,2,5,180
10/10/2021,7,190,8,0,205
10/11/2021,5,143,8,11,167
10/12/2021,4,194,6,1,205
10/13/2021,11,136,5,2,154
10/14/2021,8,185,2,3,198
10/15/2021,12,143,3,3,161
10/16/2021,7,198,10,4,219
10/17/2021,4,186,2,4,196
10/18/2021,4,194,8,5,211
10/19/2021,11,147,4,5,167
10/20/2021,10,189,9,4,212
10/21/2021,9,161,3,0,173
10/22/2021,7,155,10,4,176
10/23/2021,11,164,2,9,186
10/24/2021,9,179,9,10,207
10/25/2021,4,139,9,1,153
10/26/2021,4,179,9,6,198
10/27/2021,4,162,7,11,184
10/28/2021,9,166,7,9,191
10/29/2021,4,147,6,9,166
10/30/2021,9,176,8,3,196
10/31/2021,12,140,8,8,168
11/1/2021,10,191,9,4,214
11/2/2021,9,192,7,11,219
11/3/2021,4,195,2,1,202
11/4/2021,7,177,4,6,194
11/5/2021,11,198,6,0,215
11/6/2021,11,144,2,1,158
11/7/2021,12,196,2,0,210
11/8/2021,11,158,8,4,181
11/9/2021,10,169,10,8,197
11/10/2021,4,168,7,1,180
11/11/2021,4,159,10,11,184
11/12/2021,6,136,10,7,159
11/13/2021,7,176,9,7,199
11/14/2021,4,135,10,11,160
11/15/2021,9,154,9,3,175
11/16/2021,7,133,5,10,155
11/17/2021,11,173,5,6,195
11/18/2021,7,155,6,9,177
11/19/2021,5,181,9,10,205
11/20/2021,7,131,9,9,156
11/21/2021,4,159,5,0,168
11/22/2021,11,138,8,10,167
11/23/2021,7,156,8,8,179
11/24/2021,9,155,8,3,175
11/25/2021,10,140,2,3,155
11/26/2021,5,164,3,9,181
11/27/2021,12,199,9,1,221
11/28/2021,8,148,3,10,169
11/29/2021,4,194,9,6,213
11/30/2021,5,186,3,5,199
12/1/2021,7,155,6,9,177
12/2/2021,9,192,9,7,217
12/3/2021,11,188,4,2,205
12/4/2021,5,167,5,10,187
12/5/2021,8,146,4,9,167
12/6/2021,10,165,8,10,193
12/7/2021,5,188,2,1,196
12/8/2021,8,163,8,1,180
12/9/2021,10,173,9,6,198
12/10/2021,7,170,4,5,186
12/11/2021,4,158,8,6,176
12/12/2021,5,198,4,11,218
12/13/2021,8,164,10,3,185
12/14/2021,11,136,4,10,161
12/15/2021,7,175,2,6,190
12/16/2021,10,195,5,2,212
12/17/2021,11,193,2,4,210
12/18/2021,10,139,5,5,159
12/19/2021,11,188,2,6,207
12/20/2021,6,160,9,8,183
12/21/2021,6,146,6,9,167
12/22/2021,11,177,10,6,204
12/23/2021,9,150,9,11,179
12/24/2021,9,184,5,10,208
12/25/2021,11,172,5,7,195
12/26/2021,8,138,4,9,159
12/27/2021,4,139,3,8,154
12/28/2021,11,136,10,11,168
12/29/2021,5,130,5,10,150
12/30/2021,9,163,4,4,180
12/31/2021,7,190,9,7,213
1/1/2022,5,192,8,1,206
1/2/2022,6,169,2,3,180
1/3/2022,4,144,4,10,162
1/4/2022,11,200,2,0,213
1/5/2022,10,197,6,2,215
1/6/2022,12,137,10,2,161
1/7/2022,4,179,2,3,188
1/8/2022,6,194,7,7,214
1/9/2022,12,156,6,5,179
1/10/2022,8,183,6,0,197
1/11/2022,5,184,8,4,201
1/12/2022,11,152,7,4,174
1/13/2022,8,187,6,2,203
1/14/2022,4,143,4,10,161
1/15/2022,11,176,10,0,197
1/16/2022,6,192,9,10,217
1/17/2022,4,188,9,3,204
1/18/2022,6,161,7,0,174
1/19/2022,7,167,6,7,187
1/20/2022,9,159,10,2,180
1/21/2022,8,197,9,9,223
1/22/2022,10,196,9,1,216
1/23/2022,11,198,9,2,220
1/24/2022,7,174,5,4,190
1/25/2022,6,132,6,5,149
1/26/2022,8,170,9,7,194
1/27/2022,9,185,7,4,205
1/28/2022,5,140,3,7,155
1/29/2022,7,192,9,7,215
1/30/2022,8,175,7,5,195
1/31/2022,4,141,8,0,153
2/1/2022,12,189,3,5,209
2/2/2022,7,178,7,10,202
2/3/2022,6,162,6,4,178
2/4/2022,5,162,6,4,177
2/5/2022,4,147,8,11,170
2/6/2022,9,188,2,6,205
2/7/2022,4,192,7,5,208
2/8/2022,8,190,7,4,209
2/9/2022,9,134,3,2,148
2/10/2022,11,141,8,7,167
2/11/2022,11,195,6,10,222
2/12/2022,11,145,4,5,165
2/13/2022,9,134,9,3,155
2/14/2022,10,186,8,5,209
2/15/2022,10,135,7,3,155
2/16/2022,12,148,8,9,177
2/17/2022,5,141,2,5,153
2/18/2022,12,186,10,11,219
2/19/2022,8,196,5,5,214
2/20/2022,9,131,2,10,152
2/21/2022,4,148,2,7,161
2/22/2022,8,198,4,1,211
2/23/2022,10,139,8,0,157
2/24/2022,10,146,9,11,176
2/25/2022,10,149,4,0,163
2/26/2022,10,200,4,1,215
2/27/2022,7,142,8,4,161
2/28/2022,8,200,10,6,224
3/1/2022,8,156,9,8,181
3/2/2022,12,167,6,5,190
3/3/2022,12,169,3,5,189
3/4/2022,4,141,9,1,155
3/5/2022,7,148,5,8,168
3/6/2022,5,182,7,6,200
3/7/2022,4,147,5,5,161
3/8/2022,10,133,10,0,153
3/9/2022,9,175,4,5,193
3/10/2022,9,160,2,10,181
3/11/2022,10,179,5,4,198
3/12/2022,5,151,9,8,173
3/13/2022,5,179,10,11,205
3/14/2022,8,191,9,10,218
3/15/2022,11,197,10,11,229
3/16/2022,7,187,6,4,204
3/17/2022,6,131,8,5,150
3/18/2022,8,160,4,1,173
3/19/2022,12,193,3,0,208
3/20/2022,9,160,2,0,171
3/21/2022,9,198,8,4,219
3/22/2022,11,191,8,5,215
3/23/2022,9,173,7,0,189
3/24/2022,8,164,3,5,180
3/25/2022,8,199,7,8,222
3/26/2022,4,165,9,0,178
3/27/2022,5,161,9,2,177
3/28/2022,11,199,3,8,221
3/29/2022,6,135,9,6,156
3/30/2022,9,198,4,4,215
3/31/2022,8,161,6,2,177
4/1/2022,10,137,7,8,162
4/2/2022,6,198,10,3,217
4/3/2022,5,172,5,1,183
4/4/2022,11,145,7,2,165
4/5/2022,12,191,7,3,213
4/6/2022,7,172,7,3,189
4/7/2022,4,187,9,5,205
4/8/2022,10,147,3,7,167
4/9/2022,10,157,3,6,176
4/10/2022,12,134,7,1,154
4/11/2022,10,200,9,6,225
4/12/2022,10,162,4,5,181
4/13/2022,10,133,4,5,152
4/14/2022,7,179,6,8,200
4/15/2022,4,130,10,5,149
4/16/2022,6,173,5,4,188
4/17/2022,11,184,6,2,203
4/18/2022,9,161,7,3,180
4/19/2022,12,134,5,1,152
4/20/2022,12,173,4,1,190
4/21/2022,5,149,8,9,171
4/22/2022,5,158,10,11,184
4/23/2022,9,136,8,5,158
4/24/2022,4,184,2,8,198
4/25/2022,9,177,5,8,199
4/26/2022,12,176,9,4,201
4/27/2022,10,170,4,3,187
4/28/2022,6,190,10,1,207
4/29/2022,9,185,6,1,201
4/30/2022,5,176,7,0,188
5/1/2022,4,177,8,9,198
5/2/2022,10,163,6,3,182
5/3/2022,7,183,10,5,205
5/4/2022,9,191,3,3,206
5/5/2022,5,200,6,4,215
5/6/2022,8,195,6,4,213
5/7/2022,5,171,9,10,195
5/8/2022,9,174,5,10,198
5/9/2022,6,183,10,0,199
5/10/2022,10,144,4,9,167
5/11/2022,12,163,8,6,189
5/12/2022,10,144,5,4,163
5/13/2022,5,168,7,7,187
5/14/2022,8,132,2,9,151
5/15/2022,8,157,2,5,172
5/16/2022,8,182,5,5,200
5/17/2022,7,140,7,7,161
5/18/2022,12,157,5,11,185
5/19/2022,6,186,10,2,204
5/20/2022,6,137,3,1,147
5/21/2022,9,190,10,0,209
5/22/2022,7,146,3,9,165
5/23/2022,9,139,10,2,160
5/24/2022,11,134,2,2,149
5/25/2022,4,149,9,6,168
5/26/2022,11,173,7,3,194
5/27/2022,4,185,10,5,204
5/28/2022,12,153,5,11,181
5/29/2022,9,166,8,7,190
5/30/2022,4,181,10,5,200
5/31/2022,11,169,8,3,191
6/1/2022,5,176,9,9,199
6/2/2022,10,164,5,11,190
6/3/2022,11,155,9,11,186
6/4/2022,4,186,8,10,208
6/5/2022,12,198,8,0,218
6/6/2022,4,148,4,11,167
6/7/2022,11,181,3,8,203
6/8/2022,4,162,4,1,171
6/9/2022,7,158,6,5,176
6/10/2022,4,143,7,0,154
6/11/2022,9,185,5,1,200
6/12/2022,12,141,6,2,161
6/13/2022,8,133,7,2,150
6/14/2022,5,144,7,9,165
6/15/2022,4,199,5,2,210
6/16/2022,10,149,5,0,164
6/17/2022,6,185,6,7,204
6/18/2022,8,135,4,0,147
6/19/2022,8,155,3,1,167
6/20/2022,9,144,7,10,170
6/21/2022,6,169,5,3,183
6/22/2022,7,130,8,7,152
6/23/2022,5,188,9,9,211
6/24/2022,9,156,8,4,177
6/25/2022,9,173,8,2,192
6/26/2022,4,170,10,3,187
6/27/2022,4,192,10,2,208
6/28/2022,5,195,5,8,213
6/29/2022,9,191,2,5,207
6/30/2022,9,156,9,9,183
7/1/2022,7,152,4,0,163
7/2/2022,6,199,8,10,223
7/3/2022,12,192,2,3,209
7/4/2022,8,179,3,1,191
7/5/2022,9,167,6,3,185
7/6/2022,9,166,5,8,188
7/7/2022,11,133,9,1,154
7/8/2022,11,183,9,11,214
7/9/2022,11,184,2,3,200
7/10/2022,8,190,9,10,217
7/11/2022,8,162,3,7,180
7/12/2022,11,178,5,0,194
7/13/2022,8,140,7,0,155
7/14/2022,10,180,3,9,202
7/15/2022,11,198,7,3,219
7/16/2022,11,153,2,3,169
7/17/2022,4,160,6,2,172
7/18/2022,11,146,10,2,169
7/19/2022,6,138,3,2,149
7/20/2022,5,159,2,1,167
7/21/2022,11,136,8,2,157
7/22/2022,4,164,2,5,175
7/23/2022,10,135,10,0,155
7/24/2022,7,179,2,10,198
7/25/2022,5,147,8,5,165
7/26/2022,11,174,9,10,204
7/27/2022,7,149,9,7,172
7/28/2022,12,185,3,5,205
7/29/2022,6,148,6,10,170
7/30/2022,6,193,7,2,208
7/31/2022,11,185,5,3,204
8/1/2022,7,196,3,4,210
8/2/2022,9,137,5,3,154
8/3/2022,8,148,8,2,166
8/4/2022,12,200,2,1,215
8/5/2022,7,198,5,3,213
8/6/2022,9,134,3,9,155
8/7/2022,11,145,10,2,168
8/8/2022,6,134,8,7,155
8/9/2022,8,191,9,4,212
8/10/2022,10,191,3,7,211
8/11/2022,9,158,4,9,180
8/12/2022,12,180,3,7,202
8/13/2022,12,145,6,6,169
8/14/2022,6,200,5,5,216
8/15/2022,8,150,9,2,169
8/16/2022,8,154,5,11,178
8/17/2022,5,170,8,7,190
8/18/2022,7,190,10,4,211
8/19/2022,7,154,9,8,178
8/20/2022,6,189,10,11,216
8/21/2022,4,156,6,9,175
8/22/2022,9,189,9,4,211
8/23/2022,6,131,10,9,156
8/24/2022,10,162,9,2,183
8/25/2022,6,147,9,0,162
8/26/2022,10,159,2,9,180
8/27/2022,5,132,2,0,139
8/28/2022,4,130,2,4,140
8/29/2022,9,194,5,0,208
8/30/2022,4,137,10,1,152
8/31/2022,8,133,4,1,146
9/1/2022,12,187,8,4,211
9/2/2022,10,137,10,6,163
9/3/2022,10,154,5,10,179
9/4/2022,6,175,5,0,186
9/5/2022,12,142,10,2,166
9/6/2022,4,155,5,10,174
9/7/2022,4,158,2,9,173
9/8/2022,12,139,7,10,168
9/9/2022,8,191,9,6,214
9/10/2022,11,172,7,7,197
9/11/2022,7,158,10,9,184
9/12/2022,9,186,6,10,211
9/13/2022,10,199,7,10,226
9/14/2022,12,130,7,9,158
9/15/2022,12,159,5,11,187
9/16/2022,7,162,2,11,182
9/17/2022,12,143,9,4,168
9/18/2022,8,162,6,4,180
9/19/2022,5,172,8,3,188
9/20/2022,11,189,3,2,205
9/21/2022,7,130,7,10,154
9/22/2022,5,148,8,11,172
9/23/2022,7,163,2,5,177
9/24/2022,10,166,9,8,193
9/25/2022,9,139,3,0,151
9/26/2022,7,147,4,6,164
9/27/2022,10,135,6,4,155
9/28/2022,7,133,4,5,149
9/29/2022,8,192,6,7,213
9/30/2022,11,157,3,9,180
10/1/2022,4,139,4,5,152
10/2/2022,4,172,6,9,191
10/3/2022,10,146,8,10,174
10/4/2022,12,183,9,3,207
10/5/2022,10,145,2,4,161
10/6/2022,7,185,3,6,201
10/7/2022,12,149,9,1,171
10/8/2022,8,141,5,4,158
10/9/2022,7,195,8,0,210
10/10/2022,12,190,8,2,212
10/11/2022,7,159,7,1,174
10/12/2022,5,158,8,1,172
10/13/2022,9,192,6,4,211
10/14/2022,8,149,6,3,166
10/15/2022,9,130,2,7,148
10/16/2022,7,152,8,3,170
10/17/2022,6,188,2,0,196
10/18/2022,12,175,10,6,203
10/19/2022,10,195,7,10,222
10/20/2022,5,152,4,7,168
10/21/2022,8,186,4,8,206
10/22/2022,5,176,7,2,190
10/23/2022,12,192,7,4,215
10/24/2022,11,152,9,7,179
10/25/2022,7,196,2,8,213
10/26/2022,6,164,5,5,180
10/27/2022,8,155,5,6,174
10/28/2022,9,186,2,7,204
10/29/2022,9,163,6,4,182
10/30/2022,7,141,9,2,159
10/31/2022,4,142,6,2,154
11/1/2022,7,143,5,2,157
11/2/2022,8,200,10,5,223
11/3/2022,11,149,10,0,170
11/4/2022,8,142,7,5,162
11/5/2022,5,172,5,3,185
11/6/2022,11,169,3,0,183
11/7/2022,10,164,5,3,182
11/8/2022,10,195,8,2,215
11/9/2022,10,190,4,4,208
11/10/2022,8,148,4,10,170
11/11/2022,9,175,2,2,188
11/12/2022,8,171,2,11,192
11/13/2022,7,145,2,4,158
11/14/2022,6,153,2,5,166
11/15/2022,6,145,3,9,163
11/16/2022,7,137,7,3,154
11/17/2022,11,163,6,5,185
11/18/2022,7,164,7,6,184
11/19/2022,6,155,4,9,174
11/20/2022,9,200,8,1,218
11/21/2022,8,165,2,7,182
11/22/2022,11,181,2,3,197
11/23/2022,11,187,9,9,216
11/24/2022,5,185,6,11,207
11/25/2022,5,174,10,2,191
11/26/2022,7,199,5,6,217
11/27/2022,7,189,5,5,206
11/28/2022,10,164,3,10,187
11/29/2022,8,154,9,2,173
11/30/2022,12,186,5,6,209
12/1/2022,4,157,4,6,171
12/2/2022,5,184,8,7,204
12/3/2022,10,152,10,0,172
12/4/2022,7,170,2,4,183
12/5/2022,6,141,8,6,161
12/6/2022,12,194,2,5,213
12/7/2022,12,181,5,0,198
12/8/2022,12,141,2,0,155
12/9/2022,12,196,2,1,211
12/10/2022,12,175,8,6,201
12/11/2022,4,173,10,1,188
12/12/2022,8,142,9,7,166
12/13/2022,9,177,9,11,206
12/14/2022,12,170,9,7,198
12/15/2022,12,184,3,10,209
12/16/2022,5,173,5,7,190
12/17/2022,6,170,3,8,187
12/18/2022,5,163,10,5,183
12/19/2022,5,135,9,5,154
12/20/2022,10,156,3,11,180
12/21/2022,7,151,4,9,171
12/22/2022,9,151,4,7,171
12/23/2022,7,170,4,0,181
12/24/2022,6,154,10,9,179
12/25/2022,12,147,2,1,162
12/26/2022,6,147,9,2,164
12/27/2022,11,133,8,5,157
12/28/2022,10,176,2,0,188
12/29/2022,12,185,4,9,210
12/30/2022,12,192,3,8,215
12/31/2022,4,187,7,9,207
