admit_date,flu,covid,malaria,others,madurai_total_count
1/1/1970,12,0,3,15,30
1/2/1970,13,0,4,1,18
1/3/1970,14,0,16,5,35
1/4/1970,8,0,14,0,22
1/5/1970,4,0,10,15,29
1/6/1970,7,0,4,10,21
1/7/1970,12,0,13,12,37
1/8/1970,14,0,6,11,31
1/9/1970,7,0,13,11,31
1/10/1970,9,0,11,12,32
1/11/1970,12,0,12,0,24
1/12/1970,12,0,10,9,31
1/13/1970,8,0,8,6,22
1/14/1970,13,0,9,0,22
1/15/1970,12,0,5,13,30
1/16/1970,16,0,13,11,40
1/17/1970,8,0,8,10,26
1/18/1970,7,0,3,12,22
1/19/1970,4,0,3,6,13
1/20/1970,9,0,10,13,32
1/21/1970,12,0,4,14,30
1/22/1970,9,0,5,1,15
1/23/1970,12,0,4,7,23
1/24/1970,6,0,2,6,14
1/25/1970,7,0,6,1,14
1/26/1970,16,0,8,7,31
1/27/1970,15,0,13,1,29
1/28/1970,4,0,12,13,29
1/29/1970,16,0,8,7,31
1/30/1970,14,0,7,16,37
1/31/1970,6,0,3,7,16
2/1/1970,7,0,8,15,30
2/2/1970,14,0,2,0,16
2/3/1970,7,0,7,5,19
2/4/1970,14,0,14,14,42
2/5/1970,10,0,4,10,24
2/6/1970,6,0,11,14,31
2/7/1970,7,0,4,4,15
2/8/1970,16,0,7,7,30
2/9/1970,8,0,8,16,32
2/10/1970,11,0,10,12,33
2/11/1970,10,0,7,6,23
2/12/1970,14,0,6,14,34
2/13/1970,5,0,9,6,20
2/14/1970,10,0,11,3,24
2/15/1970,8,0,15,5,28
2/16/1970,4,0,10,11,25
2/17/1970,16,0,8,6,30
2/18/1970,9,0,9,9,27
2/19/1970,15,0,6,8,29
2/20/1970,8,0,6,13,27
2/21/1970,13,0,16,4,33
2/22/1970,9,0,5,9,23
2/23/1970,11,0,9,0,20
2/24/1970,16,0,2,7,25
2/25/1970,15,0,13,7,35
2/26/1970,15,0,3,9,27
2/27/1970,7,0,12,1,20
2/28/1970,14,0,14,15,43
3/1/1970,10,0,3,15,28
3/2/1970,12,0,12,1,25
3/3/1970,4,0,16,3,23
3/4/1970,10,0,16,13,39
3/5/1970,6,0,7,14,27
3/6/1970,16,0,9,6,31
3/7/1970,10,0,7,6,23
3/8/1970,4,0,14,7,25
3/9/1970,7,0,10,12,29
3/10/1970,11,0,15,2,28
3/11/1970,7,0,3,15,25
3/12/1970,5,0,2,14,21
3/13/1970,7,0,16,13,36
3/14/1970,9,0,11,6,26
3/15/1970,7,0,14,4,25
3/16/1970,16,0,13,13,42
3/17/1970,4,0,8,0,12
3/18/1970,14,0,14,16,44
3/19/1970,8,0,9,9,26
3/20/1970,13,0,4,3,20
3/21/1970,5,0,13,16,34
3/22/1970,15,0,7,9,31
3/23/1970,10,0,16,12,38
3/24/1970,16,0,6,11,33
3/25/1970,16,0,16,9,41
3/26/1970,7,0,4,4,15
3/27/1970,9,0,9,6,24
3/28/1970,12,0,13,4,29
3/29/1970,5,0,11,2,18
3/30/1970,13,0,7,12,32
3/31/1970,13,0,15,10,38
4/1/1970,11,0,9,0,20
4/2/1970,16,0,6,10,32
4/3/1970,12,0,12,11,35
4/4/1970,9,0,4,1,14
4/5/1970,16,0,10,10,36
4/6/1970,15,0,10,4,29
4/7/1970,7,0,9,1,17
4/8/1970,16,0,7,3,26
4/9/1970,16,0,7,2,25
4/10/1970,10,0,8,7,25
4/11/1970,16,0,10,6,32
4/12/1970,15,0,2,16,33
4/13/1970,8,0,8,12,28
4/14/1970,12,0,16,3,31
4/15/1970,13,0,12,7,32
4/16/1970,12,0,8,3,23
4/17/1970,14,0,5,12,31
4/18/1970,9,0,7,9,25
4/19/1970,10,0,3,10,23
4/20/1970,9,0,7,6,22
4/21/1970,5,0,2,7,14
4/22/1970,16,0,13,9,38
4/23/1970,14,0,2,4,20
4/24/1970,8,0,5,0,13
4/25/1970,4,0,14,0,18
4/26/1970,9,0,13,15,37
4/27/1970,12,0,14,6,32
4/28/1970,11,0,12,16,39
4/29/1970,11,0,2,15,28
4/30/1970,14,0,11,1,26
5/1/1970,6,0,16,15,37
5/2/1970,13,0,14,7,34
5/3/1970,16,0,12,2,30
5/4/1970,4,0,5,10,19
5/5/1970,7,0,15,10,32
5/6/1970,4,0,16,9,29
5/7/1970,16,0,2,7,25
5/8/1970,10,0,12,9,31
5/9/1970,15,0,2,4,21
5/10/1970,5,0,12,13,30
5/11/1970,4,0,15,16,35
5/12/1970,11,0,10,6,27
5/13/1970,8,0,15,6,29
5/14/1970,11,0,5,5,21
5/15/1970,13,0,5,8,26
5/16/1970,7,0,3,9,19
5/17/1970,9,0,10,14,33
5/18/1970,15,0,7,3,25
5/19/1970,11,0,11,16,38
5/20/1970,16,0,2,5,23
5/21/1970,15,0,7,9,31
5/22/1970,9,0,7,12,28
5/23/1970,9,0,11,5,25
5/24/1970,4,0,3,14,21
5/25/1970,9,0,8,3,20
5/26/1970,14,0,14,16,44
5/27/1970,13,0,12,9,34
5/28/1970,14,0,4,4,22
5/29/1970,15,0,7,13,35
5/30/1970,15,0,13,9,37
5/31/1970,15,0,3,16,34
6/1/1970,7,0,11,2,20
6/2/1970,15,0,10,10,35
6/3/1970,9,0,13,13,35
6/4/1970,9,0,7,8,24
6/5/1970,13,0,15,13,41
6/6/1970,12,0,12,7,31
6/7/1970,9,0,8,0,17
6/8/1970,11,0,10,16,37
6/9/1970,11,0,11,11,33
6/10/1970,9,0,2,16,27
6/11/1970,10,0,11,16,37
6/12/1970,7,0,7,1,15
6/13/1970,12,0,11,10,33
6/14/1970,14,0,2,0,16
6/15/1970,11,0,10,0,21
6/16/1970,14,0,12,9,35
6/17/1970,15,0,9,11,35
6/18/1970,6,0,3,14,23
6/19/1970,5,0,3,10,18
6/20/1970,7,0,12,3,22
6/21/1970,10,0,3,8,21
6/22/1970,5,0,16,12,33
6/23/1970,9,0,10,16,35
6/24/1970,14,0,9,1,24
6/25/1970,10,0,12,15,37
6/26/1970,5,0,10,14,29
6/27/1970,5,0,14,7,26
6/28/1970,10,0,7,1,18
6/29/1970,8,0,11,2,21
6/30/1970,7,0,14,11,32
7/1/1970,12,0,2,15,29
7/2/1970,9,0,15,14,38
7/3/1970,10,0,5,4,19
7/4/1970,12,0,10,5,27
7/5/1970,11,0,7,5,23
7/6/1970,10,0,14,12,36
7/7/1970,13,0,4,10,27
7/8/1970,12,0,7,14,33
7/9/1970,9,0,12,16,37
7/10/1970,10,0,6,11,27
7/11/1970,14,0,11,13,38
7/12/1970,14,0,12,16,42
7/13/1970,7,0,7,9,23
7/14/1970,9,0,10,12,31
7/15/1970,8,0,13,8,29
7/16/1970,10,0,3,0,13
7/17/1970,11,0,6,14,31
7/18/1970,11,0,13,10,34
7/19/1970,4,0,9,3,16
7/20/1970,5,0,8,10,23
7/21/1970,15,0,4,5,24
7/22/1970,14,0,5,5,24
7/23/1970,4,0,12,13,29
7/24/1970,14,0,7,3,24
7/25/1970,13,0,11,1,25
7/26/1970,10,0,8,13,31
7/27/1970,5,0,16,7,28
7/28/1970,9,0,14,7,30
7/29/1970,16,0,8,2,26
7/30/1970,8,0,9,0,17
7/31/1970,5,0,13,3,21
8/1/1970,4,0,6,9,19
8/2/1970,13,0,6,0,19
8/3/1970,8,0,16,15,39
8/4/1970,4,0,3,4,11
8/5/1970,9,0,6,0,15
8/6/1970,16,0,8,7,31
8/7/1970,14,0,16,10,40
8/8/1970,8,0,6,1,15
8/9/1970,13,0,8,14,35
8/10/1970,14,0,4,13,31
8/11/1970,6,0,8,0,14
8/12/1970,13,0,10,16,39
8/13/1970,9,0,16,9,34
8/14/1970,10,0,10,0,20
8/15/1970,5,0,10,9,24
8/16/1970,5,0,2,5,12
8/17/1970,8,0,9,1,18
8/18/1970,4,0,5,9,18
8/19/1970,15,0,5,6,26
8/20/1970,11,0,14,2,27
8/21/1970,16,0,2,3,21
8/22/1970,9,0,12,3,24
8/23/1970,13,0,14,2,29
8/24/1970,10,0,14,9,33
8/25/1970,11,0,3,2,16
8/26/1970,8,0,11,6,25
8/27/1970,7,0,13,3,23
8/28/1970,4,0,10,15,29
8/29/1970,16,0,4,2,22
8/30/1970,10,0,14,8,32
8/31/1970,9,0,2,6,17
9/1/1970,4,0,2,11,17
9/2/1970,8,0,5,11,24
9/3/1970,7,0,10,6,23
9/4/1970,12,0,16,1,29
9/5/1970,5,0,14,15,34
9/6/1970,10,0,15,1,26
9/7/1970,5,0,5,6,16
9/8/1970,16,0,9,11,36
9/9/1970,10,0,4,3,17
9/10/1970,16,0,3,15,34
9/11/1970,8,0,11,13,32
9/12/1970,13,0,7,6,26
9/13/1970,10,0,14,8,32
9/14/1970,13,0,12,16,41
9/15/1970,16,0,13,15,44
9/16/1970,12,0,14,0,26
9/17/1970,6,0,11,14,31
9/18/1970,6,0,11,10,27
9/19/1970,13,0,4,8,25
9/20/1970,5,0,4,5,14
9/21/1970,7,0,2,6,15
9/22/1970,9,0,4,10,23
9/23/1970,14,0,4,12,30
9/24/1970,15,0,5,16,36
9/25/1970,6,0,10,14,30
9/26/1970,13,0,6,3,22
9/27/1970,9,0,16,6,31
9/28/1970,12,0,6,10,28
9/29/1970,6,0,13,14,33
9/30/1970,5,0,7,12,24
10/1/1970,15,0,7,0,22
10/2/1970,9,0,8,14,31
10/3/1970,9,0,9,9,27
10/4/1970,10,0,10,15,35
10/5/1970,13,0,15,16,44
10/6/1970,7,0,10,7,24
10/7/1970,5,0,6,7,18
10/8/1970,11,0,7,0,18
10/9/1970,13,0,13,9,35
10/10/1970,8,0,9,2,19
10/11/1970,12,0,9,10,31
10/12/1970,12,0,15,9,36
10/13/1970,16,0,8,15,39
10/14/1970,9,0,8,11,28
10/15/1970,14,0,9,3,26
10/16/1970,16,0,9,5,30
10/17/1970,7,0,14,5,26
10/18/1970,9,0,5,15,29
10/19/1970,11,0,14,7,32
10/20/1970,9,0,12,14,35
10/21/1970,15,0,12,16,43
10/22/1970,15,0,4,11,30
10/23/1970,12,0,10,1,23
10/24/1970,16,0,12,5,33
10/25/1970,13,0,12,14,39
10/26/1970,5,0,5,11,21
10/27/1970,9,0,4,12,25
10/28/1970,10,0,9,8,27
10/29/1970,12,0,4,3,19
10/30/1970,10,0,7,10,27
10/31/1970,6,0,5,2,13
11/1/1970,8,0,16,15,39
11/2/1970,6,0,5,1,12
11/3/1970,12,0,8,7,27
11/4/1970,12,0,13,6,31
11/5/1970,13,0,12,8,33
11/6/1970,14,0,11,9,34
11/7/1970,9,0,3,8,20
11/8/1970,6,0,6,16,28
11/9/1970,13,0,15,15,43
11/10/1970,8,0,16,14,38
11/11/1970,7,0,9,16,32
11/12/1970,14,0,16,3,33
11/13/1970,4,0,8,9,21
11/14/1970,13,0,12,15,40
11/15/1970,11,0,7,8,26
11/16/1970,13,0,4,7,24
11/17/1970,10,0,8,14,32
11/18/1970,16,0,2,12,30
11/19/1970,10,0,14,14,38
11/20/1970,5,0,6,10,21
11/21/1970,12,0,5,0,17
11/22/1970,6,0,7,11,24
11/23/1970,12,0,11,3,26
11/24/1970,8,0,14,3,25
11/25/1970,6,0,10,1,17
11/26/1970,6,0,10,16,32
11/27/1970,12,0,9,14,35
11/28/1970,15,0,7,13,35
11/29/1970,15,0,13,5,33
11/30/1970,6,0,16,16,38
12/1/1970,7,0,13,3,23
12/2/1970,8,0,15,14,37
12/3/1970,10,0,13,10,33
12/4/1970,8,0,8,13,29
12/5/1970,6,0,7,12,25
12/6/1970,12,0,10,6,28
12/7/1970,14,0,16,0,30
12/8/1970,8,0,16,10,34
12/9/1970,16,0,5,1,22
12/10/1970,10,0,6,6,22
12/11/1970,4,0,10,14,28
12/12/1970,5,0,5,10,20
12/13/1970,7,0,7,3,17
12/14/1970,15,0,3,9,27
12/15/1970,12,0,3,15,30
12/16/1970,4,0,9,9,22
12/17/1970,11,0,6,7,24
12/18/1970,12,0,10,9,31
12/19/1970,12,0,14,2,28
12/20/1970,12,0,8,8,28
12/21/1970,13,0,12,10,35
12/22/1970,9,0,15,7,31
12/23/1970,8,0,9,6,23
12/24/1970,14,0,9,1,24
12/25/1970,10,0,2,7,19
12/26/1970,11,0,9,16,36
12/27/1970,7,0,8,16,31
12/28/1970,12,0,5,1,18
12/29/1970,9,0,3,8,20
12/30/1970,7,0,9,14,30
12/31/1970,7,0,14,11,32
1/1/1971,5,0,2,6,13
1/2/1971,7,0,9,2,18
1/3/1971,14,0,14,4,32
1/4/1971,16,0,4,9,29
1/5/1971,9,0,7,15,31
1/6/1971,13,0,9,9,31
1/7/1971,4,0,5,4,13
1/8/1971,6,0,4,12,22
1/9/1971,11,0,3,15,29
1/10/1971,7,0,6,1,14
1/11/1971,11,0,2,9,22
1/12/1971,6,0,16,5,27
1/13/1971,15,0,4,4,23
1/14/1971,14,0,9,15,38
1/15/1971,11,0,4,13,28
1/16/1971,10,0,15,5,30
1/17/1971,13,0,3,1,17
1/18/1971,5,0,12,11,28
1/19/1971,5,0,2,2,9
1/20/1971,7,0,4,13,24
1/21/1971,4,0,8,8,20
1/22/1971,9,0,5,13,27
1/23/1971,12,0,14,13,39
1/24/1971,14,0,11,7,32
1/25/1971,9,0,5,15,29
1/26/1971,15,0,6,5,26
1/27/1971,6,0,5,14,25
1/28/1971,12,0,15,10,37
1/29/1971,16,0,2,6,24
1/30/1971,4,0,2,9,15
1/31/1971,14,0,13,2,29
2/1/1971,6,0,13,4,23
2/2/1971,13,0,2,1,16
2/3/1971,5,0,12,1,18
2/4/1971,13,0,4,5,22
2/5/1971,12,0,3,7,22
2/6/1971,15,0,15,1,31
2/7/1971,15,0,5,7,27
2/8/1971,16,0,16,2,34
2/9/1971,6,0,14,8,28
2/10/1971,13,0,12,16,41
2/11/1971,9,0,10,0,19
2/12/1971,4,0,11,6,21
2/13/1971,14,0,5,2,21
2/14/1971,13,0,8,15,36
2/15/1971,6,0,6,1,13
2/16/1971,6,0,3,14,23
2/17/1971,6,0,13,12,31
2/18/1971,5,0,6,4,15
2/19/1971,13,0,2,7,22
2/20/1971,13,0,16,11,40
2/21/1971,13,0,9,7,29
2/22/1971,4,0,15,6,25
2/23/1971,9,0,2,3,14
2/24/1971,15,0,12,1,28
2/25/1971,5,0,13,16,34
2/26/1971,8,0,12,0,20
2/27/1971,11,0,9,10,30
2/28/1971,7,0,5,13,25
3/1/1971,14,0,11,9,34
3/2/1971,11,0,7,10,28
3/3/1971,12,0,3,0,15
3/4/1971,16,0,3,1,20
3/5/1971,8,0,6,5,19
3/6/1971,13,0,12,6,31
3/7/1971,4,0,7,3,14
3/8/1971,13,0,12,5,30
3/9/1971,7,0,7,12,26
3/10/1971,6,0,3,14,23
3/11/1971,7,0,6,8,21
3/12/1971,6,0,7,12,25
3/13/1971,13,0,12,2,27
3/14/1971,13,0,4,9,26
3/15/1971,4,0,5,4,13
3/16/1971,6,0,9,15,30
3/17/1971,9,0,2,16,27
3/18/1971,4,0,12,1,17
3/19/1971,6,0,5,5,16
3/20/1971,7,0,15,8,30
3/21/1971,12,0,15,2,29
3/22/1971,4,0,8,6,18
3/23/1971,9,0,7,9,25
3/24/1971,10,0,8,13,31
3/25/1971,4,0,6,11,21
3/26/1971,11,0,5,0,16
3/27/1971,16,0,2,4,22
3/28/1971,5,0,2,15,22
3/29/1971,6,0,7,16,29
3/30/1971,6,0,8,3,17
3/31/1971,6,0,13,8,27
4/1/1971,16,0,7,15,38
4/2/1971,13,0,14,15,42
4/3/1971,10,0,9,2,21
4/4/1971,14,0,5,7,26
4/5/1971,14,0,8,10,32
4/6/1971,16,0,4,6,26
4/7/1971,10,0,4,4,18
4/8/1971,12,0,6,7,25
4/9/1971,9,0,13,12,34
4/10/1971,6,0,12,4,22
4/11/1971,14,0,11,12,37
4/12/1971,5,0,14,16,35
4/13/1971,10,0,3,3,16
4/14/1971,13,0,10,14,37
4/15/1971,12,0,16,6,34
4/16/1971,13,0,2,13,28
4/17/1971,12,0,9,13,34
4/18/1971,11,0,13,3,27
4/19/1971,8,0,16,7,31
4/20/1971,13,0,4,16,33
4/21/1971,16,0,10,2,28
4/22/1971,10,0,3,7,20
4/23/1971,8,0,2,8,18
4/24/1971,12,0,12,8,32
4/25/1971,10,0,2,13,25
4/26/1971,9,0,10,9,28
4/27/1971,7,0,5,6,18
4/28/1971,6,0,16,10,32
4/29/1971,15,0,7,9,31
4/30/1971,7,0,10,13,30
5/1/1971,12,0,14,1,27
5/2/1971,5,0,6,3,14
5/3/1971,4,0,13,13,30
5/4/1971,6,0,6,16,28
5/5/1971,13,0,2,7,22
5/6/1971,13,0,6,14,33
5/7/1971,10,0,6,14,30
5/8/1971,14,0,11,14,39
5/9/1971,10,0,10,11,31
5/10/1971,12,0,15,6,33
5/11/1971,9,0,13,2,24
5/12/1971,5,0,14,5,24
5/13/1971,7,0,16,4,27
5/14/1971,4,0,7,9,20
5/15/1971,11,0,14,15,40
5/16/1971,11,0,3,3,17
5/17/1971,14,0,10,12,36
5/18/1971,16,0,15,3,34
5/19/1971,14,0,13,4,31
5/20/1971,12,0,14,4,30
5/21/1971,9,0,3,16,28
5/22/1971,5,0,15,14,34
5/23/1971,14,0,15,14,43
5/24/1971,7,0,8,11,26
5/25/1971,6,0,7,5,18
5/26/1971,5,0,13,4,22
5/27/1971,7,0,10,3,20
5/28/1971,8,0,8,8,24
5/29/1971,11,0,10,16,37
5/30/1971,16,0,2,1,19
5/31/1971,8,0,7,3,18
6/1/1971,12,0,10,1,23
6/2/1971,12,0,2,2,16
6/3/1971,14,0,7,2,23
6/4/1971,10,0,2,8,20
6/5/1971,13,0,16,13,42
6/6/1971,9,0,16,8,33
6/7/1971,5,0,14,13,32
6/8/1971,11,0,14,7,32
6/9/1971,11,0,10,4,25
6/10/1971,8,0,3,5,16
6/11/1971,4,0,6,0,10
6/12/1971,12,0,4,8,24
6/13/1971,8,0,3,1,12
6/14/1971,9,0,6,0,15
6/15/1971,10,0,16,6,32
6/16/1971,16,0,11,6,33
6/17/1971,6,0,7,13,26
6/18/1971,16,0,9,2,27
6/19/1971,15,0,12,2,29
6/20/1971,8,0,2,4,14
6/21/1971,16,0,9,5,30
6/22/1971,6,0,11,3,20
6/23/1971,10,0,16,4,30
6/24/1971,5,0,4,10,19
6/25/1971,10,0,16,14,40
6/26/1971,14,0,11,3,28
6/27/1971,8,0,11,6,25
6/28/1971,5,0,2,10,17
6/29/1971,14,0,16,0,30
6/30/1971,5,0,14,9,28
7/1/1971,6,0,15,16,37
7/2/1971,12,0,11,11,34
7/3/1971,12,0,9,11,32
7/4/1971,6,0,14,12,32
7/5/1971,7,0,2,13,22
7/6/1971,4,0,13,10,27
7/7/1971,15,0,10,13,38
7/8/1971,4,0,5,9,18
7/9/1971,10,0,15,8,33
7/10/1971,7,0,7,0,14
7/11/1971,13,0,12,13,38
7/12/1971,4,0,12,10,26
7/13/1971,7,0,2,13,22
7/14/1971,6,0,16,4,26
7/15/1971,9,0,10,14,33
7/16/1971,14,0,3,0,17
7/17/1971,16,0,16,13,45
7/18/1971,10,0,5,5,20
7/19/1971,8,0,15,9,32
7/20/1971,4,0,7,6,17
7/21/1971,5,0,6,12,23
7/22/1971,5,0,7,14,26
7/23/1971,11,0,11,0,22
7/24/1971,11,0,14,8,33
7/25/1971,10,0,6,15,31
7/26/1971,13,0,2,13,28
7/27/1971,12,0,8,3,23
7/28/1971,15,0,10,6,31
7/29/1971,13,0,8,4,25
7/30/1971,6,0,7,4,17
7/31/1971,12,0,3,11,26
8/1/1971,14,0,10,3,27
8/2/1971,5,0,13,0,18
8/3/1971,13,0,15,12,40
8/4/1971,9,0,11,4,24
8/5/1971,10,0,7,16,33
8/6/1971,8,0,8,12,28
8/7/1971,15,0,3,14,32
8/8/1971,7,0,5,14,26
8/9/1971,16,0,5,3,24
8/10/1971,11,0,6,12,29
8/11/1971,5,0,12,4,21
8/12/1971,15,0,3,16,34
8/13/1971,13,0,2,15,30
8/14/1971,4,0,7,16,27
8/15/1971,11,0,8,12,31
8/16/1971,4,0,14,9,27
8/17/1971,9,0,6,6,21
8/18/1971,6,0,4,13,23
8/19/1971,10,0,14,9,33
8/20/1971,15,0,14,5,34
8/21/1971,6,0,16,6,28
8/22/1971,14,0,6,14,34
8/23/1971,11,0,10,4,25
8/24/1971,12,0,14,5,31
8/25/1971,12,0,3,8,23
8/26/1971,15,0,7,11,33
8/27/1971,10,0,16,0,26
8/28/1971,14,0,13,8,35
8/29/1971,8,0,8,1,17
8/30/1971,6,0,6,4,16
8/31/1971,9,0,9,11,29
9/1/1971,9,0,4,10,23
9/2/1971,11,0,16,0,27
9/3/1971,16,0,11,7,34
9/4/1971,4,0,14,10,28
9/5/1971,16,0,8,0,24
9/6/1971,4,0,6,2,12
9/7/1971,8,0,9,2,19
9/8/1971,12,0,3,15,30
9/9/1971,10,0,10,12,32
9/10/1971,15,0,2,16,33
9/11/1971,10,0,3,1,14
9/12/1971,6,0,6,13,25
9/13/1971,11,0,6,7,24
9/14/1971,7,0,12,8,27
9/15/1971,13,0,13,7,33
9/16/1971,14,0,4,3,21
9/17/1971,12,0,10,2,24
9/18/1971,15,0,2,15,32
9/19/1971,12,0,10,4,26
9/20/1971,15,0,9,12,36
9/21/1971,8,0,6,12,26
9/22/1971,10,0,3,0,13
9/23/1971,12,0,10,4,26
9/24/1971,16,0,16,15,47
9/25/1971,14,0,11,4,29
9/26/1971,9,0,4,10,23
9/27/1971,4,0,5,14,23
9/28/1971,11,0,16,9,36
9/29/1971,5,0,13,1,19
9/30/1971,11,0,7,8,26
10/1/1971,4,0,16,6,26
10/2/1971,7,0,9,5,21
10/3/1971,13,0,9,6,28
10/4/1971,14,0,15,16,45
10/5/1971,8,0,10,15,33
10/6/1971,10,0,9,10,29
10/7/1971,13,0,10,6,29
10/8/1971,12,0,9,9,30
10/9/1971,15,0,9,12,36
10/10/1971,13,0,6,16,35
10/11/1971,9,0,4,7,20
10/12/1971,6,0,7,16,29
10/13/1971,10,0,16,9,35
10/14/1971,11,0,7,10,28
10/15/1971,8,0,5,12,25
10/16/1971,4,0,11,6,21
10/17/1971,10,0,7,15,32
10/18/1971,8,0,4,13,25
10/19/1971,10,0,14,9,33
10/20/1971,15,0,11,2,28
10/21/1971,6,0,3,7,16
10/22/1971,11,0,11,10,32
10/23/1971,7,0,10,1,18
10/24/1971,12,0,5,10,27
10/25/1971,16,0,11,6,33
10/26/1971,5,0,11,11,27
10/27/1971,7,0,16,15,38
10/28/1971,5,0,2,4,11
10/29/1971,8,0,14,5,27
10/30/1971,16,0,6,10,32
10/31/1971,11,0,13,6,30
11/1/1971,8,0,7,1,16
11/2/1971,16,0,4,11,31
11/3/1971,10,0,10,3,23
11/4/1971,9,0,13,6,28
11/5/1971,10,0,5,10,25
11/6/1971,4,0,7,13,24
11/7/1971,12,0,6,4,22
11/8/1971,6,0,6,12,24
11/9/1971,5,0,12,11,28
11/10/1971,16,0,10,0,26
11/11/1971,15,0,9,2,26
11/12/1971,4,0,4,5,13
11/13/1971,9,0,4,13,26
11/14/1971,6,0,12,11,29
11/15/1971,9,0,3,6,18
11/16/1971,12,0,7,8,27
11/17/1971,10,0,10,14,34
11/18/1971,6,0,14,11,31
11/19/1971,12,0,4,1,17
11/20/1971,11,0,10,9,30
11/21/1971,9,0,2,6,17
11/22/1971,4,0,15,6,25
11/23/1971,9,0,14,14,37
11/24/1971,14,0,8,0,22
11/25/1971,12,0,14,8,34
11/26/1971,12,0,9,0,21
11/27/1971,14,0,12,4,30
11/28/1971,16,0,9,16,41
11/29/1971,4,0,11,8,23
11/30/1971,4,0,13,14,31
12/1/1971,11,0,16,14,41
12/2/1971,10,0,4,6,20
12/3/1971,11,0,14,13,38
12/4/1971,9,0,9,1,19
12/5/1971,13,0,12,10,35
12/6/1971,12,0,5,7,24
12/7/1971,8,0,12,7,27
12/8/1971,12,0,3,6,21
12/9/1971,14,0,11,5,30
12/10/1971,5,0,12,1,18
12/11/1971,5,0,8,9,22
12/12/1971,5,0,2,3,10
12/13/1971,12,0,11,3,26
12/14/1971,7,0,16,8,31
12/15/1971,16,0,10,14,40
12/16/1971,11,0,10,11,32
12/17/1971,7,0,14,1,22
12/18/1971,6,0,7,4,17
12/19/1971,12,0,6,3,21
12/20/1971,16,0,4,2,22
12/21/1971,11,0,9,15,35
12/22/1971,6,0,12,4,22
12/23/1971,9,0,6,6,21
12/24/1971,9,0,8,16,33
12/25/1971,12,0,10,10,32
12/26/1971,14,0,7,0,21
12/27/1971,5,0,4,11,20
12/28/1971,11,0,6,15,32
12/29/1971,11,0,11,8,30
12/30/1971,5,0,12,8,25
12/31/1971,8,0,10,14,32
1/1/1972,8,0,9,8,25
1/2/1972,15,0,3,14,32
1/3/1972,9,0,12,6,27
1/4/1972,15,0,9,10,34
1/5/1972,4,0,7,9,20
1/6/1972,8,0,10,0,18
1/7/1972,9,0,14,3,26
1/8/1972,6,0,11,14,31
1/9/1972,16,0,6,7,29
1/10/1972,5,0,15,9,29
1/11/1972,15,0,9,7,31
1/12/1972,11,0,10,15,36
1/13/1972,9,0,4,11,24
1/14/1972,7,0,11,5,23
1/15/1972,6,0,12,15,33
1/16/1972,6,0,15,5,26
1/17/1972,4,0,14,0,18
1/18/1972,15,0,12,1,28
1/19/1972,12,0,4,0,16
1/20/1972,9,0,13,7,29
1/21/1972,11,0,7,5,23
1/22/1972,15,0,3,10,28
1/23/1972,16,0,12,10,38
1/24/1972,10,0,8,2,20
1/25/1972,13,0,3,2,18
1/26/1972,7,0,10,14,31
1/27/1972,12,0,11,10,33
1/28/1972,5,0,12,14,31
1/29/1972,5,0,16,14,35
1/30/1972,14,0,10,6,30
1/31/1972,13,0,10,6,29
2/1/1972,8,0,5,9,22
2/2/1972,14,0,13,8,35
2/3/1972,10,0,9,9,28
2/4/1972,16,0,16,12,44
2/5/1972,4,0,8,2,14
2/6/1972,15,0,11,13,39
2/7/1972,8,0,7,6,21
2/8/1972,9,0,14,9,32
2/9/1972,9,0,13,0,22
2/10/1972,11,0,7,10,28
2/11/1972,6,0,14,16,36
2/12/1972,10,0,2,6,18
2/13/1972,7,0,12,11,30
2/14/1972,16,0,14,3,33
2/15/1972,16,0,16,14,46
2/16/1972,12,0,14,13,39
2/17/1972,9,0,13,1,23
2/18/1972,15,0,3,3,21
2/19/1972,15,0,16,9,40
2/20/1972,11,0,16,11,38
2/21/1972,11,0,6,3,20
2/22/1972,12,0,15,13,40
2/23/1972,14,0,2,0,16
2/24/1972,11,0,3,14,28
2/25/1972,4,0,12,11,27
2/26/1972,7,0,3,7,17
2/27/1972,12,0,6,3,21
2/28/1972,8,0,14,5,27
2/29/1972,13,0,16,10,39
3/1/1972,9,0,10,9,28
3/2/1972,5,0,10,10,25
3/3/1972,14,0,4,1,19
3/4/1972,16,0,16,6,38
3/5/1972,7,0,12,3,22
3/6/1972,10,0,6,6,22
3/7/1972,14,0,12,14,40
3/8/1972,15,0,9,10,34
3/9/1972,11,0,14,7,32
3/10/1972,9,0,10,7,26
3/11/1972,14,0,2,5,21
3/12/1972,14,0,11,4,29
3/13/1972,8,0,12,5,25
3/14/1972,7,0,11,0,18
3/15/1972,12,0,3,8,23
3/16/1972,14,0,3,2,19
3/17/1972,7,0,16,16,39
3/18/1972,15,0,8,8,31
3/19/1972,6,0,6,0,12
3/20/1972,9,0,5,16,30
3/21/1972,5,0,11,14,30
3/22/1972,11,0,15,1,27
3/23/1972,13,0,13,4,30
3/24/1972,5,0,9,15,29
3/25/1972,9,0,5,4,18
3/26/1972,8,0,5,11,24
3/27/1972,10,0,2,11,23
3/28/1972,15,0,15,3,33
3/29/1972,4,0,4,16,24
3/30/1972,10,0,16,13,39
3/31/1972,4,0,2,8,14
4/1/1972,6,0,2,4,12
4/2/1972,5,0,12,12,29
4/3/1972,5,0,7,13,25
4/4/1972,4,0,7,13,24
4/5/1972,10,0,4,14,28
4/6/1972,14,0,4,15,33
4/7/1972,12,0,2,6,20
4/8/1972,12,0,15,1,28
4/9/1972,4,0,15,16,35
4/10/1972,8,0,10,2,20
4/11/1972,9,0,5,9,23
4/12/1972,9,0,13,13,35
4/13/1972,4,0,4,1,9
4/14/1972,10,0,10,5,25
4/15/1972,16,0,4,16,36
4/16/1972,14,0,13,10,37
4/17/1972,10,0,11,16,37
4/18/1972,16,0,15,16,47
4/19/1972,9,0,8,16,33
4/20/1972,7,0,11,15,33
4/21/1972,16,0,12,10,38
4/22/1972,9,0,12,3,24
4/23/1972,6,0,10,6,22
4/24/1972,5,0,15,11,31
4/25/1972,6,0,11,12,29
4/26/1972,16,0,7,12,35
4/27/1972,4,0,13,12,29
4/28/1972,7,0,9,4,20
4/29/1972,9,0,3,11,23
4/30/1972,13,0,10,11,34
5/1/1972,9,0,13,9,31
5/2/1972,12,0,2,5,19
5/3/1972,7,0,7,1,15
5/4/1972,9,0,9,2,20
5/5/1972,9,0,2,2,13
5/6/1972,12,0,3,10,25
5/7/1972,14,0,9,10,33
5/8/1972,15,0,13,14,42
5/9/1972,6,0,14,7,27
5/10/1972,15,0,9,5,29
5/11/1972,5,0,4,0,9
5/12/1972,15,0,9,14,38
5/13/1972,14,0,15,2,31
5/14/1972,13,0,8,3,24
5/15/1972,16,0,5,1,22
5/16/1972,5,0,9,7,21
5/17/1972,11,0,15,4,30
5/18/1972,13,0,13,11,37
5/19/1972,9,0,3,10,22
5/20/1972,14,0,15,2,31
5/21/1972,16,0,6,10,32
5/22/1972,9,0,14,3,26
5/23/1972,9,0,8,5,22
5/24/1972,14,0,2,0,16
5/25/1972,4,0,14,13,31
5/26/1972,13,0,10,0,23
5/27/1972,13,0,16,2,31
5/28/1972,9,0,2,7,18
5/29/1972,4,0,15,2,21
5/30/1972,12,0,4,15,31
5/31/1972,11,0,6,2,19
6/1/1972,13,0,8,9,30
6/2/1972,4,0,2,11,17
6/3/1972,8,0,7,3,18
6/4/1972,15,0,15,2,32
6/5/1972,5,0,7,1,13
6/6/1972,16,0,15,4,35
6/7/1972,6,0,6,9,21
6/8/1972,15,0,6,14,35
6/9/1972,14,0,8,12,34
6/10/1972,11,0,10,2,23
6/11/1972,13,0,9,3,25
6/12/1972,8,0,10,4,22
6/13/1972,14,0,15,5,34
6/14/1972,12,0,15,11,38
6/15/1972,8,0,15,8,31
6/16/1972,7,0,2,2,11
6/17/1972,9,0,3,11,23
6/18/1972,11,0,9,12,32
6/19/1972,7,0,11,13,31
6/20/1972,9,0,8,2,19
6/21/1972,14,0,14,14,42
6/22/1972,7,0,12,2,21
6/23/1972,7,0,7,10,24
6/24/1972,13,0,3,4,20
6/25/1972,10,0,9,1,20
6/26/1972,7,0,3,5,15
6/27/1972,11,0,10,7,28
6/28/1972,4,0,5,9,18
6/29/1972,10,0,2,3,15
6/30/1972,13,0,15,6,34
7/1/1972,13,0,7,8,28
7/2/1972,10,0,7,2,19
7/3/1972,14,0,11,10,35
7/4/1972,11,0,6,10,27
7/5/1972,5,0,10,5,20
7/6/1972,4,0,6,12,22
7/7/1972,9,0,5,4,18
7/8/1972,12,0,12,13,37
7/9/1972,9,0,8,11,28
7/10/1972,9,0,4,16,29
7/11/1972,5,0,12,12,29
7/12/1972,15,0,13,5,33
7/13/1972,4,0,4,0,8
7/14/1972,4,0,4,7,15
7/15/1972,8,0,3,0,11
7/16/1972,16,0,7,6,29
7/17/1972,8,0,8,12,28
7/18/1972,14,0,12,9,35
7/19/1972,4,0,8,4,16
7/20/1972,5,0,10,10,25
7/21/1972,8,0,12,6,26
7/22/1972,8,0,8,9,25
7/23/1972,4,0,4,2,10
7/24/1972,6,0,12,1,19
7/25/1972,6,0,7,6,19
7/26/1972,15,0,13,5,33
7/27/1972,7,0,5,11,23
7/28/1972,4,0,3,9,16
7/29/1972,9,0,7,12,28
7/30/1972,14,0,7,4,25
7/31/1972,7,0,9,13,29
8/1/1972,8,0,2,11,21
8/2/1972,9,0,11,12,32
8/3/1972,6,0,2,13,21
8/4/1972,9,0,7,14,30
8/5/1972,9,0,8,5,22
8/6/1972,4,0,11,10,25
8/7/1972,12,0,10,10,32
8/8/1972,4,0,12,1,17
8/9/1972,11,0,13,8,32
8/10/1972,5,0,10,0,15
8/11/1972,13,0,7,1,21
8/12/1972,10,0,11,3,24
8/13/1972,14,0,8,9,31
8/14/1972,12,0,16,9,37
8/15/1972,7,0,9,10,26
8/16/1972,9,0,15,3,27
8/17/1972,13,0,14,13,40
8/18/1972,6,0,8,15,29
8/19/1972,11,0,9,12,32
8/20/1972,10,0,2,11,23
8/21/1972,11,0,16,10,37
8/22/1972,13,0,3,3,19
8/23/1972,8,0,16,14,38
8/24/1972,8,0,2,15,25
8/25/1972,13,0,14,8,35
8/26/1972,13,0,3,12,28
8/27/1972,7,0,10,3,20
8/28/1972,11,0,10,8,29
8/29/1972,14,0,13,9,36
8/30/1972,13,0,8,1,22
8/31/1972,6,0,12,2,20
9/1/1972,13,0,10,11,34
9/2/1972,4,0,5,2,11
9/3/1972,10,0,2,5,17
9/4/1972,14,0,16,0,30
9/5/1972,13,0,2,0,15
9/6/1972,4,0,15,16,35
9/7/1972,15,0,9,9,33
9/8/1972,16,0,7,7,30
9/9/1972,12,0,10,13,35
9/10/1972,5,0,11,8,24
9/11/1972,4,0,16,7,27
9/12/1972,14,0,14,10,38
9/13/1972,12,0,10,5,27
9/14/1972,15,0,12,13,40
9/15/1972,13,0,3,7,23
9/16/1972,13,0,11,16,40
9/17/1972,10,0,11,8,29
9/18/1972,11,0,3,14,28
9/19/1972,16,0,4,5,25
9/20/1972,15,0,4,16,35
9/21/1972,12,0,4,11,27
9/22/1972,8,0,8,11,27
9/23/1972,10,0,2,11,23
9/24/1972,4,0,16,13,33
9/25/1972,15,0,7,13,35
9/26/1972,9,0,16,8,33
9/27/1972,6,0,11,10,27
9/28/1972,14,0,5,6,25
9/29/1972,9,0,7,4,20
9/30/1972,8,0,15,6,29
10/1/1972,8,0,16,3,27
10/2/1972,5,0,2,11,18
10/3/1972,5,0,14,4,23
10/4/1972,5,0,2,8,15
10/5/1972,10,0,10,15,35
10/6/1972,8,0,6,3,17
10/7/1972,16,0,13,11,40
10/8/1972,9,0,7,16,32
10/9/1972,15,0,7,15,37
10/10/1972,13,0,10,2,25
10/11/1972,5,0,16,4,25
10/12/1972,9,0,5,10,24
10/13/1972,16,0,10,14,40
10/14/1972,12,0,6,15,33
10/15/1972,15,0,7,14,36
10/16/1972,10,0,2,5,17
10/17/1972,12,0,5,9,26
10/18/1972,16,0,9,8,33
10/19/1972,4,0,6,9,19
10/20/1972,7,0,10,5,22
10/21/1972,15,0,11,11,37
10/22/1972,4,0,3,10,17
10/23/1972,8,0,4,1,13
10/24/1972,8,0,15,16,39
10/25/1972,15,0,3,15,33
10/26/1972,9,0,10,16,35
10/27/1972,12,0,11,15,38
10/28/1972,5,0,10,2,17
10/29/1972,7,0,2,0,9
10/30/1972,16,0,7,6,29
10/31/1972,15,0,4,13,32
11/1/1972,5,0,6,1,12
11/2/1972,7,0,14,2,23
11/3/1972,7,0,7,9,23
11/4/1972,6,0,13,8,27
11/5/1972,11,0,3,12,26
11/6/1972,7,0,9,13,29
11/7/1972,6,0,10,13,29
11/8/1972,7,0,2,12,21
11/9/1972,11,0,4,0,15
11/10/1972,9,0,7,2,18
11/11/1972,16,0,10,4,30
11/12/1972,8,0,9,4,21
11/13/1972,10,0,9,1,20
11/14/1972,6,0,3,9,18
11/15/1972,7,0,10,6,23
11/16/1972,14,0,3,0,17
11/17/1972,16,0,11,6,33
11/18/1972,13,0,7,3,23
11/19/1972,16,0,9,15,40
11/20/1972,15,0,4,4,23
11/21/1972,10,0,15,2,27
11/22/1972,10,0,10,2,22
11/23/1972,11,0,6,15,32
11/24/1972,11,0,14,2,27
11/25/1972,15,0,5,14,34
11/26/1972,9,0,5,7,21
11/27/1972,9,0,3,4,16
11/28/1972,6,0,4,3,13
11/29/1972,16,0,15,15,46
11/30/1972,5,0,5,5,15
12/1/1972,11,0,15,4,30
12/2/1972,4,0,4,3,11
12/3/1972,9,0,7,2,18
12/4/1972,10,0,8,14,32
12/5/1972,15,0,8,6,29
12/6/1972,12,0,3,8,23
12/7/1972,5,0,6,12,23
12/8/1972,14,0,2,11,27
12/9/1972,4,0,12,8,24
12/10/1972,6,0,3,1,10
12/11/1972,13,0,11,3,27
12/12/1972,13,0,9,9,31
12/13/1972,8,0,11,16,35
12/14/1972,15,0,15,12,42
12/15/1972,16,0,8,3,27
12/16/1972,6,0,9,16,31
12/17/1972,8,0,11,0,19
12/18/1972,13,0,8,4,25
12/19/1972,13,0,3,7,23
12/20/1972,6,0,15,13,34
12/21/1972,11,0,9,5,25
12/22/1972,14,0,2,0,16
12/23/1972,11,0,10,13,34
12/24/1972,15,0,7,8,30
12/25/1972,14,0,12,10,36
12/26/1972,4,0,4,4,12
12/27/1972,14,0,16,1,31
12/28/1972,10,0,2,4,16
12/29/1972,10,0,15,13,38
12/30/1972,13,0,13,10,36
12/31/1972,7,0,7,11,25
1/1/1973,14,0,6,3,23
1/2/1973,16,0,15,6,37
1/3/1973,5,0,13,1,19
1/4/1973,8,0,16,2,26
1/5/1973,12,0,9,15,36
1/6/1973,8,0,7,2,17
1/7/1973,15,0,8,11,34
1/8/1973,7,0,3,15,25
1/9/1973,10,0,2,6,18
1/10/1973,7,0,13,3,23
1/11/1973,4,0,4,8,16
1/12/1973,14,0,14,15,43
1/13/1973,4,0,12,6,22
1/14/1973,13,0,14,0,27
1/15/1973,14,0,4,10,28
1/16/1973,10,0,11,6,27
1/17/1973,9,0,15,16,40
1/18/1973,13,0,7,8,28
1/19/1973,14,0,10,13,37
1/20/1973,5,0,5,11,21
1/21/1973,16,0,8,15,39
1/22/1973,9,0,13,11,33
1/23/1973,5,0,15,9,29
1/24/1973,9,0,12,15,36
1/25/1973,8,0,12,3,23
1/26/1973,4,0,2,14,20
1/27/1973,14,0,5,7,26
1/28/1973,15,0,10,13,38
1/29/1973,15,0,5,9,29
1/30/1973,6,0,7,4,17
1/31/1973,8,0,9,4,21
2/1/1973,11,0,7,1,19
2/2/1973,11,0,5,7,23
2/3/1973,14,0,7,2,23
2/4/1973,12,0,15,12,39
2/5/1973,4,0,15,9,28
2/6/1973,12,0,9,16,37
2/7/1973,11,0,12,4,27
2/8/1973,5,0,10,12,27
2/9/1973,4,0,12,4,20
2/10/1973,8,0,10,3,21
2/11/1973,11,0,11,12,34
2/12/1973,4,0,16,16,36
2/13/1973,15,0,16,7,38
2/14/1973,16,0,6,4,26
2/15/1973,12,0,2,10,24
2/16/1973,9,0,11,5,25
2/17/1973,4,0,2,0,6
2/18/1973,8,0,13,3,24
2/19/1973,6,0,7,16,29
2/20/1973,9,0,7,7,23
2/21/1973,14,0,5,7,26
2/22/1973,10,0,7,12,29
2/23/1973,16,0,2,7,25
2/24/1973,11,0,15,5,31
2/25/1973,5,0,10,2,17
2/26/1973,12,0,8,15,35
2/27/1973,13,0,6,9,28
2/28/1973,10,0,13,6,29
3/1/1973,13,0,8,2,23
3/2/1973,13,0,9,9,31
3/3/1973,16,0,12,14,42
3/4/1973,6,0,15,14,35
3/5/1973,6,0,6,4,16
3/6/1973,4,0,16,15,35
3/7/1973,16,0,11,4,31
3/8/1973,12,0,13,3,28
3/9/1973,15,0,3,14,32
3/10/1973,9,0,7,0,16
3/11/1973,11,0,14,5,30
3/12/1973,13,0,6,2,21
3/13/1973,13,0,8,3,24
3/14/1973,10,0,13,3,26
3/15/1973,5,0,9,16,30
3/16/1973,5,0,7,10,22
3/17/1973,12,0,16,12,40
3/18/1973,15,0,11,2,28
3/19/1973,6,0,9,2,17
3/20/1973,7,0,6,0,13
3/21/1973,14,0,8,11,33
3/22/1973,5,0,12,14,31
3/23/1973,11,0,10,7,28
3/24/1973,11,0,16,7,34
3/25/1973,16,0,15,6,37
3/26/1973,8,0,8,5,21
3/27/1973,12,0,8,15,35
3/28/1973,15,0,6,16,37
3/29/1973,5,0,4,6,15
3/30/1973,15,0,9,0,24
3/31/1973,11,0,14,1,26
4/1/1973,15,0,10,12,37
4/2/1973,8,0,10,0,18
4/3/1973,10,0,16,6,32
4/4/1973,7,0,9,12,28
4/5/1973,14,0,8,5,27
4/6/1973,7,0,15,4,26
4/7/1973,10,0,3,4,17
4/8/1973,4,0,11,4,19
4/9/1973,10,0,8,13,31
4/10/1973,8,0,12,4,24
4/11/1973,16,0,3,5,24
4/12/1973,14,0,6,10,30
4/13/1973,12,0,13,9,34
4/14/1973,15,0,16,8,39
4/15/1973,4,0,14,5,23
4/16/1973,15,0,3,9,27
4/17/1973,10,0,11,6,27
4/18/1973,13,0,7,7,27
4/19/1973,14,0,13,3,30
4/20/1973,7,0,10,1,18
4/21/1973,16,0,4,4,24
4/22/1973,16,0,9,3,28
4/23/1973,5,0,14,1,20
4/24/1973,14,0,11,0,25
4/25/1973,16,0,8,9,33
4/26/1973,10,0,5,6,21
4/27/1973,11,0,9,1,21
4/28/1973,16,0,14,0,30
4/29/1973,6,0,13,13,32
4/30/1973,7,0,3,8,18
5/1/1973,10,0,12,4,26
5/2/1973,7,0,11,7,25
5/3/1973,5,0,13,2,20
5/4/1973,7,0,11,13,31
5/5/1973,15,0,2,10,27
5/6/1973,10,0,15,9,34
5/7/1973,12,0,5,0,17
5/8/1973,13,0,15,12,40
5/9/1973,4,0,9,1,14
5/10/1973,15,0,2,15,32
5/11/1973,14,0,10,12,36
5/12/1973,16,0,12,12,40
5/13/1973,5,0,13,7,25
5/14/1973,15,0,4,9,28
5/15/1973,16,0,7,3,26
5/16/1973,5,0,9,7,21
5/17/1973,14,0,9,5,28
5/18/1973,12,0,3,14,29
5/19/1973,8,0,8,14,30
5/20/1973,12,0,11,3,26
5/21/1973,6,0,6,10,22
5/22/1973,8,0,5,4,17
5/23/1973,16,0,2,8,26
5/24/1973,15,0,3,3,21
5/25/1973,4,0,6,11,21
5/26/1973,7,0,9,13,29
5/27/1973,15,0,4,1,20
5/28/1973,4,0,3,7,14
5/29/1973,16,0,5,15,36
5/30/1973,15,0,6,7,28
5/31/1973,5,0,2,14,21
6/1/1973,8,0,3,0,11
6/2/1973,10,0,6,10,26
6/3/1973,7,0,3,5,15
6/4/1973,7,0,8,3,18
6/5/1973,10,0,10,0,20
6/6/1973,16,0,14,14,44
6/7/1973,8,0,5,16,29
6/8/1973,6,0,3,15,24
6/9/1973,14,0,3,12,29
6/10/1973,14,0,13,2,29
6/11/1973,12,0,15,4,31
6/12/1973,5,0,4,12,21
6/13/1973,12,0,15,16,43
6/14/1973,16,0,9,3,28
6/15/1973,8,0,4,11,23
6/16/1973,7,0,3,15,25
6/17/1973,8,0,8,6,22
6/18/1973,14,0,8,15,37
6/19/1973,8,0,2,6,16
6/20/1973,9,0,15,12,36
6/21/1973,5,0,5,5,15
6/22/1973,16,0,14,4,34
6/23/1973,13,0,7,3,23
6/24/1973,12,0,7,4,23
6/25/1973,9,0,9,4,22
6/26/1973,7,0,8,2,17
6/27/1973,11,0,5,11,27
6/28/1973,15,0,16,16,47
6/29/1973,8,0,14,7,29
6/30/1973,5,0,15,1,21
7/1/1973,8,0,4,1,13
7/2/1973,7,0,7,16,30
7/3/1973,5,0,14,4,23
7/4/1973,6,0,15,5,26
7/5/1973,6,0,8,16,30
7/6/1973,9,0,11,4,24
7/7/1973,4,0,3,7,14
7/8/1973,4,0,3,4,11
7/9/1973,6,0,8,6,20
7/10/1973,11,0,16,12,39
7/11/1973,5,0,15,11,31
7/12/1973,8,0,8,16,32
7/13/1973,8,0,14,15,37
7/14/1973,11,0,4,5,20
7/15/1973,9,0,15,6,30
7/16/1973,11,0,14,10,35
7/17/1973,9,0,2,16,27
7/18/1973,13,0,4,7,24
7/19/1973,7,0,2,11,20
7/20/1973,5,0,2,3,10
7/21/1973,4,0,5,10,19
7/22/1973,12,0,11,9,32
7/23/1973,7,0,4,7,18
7/24/1973,12,0,9,4,25
7/25/1973,7,0,8,4,19
7/26/1973,12,0,6,5,23
7/27/1973,6,0,4,1,11
7/28/1973,13,0,13,9,35
7/29/1973,9,0,5,8,22
7/30/1973,12,0,13,3,28
7/31/1973,11,0,6,13,30
8/1/1973,4,0,5,13,22
8/2/1973,4,0,15,13,32
8/3/1973,13,0,14,4,31
8/4/1973,11,0,13,5,29
8/5/1973,14,0,14,7,35
8/6/1973,11,0,5,4,20
8/7/1973,5,0,8,7,20
8/8/1973,7,0,5,14,26
8/9/1973,9,0,7,0,16
8/10/1973,5,0,5,11,21
8/11/1973,4,0,6,1,11
8/12/1973,6,0,7,16,29
8/13/1973,11,0,7,11,29
8/14/1973,10,0,4,10,24
8/15/1973,9,0,6,9,24
8/16/1973,4,0,6,6,16
8/17/1973,6,0,5,10,21
8/18/1973,4,0,6,4,14
8/19/1973,16,0,4,13,33
8/20/1973,11,0,11,7,29
8/21/1973,15,0,6,15,36
8/22/1973,6,0,6,5,17
8/23/1973,7,0,10,1,18
8/24/1973,14,0,9,11,34
8/25/1973,11,0,13,12,36
8/26/1973,5,0,6,3,14
8/27/1973,11,0,14,0,25
8/28/1973,5,0,9,9,23
8/29/1973,9,0,2,0,11
8/30/1973,10,0,11,12,33
8/31/1973,12,0,9,4,25
9/1/1973,14,0,5,9,28
9/2/1973,13,0,14,13,40
9/3/1973,11,0,13,6,30
9/4/1973,8,0,5,2,15
9/5/1973,6,0,16,9,31
9/6/1973,6,0,10,12,28
9/7/1973,5,0,10,3,18
9/8/1973,9,0,7,0,16
9/9/1973,16,0,4,13,33
9/10/1973,4,0,4,14,22
9/11/1973,14,0,5,8,27
9/12/1973,4,0,2,13,19
9/13/1973,15,0,11,12,38
9/14/1973,6,0,15,3,24
9/15/1973,15,0,15,15,45
9/16/1973,4,0,15,8,27
9/17/1973,11,0,10,2,23
9/18/1973,14,0,7,10,31
9/19/1973,5,0,2,5,12
9/20/1973,8,0,13,0,21
9/21/1973,5,0,15,2,22
9/22/1973,14,0,16,7,37
9/23/1973,7,0,14,2,23
9/24/1973,15,0,9,3,27
9/25/1973,10,0,15,8,33
9/26/1973,4,0,11,16,31
9/27/1973,11,0,5,5,21
9/28/1973,6,0,11,3,20
9/29/1973,9,0,13,3,25
9/30/1973,16,0,12,14,42
10/1/1973,16,0,12,10,38
10/2/1973,5,0,14,4,23
10/3/1973,4,0,3,5,12
10/4/1973,5,0,6,15,26
10/5/1973,14,0,7,1,22
10/6/1973,16,0,15,6,37
10/7/1973,6,0,4,1,11
10/8/1973,11,0,6,7,24
10/9/1973,10,0,5,3,18
10/10/1973,8,0,8,11,27
10/11/1973,9,0,10,3,22
10/12/1973,15,0,14,4,33
10/13/1973,12,0,9,2,23
10/14/1973,16,0,8,10,34
10/15/1973,10,0,5,1,16
10/16/1973,6,0,16,8,30
10/17/1973,6,0,13,6,25
10/18/1973,4,0,8,3,15
10/19/1973,16,0,8,11,35
10/20/1973,8,0,15,2,25
10/21/1973,8,0,14,9,31
10/22/1973,12,0,16,16,44
10/23/1973,15,0,16,15,46
10/24/1973,13,0,4,10,27
10/25/1973,6,0,14,13,33
10/26/1973,15,0,14,14,43
10/27/1973,9,0,5,13,27
10/28/1973,14,0,16,12,42
10/29/1973,11,0,4,5,20
10/30/1973,4,0,6,8,18
10/31/1973,8,0,4,15,27
11/1/1973,13,0,12,6,31
11/2/1973,12,0,2,10,24
11/3/1973,4,0,8,14,26
11/4/1973,7,0,7,16,30
11/5/1973,6,0,8,16,30
11/6/1973,7,0,12,2,21
11/7/1973,14,0,5,13,32
11/8/1973,5,0,9,7,21
11/9/1973,12,0,15,4,31
11/10/1973,4,0,14,10,28
11/11/1973,5,0,2,1,8
11/12/1973,11,0,14,15,40
11/13/1973,12,0,15,6,33
11/14/1973,4,0,4,15,23
11/15/1973,9,0,11,2,22
11/16/1973,5,0,12,11,28
11/17/1973,5,0,5,13,23
11/18/1973,12,0,12,9,33
11/19/1973,13,0,4,11,28
11/20/1973,4,0,3,5,12
11/21/1973,11,0,4,7,22
11/22/1973,10,0,10,6,26
11/23/1973,11,0,7,16,34
11/24/1973,4,0,3,2,9
11/25/1973,7,0,16,8,31
11/26/1973,7,0,15,4,26
11/27/1973,8,0,4,4,16
11/28/1973,7,0,14,9,30
11/29/1973,16,0,9,8,33
11/30/1973,13,0,13,2,28
12/1/1973,15,0,15,9,39
12/2/1973,15,0,14,9,38
12/3/1973,7,0,12,5,24
12/4/1973,11,0,10,13,34
12/5/1973,8,0,11,13,32
12/6/1973,15,0,8,5,28
12/7/1973,13,0,5,15,33
12/8/1973,11,0,6,2,19
12/9/1973,16,0,8,14,38
12/10/1973,6,0,15,11,32
12/11/1973,7,0,4,2,13
12/12/1973,12,0,12,3,27
12/13/1973,15,0,16,5,36
12/14/1973,16,0,14,10,40
12/15/1973,6,0,15,13,34
12/16/1973,8,0,3,4,15
12/17/1973,5,0,14,2,21
12/18/1973,12,0,11,0,23
12/19/1973,10,0,2,8,20
12/20/1973,8,0,13,1,22
12/21/1973,10,0,4,11,25
12/22/1973,13,0,5,11,29
12/23/1973,9,0,7,11,27
12/24/1973,14,0,10,11,35
12/25/1973,8,0,15,13,36
12/26/1973,14,0,12,13,39
12/27/1973,7,0,12,11,30
12/28/1973,6,0,11,0,17
12/29/1973,15,0,7,3,25
12/30/1973,15,0,8,10,33
12/31/1973,4,0,3,0,7
1/1/1974,13,0,4,4,21
1/2/1974,13,0,2,10,25
1/3/1974,5,0,7,16,28
1/4/1974,13,0,3,5,21
1/5/1974,8,0,10,13,31
1/6/1974,9,0,14,4,27
1/7/1974,16,0,16,5,37
1/8/1974,11,0,14,13,38
1/9/1974,5,0,13,4,22
1/10/1974,8,0,6,12,26
1/11/1974,4,0,13,13,30
1/12/1974,7,0,6,9,22
1/13/1974,8,0,16,16,40
1/14/1974,7,0,2,14,23
1/15/1974,9,0,14,6,29
1/16/1974,6,0,12,3,21
1/17/1974,4,0,10,0,14
1/18/1974,6,0,9,6,21
1/19/1974,4,0,4,16,24
1/20/1974,10,0,16,11,37
1/21/1974,13,0,16,4,33
1/22/1974,6,0,7,11,24
1/23/1974,14,0,14,16,44
1/24/1974,5,0,9,9,23
1/25/1974,11,0,2,7,20
1/26/1974,8,0,5,8,21
1/27/1974,6,0,4,1,11
1/28/1974,14,0,14,3,31
1/29/1974,13,0,15,16,44
1/30/1974,16,0,2,14,32
1/31/1974,10,0,15,16,41
2/1/1974,16,0,11,8,35
2/2/1974,13,0,10,8,31
2/3/1974,9,0,15,1,25
2/4/1974,12,0,2,12,26
2/5/1974,9,0,10,1,20
2/6/1974,4,0,3,16,23
2/7/1974,8,0,8,10,26
2/8/1974,13,0,14,2,29
2/9/1974,14,0,13,2,29
2/10/1974,7,0,5,4,16
2/11/1974,15,0,14,10,39
2/12/1974,11,0,10,11,32
2/13/1974,7,0,8,1,16
2/14/1974,6,0,12,10,28
2/15/1974,12,0,13,2,27
2/16/1974,5,0,8,12,25
2/17/1974,15,0,7,14,36
2/18/1974,9,0,4,8,21
2/19/1974,13,0,16,6,35
2/20/1974,5,0,4,1,10
2/21/1974,4,0,16,3,23
2/22/1974,5,0,7,12,24
2/23/1974,9,0,14,9,32
2/24/1974,10,0,13,12,35
2/25/1974,16,0,10,4,30
2/26/1974,16,0,2,0,18
2/27/1974,4,0,9,0,13
2/28/1974,5,0,16,15,36
3/1/1974,15,0,6,8,29
3/2/1974,8,0,5,12,25
3/3/1974,8,0,14,15,37
3/4/1974,16,0,7,9,32
3/5/1974,11,0,14,10,35
3/6/1974,12,0,6,10,28
3/7/1974,12,0,5,12,29
3/8/1974,15,0,11,10,36
3/9/1974,13,0,15,11,39
3/10/1974,10,0,8,5,23
3/11/1974,10,0,6,12,28
3/12/1974,11,0,9,9,29
3/13/1974,9,0,6,16,31
3/14/1974,5,0,15,1,21
3/15/1974,11,0,4,1,16
3/16/1974,12,0,13,14,39
3/17/1974,13,0,5,5,23
3/18/1974,9,0,9,0,18
3/19/1974,13,0,16,5,34
3/20/1974,10,0,8,9,27
3/21/1974,13,0,9,15,37
3/22/1974,9,0,12,8,29
3/23/1974,13,0,2,8,23
3/24/1974,13,0,11,12,36
3/25/1974,14,0,3,13,30
3/26/1974,6,0,4,14,24
3/27/1974,5,0,16,14,35
3/28/1974,13,0,15,2,30
3/29/1974,7,0,16,13,36
3/30/1974,5,0,10,6,21
3/31/1974,9,0,13,7,29
4/1/1974,7,0,3,15,25
4/2/1974,9,0,7,14,30
4/3/1974,10,0,6,11,27
4/4/1974,11,0,9,14,34
4/5/1974,10,0,15,11,36
4/6/1974,8,0,15,7,30
4/7/1974,11,0,3,13,27
4/8/1974,9,0,8,0,17
4/9/1974,9,0,2,1,12
4/10/1974,7,0,10,7,24
4/11/1974,9,0,12,4,25
4/12/1974,11,0,5,0,16
4/13/1974,7,0,2,11,20
4/14/1974,15,0,8,5,28
4/15/1974,11,0,11,2,24
4/16/1974,11,0,15,10,36
4/17/1974,9,0,13,9,31
4/18/1974,7,0,5,8,20
4/19/1974,11,0,6,2,19
4/20/1974,6,0,14,11,31
4/21/1974,6,0,12,12,30
4/22/1974,5,0,15,10,30
4/23/1974,10,0,3,0,13
4/24/1974,6,0,6,12,24
4/25/1974,10,0,9,5,24
4/26/1974,8,0,15,13,36
4/27/1974,9,0,16,9,34
4/28/1974,16,0,6,14,36
4/29/1974,7,0,2,8,17
4/30/1974,4,0,16,13,33
5/1/1974,14,0,7,16,37
5/2/1974,10,0,2,0,12
5/3/1974,16,0,12,11,39
5/4/1974,16,0,16,13,45
5/5/1974,5,0,13,13,31
5/6/1974,8,0,11,13,32
5/7/1974,16,0,8,5,29
5/8/1974,7,0,13,3,23
5/9/1974,16,0,12,12,40
5/10/1974,12,0,7,14,33
5/11/1974,12,0,6,1,19
5/12/1974,10,0,2,8,20
5/13/1974,7,0,11,7,25
5/14/1974,5,0,11,1,17
5/15/1974,5,0,6,8,19
5/16/1974,4,0,8,0,12
5/17/1974,11,0,16,2,29
5/18/1974,16,0,14,3,33
5/19/1974,11,0,7,2,20
5/20/1974,10,0,10,6,26
5/21/1974,7,0,12,3,22
5/22/1974,16,0,6,7,29
5/23/1974,9,0,9,5,23
5/24/1974,12,0,10,11,33
5/25/1974,5,0,8,9,22
5/26/1974,14,0,16,9,39
5/27/1974,7,0,8,5,20
5/28/1974,16,0,7,4,27
5/29/1974,6,0,6,10,22
5/30/1974,4,0,15,5,24
5/31/1974,8,0,6,3,17
6/1/1974,13,0,4,4,21
6/2/1974,10,0,14,9,33
6/3/1974,7,0,10,12,29
6/4/1974,8,0,10,7,25
6/5/1974,15,0,2,6,23
6/6/1974,6,0,15,11,32
6/7/1974,15,0,8,16,39
6/8/1974,14,0,3,15,32
6/9/1974,11,0,9,12,32
6/10/1974,16,0,9,6,31
6/11/1974,5,0,2,13,20
6/12/1974,6,0,6,14,26
6/13/1974,14,0,4,15,33
6/14/1974,13,0,15,16,44
6/15/1974,5,0,4,4,13
6/16/1974,10,0,5,5,20
6/17/1974,13,0,15,10,38
6/18/1974,10,0,15,7,32
6/19/1974,11,0,9,8,28
6/20/1974,11,0,8,14,33
6/21/1974,5,0,14,4,23
6/22/1974,10,0,9,3,22
6/23/1974,11,0,7,6,24
6/24/1974,14,0,12,3,29
6/25/1974,12,0,5,7,24
6/26/1974,5,0,6,12,23
6/27/1974,11,0,9,16,36
6/28/1974,5,0,4,16,25
6/29/1974,5,0,2,6,13
6/30/1974,16,0,5,13,34
7/1/1974,6,0,8,2,16
7/2/1974,12,0,7,9,28
7/3/1974,11,0,8,5,24
7/4/1974,5,0,5,16,26
7/5/1974,13,0,10,1,24
7/6/1974,11,0,13,14,38
7/7/1974,11,0,14,4,29
7/8/1974,6,0,12,5,23
7/9/1974,4,0,10,9,23
7/10/1974,4,0,15,4,23
7/11/1974,16,0,5,1,22
7/12/1974,12,0,5,6,23
7/13/1974,4,0,14,3,21
7/14/1974,7,0,14,13,34
7/15/1974,12,0,9,12,33
7/16/1974,14,0,11,12,37
7/17/1974,13,0,3,11,27
7/18/1974,11,0,2,8,21
7/19/1974,16,0,15,7,38
7/20/1974,14,0,15,1,30
7/21/1974,7,0,12,13,32
7/22/1974,15,0,12,15,42
7/23/1974,14,0,13,5,32
7/24/1974,10,0,7,14,31
7/25/1974,8,0,3,4,15
7/26/1974,5,0,5,7,17
7/27/1974,12,0,9,6,27
7/28/1974,13,0,5,6,24
7/29/1974,11,0,2,15,28
7/30/1974,7,0,2,6,15
7/31/1974,12,0,10,12,34
8/1/1974,12,0,3,15,30
8/2/1974,5,0,10,11,26
8/3/1974,11,0,3,6,20
8/4/1974,7,0,2,14,23
8/5/1974,14,0,10,4,28
8/6/1974,16,0,9,15,40
8/7/1974,12,0,13,2,27
8/8/1974,16,0,7,13,36
8/9/1974,4,0,6,6,16
8/10/1974,9,0,4,5,18
8/11/1974,4,0,9,3,16
8/12/1974,7,0,6,2,15
8/13/1974,5,0,16,11,32
8/14/1974,13,0,6,4,23
8/15/1974,11,0,4,4,19
8/16/1974,14,0,16,11,41
8/17/1974,9,0,6,0,15
8/18/1974,9,0,11,13,33
8/19/1974,14,0,5,3,22
8/20/1974,12,0,12,10,34
8/21/1974,6,0,10,0,16
8/22/1974,10,0,4,5,19
8/23/1974,11,0,8,15,34
8/24/1974,15,0,4,6,25
8/25/1974,8,0,5,15,28
8/26/1974,5,0,7,3,15
8/27/1974,14,0,8,0,22
8/28/1974,16,0,13,9,38
8/29/1974,12,0,5,7,24
8/30/1974,12,0,3,5,20
8/31/1974,14,0,13,1,28
9/1/1974,13,0,3,15,31
9/2/1974,15,0,12,1,28
9/3/1974,16,0,5,8,29
9/4/1974,15,0,4,13,32
9/5/1974,9,0,16,4,29
9/6/1974,15,0,5,16,36
9/7/1974,8,0,7,11,26
9/8/1974,7,0,15,12,34
9/9/1974,7,0,13,3,23
9/10/1974,9,0,12,2,23
9/11/1974,5,0,3,8,16
9/12/1974,5,0,7,13,25
9/13/1974,5,0,2,0,7
9/14/1974,14,0,15,1,30
9/15/1974,12,0,14,5,31
9/16/1974,16,0,16,0,32
9/17/1974,8,0,4,10,22
9/18/1974,11,0,5,16,32
9/19/1974,11,0,12,5,28
9/20/1974,4,0,2,6,12
9/21/1974,5,0,4,6,15
9/22/1974,6,0,4,15,25
9/23/1974,13,0,11,4,28
9/24/1974,9,0,2,14,25
9/25/1974,5,0,2,13,20
9/26/1974,15,0,6,4,25
9/27/1974,9,0,11,13,33
9/28/1974,13,0,9,5,27
9/29/1974,4,0,13,5,22
9/30/1974,11,0,4,11,26
10/1/1974,11,0,12,12,35
10/2/1974,13,0,8,9,30
10/3/1974,4,0,11,15,30
10/4/1974,15,0,7,0,22
10/5/1974,15,0,10,4,29
10/6/1974,14,0,12,16,42
10/7/1974,12,0,16,5,33
10/8/1974,15,0,12,6,33
10/9/1974,6,0,6,4,16
10/10/1974,15,0,15,9,39
10/11/1974,4,0,8,8,20
10/12/1974,4,0,11,9,24
10/13/1974,13,0,8,6,27
10/14/1974,15,0,13,11,39
10/15/1974,14,0,12,1,27
10/16/1974,13,0,4,12,29
10/17/1974,8,0,13,2,23
10/18/1974,11,0,11,13,35
10/19/1974,10,0,13,7,30
10/20/1974,15,0,6,2,23
10/21/1974,4,0,16,15,35
10/22/1974,9,0,5,15,29
10/23/1974,5,0,15,12,32
10/24/1974,14,0,6,12,32
10/25/1974,5,0,2,11,18
10/26/1974,6,0,13,13,32
10/27/1974,9,0,14,9,32
10/28/1974,9,0,8,2,19
10/29/1974,6,0,12,2,20
10/30/1974,8,0,9,1,18
10/31/1974,11,0,16,7,34
11/1/1974,4,0,9,7,20
11/2/1974,10,0,2,8,20
11/3/1974,11,0,10,15,36
11/4/1974,10,0,6,5,21
11/5/1974,11,0,2,5,18
11/6/1974,9,0,13,4,26
11/7/1974,5,0,12,9,26
11/8/1974,10,0,9,1,20
11/9/1974,13,0,6,15,34
11/10/1974,4,0,3,16,23
11/11/1974,11,0,16,3,30
11/12/1974,12,0,8,2,22
11/13/1974,8,0,13,3,24
11/14/1974,12,0,11,0,23
11/15/1974,16,0,7,5,28
11/16/1974,7,0,5,13,25
11/17/1974,7,0,13,9,29
11/18/1974,6,0,9,16,31
11/19/1974,4,0,6,13,23
11/20/1974,7,0,12,3,22
11/21/1974,13,0,9,13,35
11/22/1974,15,0,16,6,37
11/23/1974,10,0,9,6,25
11/24/1974,9,0,2,0,11
11/25/1974,13,0,13,1,27
11/26/1974,14,0,11,7,32
11/27/1974,12,0,10,14,36
11/28/1974,5,0,4,11,20
11/29/1974,9,0,11,3,23
11/30/1974,13,0,10,9,32
12/1/1974,16,0,8,16,40
12/2/1974,8,0,9,0,17
12/3/1974,14,0,12,1,27
12/4/1974,12,0,5,6,23
12/5/1974,8,0,2,10,20
12/6/1974,5,0,11,16,32
12/7/1974,6,0,5,12,23
12/8/1974,16,0,2,7,25
12/9/1974,11,0,5,3,19
12/10/1974,16,0,8,12,36
12/11/1974,11,0,7,12,30
12/12/1974,8,0,2,16,26
12/13/1974,8,0,13,14,35
12/14/1974,10,0,6,16,32
12/15/1974,13,0,13,6,32
12/16/1974,15,0,2,15,32
12/17/1974,5,0,6,3,14
12/18/1974,10,0,5,1,16
12/19/1974,16,0,7,8,31
12/20/1974,12,0,15,5,32
12/21/1974,14,0,4,15,33
12/22/1974,15,0,14,13,42
12/23/1974,16,0,11,5,32
12/24/1974,7,0,11,14,32
12/25/1974,6,0,11,16,33
12/26/1974,8,0,10,6,24
12/27/1974,8,0,8,12,28
12/28/1974,12,0,10,6,28
12/29/1974,15,0,3,4,22
12/30/1974,6,0,8,4,18
12/31/1974,7,0,2,7,16
1/1/1975,12,0,5,3,20
1/2/1975,5,0,3,7,15
1/3/1975,4,0,3,1,8
1/4/1975,14,0,9,14,37
1/5/1975,13,0,5,14,32
1/6/1975,8,0,11,4,23
1/7/1975,10,0,8,11,29
1/8/1975,11,0,6,8,25
1/9/1975,6,0,10,14,30
1/10/1975,12,0,12,0,24
1/11/1975,6,0,4,12,22
1/12/1975,11,0,14,14,39
1/13/1975,5,0,14,14,33
1/14/1975,13,0,4,13,30
1/15/1975,6,0,14,15,35
1/16/1975,14,0,9,11,34
1/17/1975,5,0,6,13,24
1/18/1975,11,0,13,14,38
1/19/1975,12,0,5,7,24
1/20/1975,12,0,4,2,18
1/21/1975,10,0,11,10,31
1/22/1975,5,0,12,6,23
1/23/1975,6,0,13,16,35
1/24/1975,4,0,9,0,13
1/25/1975,4,0,13,14,31
1/26/1975,11,0,10,13,34
1/27/1975,12,0,11,1,24
1/28/1975,11,0,14,16,41
1/29/1975,10,0,8,6,24
1/30/1975,12,0,16,16,44
1/31/1975,10,0,9,8,27
2/1/1975,12,0,13,16,41
2/2/1975,10,0,5,12,27
2/3/1975,12,0,8,13,33
2/4/1975,9,0,11,1,21
2/5/1975,11,0,12,1,24
2/6/1975,4,0,5,0,9
2/7/1975,8,0,15,10,33
2/8/1975,13,0,3,15,31
2/9/1975,12,0,6,15,33
2/10/1975,10,0,2,13,25
2/11/1975,7,0,11,2,20
2/12/1975,8,0,8,16,32
2/13/1975,8,0,2,2,12
2/14/1975,16,0,7,0,23
2/15/1975,4,0,7,10,21
2/16/1975,4,0,5,10,19
2/17/1975,16,0,12,12,40
2/18/1975,6,0,4,14,24
2/19/1975,5,0,11,16,32
2/20/1975,11,0,9,3,23
2/21/1975,13,0,9,9,31
2/22/1975,6,0,3,5,14
2/23/1975,5,0,10,5,20
2/24/1975,14,0,5,0,19
2/25/1975,6,0,10,11,27
2/26/1975,5,0,8,7,20
2/27/1975,10,0,3,1,14
2/28/1975,12,0,4,7,23
3/1/1975,4,0,11,14,29
3/2/1975,9,0,5,3,17
3/3/1975,7,0,15,6,28
3/4/1975,6,0,14,13,33
3/5/1975,14,0,16,7,37
3/6/1975,8,0,4,14,26
3/7/1975,12,0,13,0,25
3/8/1975,10,0,14,5,29
3/9/1975,5,0,8,9,22
3/10/1975,4,0,4,16,24
3/11/1975,7,0,7,13,27
3/12/1975,7,0,5,8,20
3/13/1975,15,0,8,14,37
3/14/1975,11,0,7,1,19
3/15/1975,11,0,11,8,30
3/16/1975,11,0,15,4,30
3/17/1975,14,0,2,6,22
3/18/1975,13,0,15,16,44
3/19/1975,13,0,6,0,19
3/20/1975,12,0,10,14,36
3/21/1975,15,0,3,0,18
3/22/1975,15,0,9,16,40
3/23/1975,14,0,3,6,23
3/24/1975,5,0,5,14,24
3/25/1975,12,0,4,8,24
3/26/1975,9,0,15,3,27
3/27/1975,4,0,2,10,16
3/28/1975,14,0,5,13,32
3/29/1975,16,0,10,6,32
3/30/1975,13,0,7,8,28
3/31/1975,7,0,10,3,20
4/1/1975,15,0,11,9,35
4/2/1975,16,0,2,4,22
4/3/1975,6,0,3,12,21
4/4/1975,5,0,14,12,31
4/5/1975,7,0,10,12,29
4/6/1975,6,0,14,10,30
4/7/1975,9,0,5,16,30
4/8/1975,7,0,8,14,29
4/9/1975,9,0,4,4,17
4/10/1975,5,0,5,3,13
4/11/1975,14,0,10,1,25
4/12/1975,13,0,6,0,19
4/13/1975,13,0,11,13,37
4/14/1975,5,0,16,7,28
4/15/1975,9,0,5,14,28
4/16/1975,8,0,16,4,28
4/17/1975,10,0,6,5,21
4/18/1975,8,0,16,4,28
4/19/1975,16,0,16,3,35
4/20/1975,8,0,4,7,19
4/21/1975,12,0,4,12,28
4/22/1975,8,0,6,8,22
4/23/1975,4,0,2,13,19
4/24/1975,6,0,14,12,32
4/25/1975,11,0,4,5,20
4/26/1975,7,0,4,13,24
4/27/1975,13,0,12,0,25
4/28/1975,11,0,12,2,25
4/29/1975,14,0,8,6,28
4/30/1975,9,0,8,5,22
5/1/1975,8,0,16,14,38
5/2/1975,9,0,10,15,34
5/3/1975,9,0,9,11,29
5/4/1975,9,0,15,13,37
5/5/1975,11,0,6,12,29
5/6/1975,16,0,9,9,34
5/7/1975,11,0,8,12,31
5/8/1975,16,0,6,11,33
5/9/1975,12,0,4,0,16
5/10/1975,10,0,14,1,25
5/11/1975,16,0,2,10,28
5/12/1975,4,0,6,1,11
5/13/1975,13,0,6,15,34
5/14/1975,9,0,14,9,32
5/15/1975,9,0,11,5,25
5/16/1975,12,0,16,7,35
5/17/1975,13,0,14,6,33
5/18/1975,4,0,2,13,19
5/19/1975,8,0,14,2,24
5/20/1975,5,0,16,5,26
5/21/1975,10,0,16,12,38
5/22/1975,5,0,15,11,31
5/23/1975,12,0,4,1,17
5/24/1975,13,0,14,15,42
5/25/1975,10,0,16,12,38
5/26/1975,15,0,15,16,46
5/27/1975,4,0,10,15,29
5/28/1975,10,0,6,3,19
5/29/1975,9,0,10,8,27
5/30/1975,5,0,13,2,20
5/31/1975,4,0,15,2,21
6/1/1975,13,0,14,0,27
6/2/1975,11,0,3,12,26
6/3/1975,16,0,8,10,34
6/4/1975,8,0,6,14,28
6/5/1975,5,0,11,6,22
6/6/1975,12,0,2,9,23
6/7/1975,9,0,16,10,35
6/8/1975,6,0,10,10,26
6/9/1975,13,0,6,13,32
6/10/1975,8,0,3,16,27
6/11/1975,7,0,12,3,22
6/12/1975,15,0,8,1,24
6/13/1975,9,0,16,2,27
6/14/1975,5,0,2,8,15
6/15/1975,5,0,11,12,28
6/16/1975,6,0,4,0,10
6/17/1975,16,0,14,15,45
6/18/1975,10,0,7,1,18
6/19/1975,4,0,14,12,30
6/20/1975,8,0,4,16,28
6/21/1975,16,0,14,13,43
6/22/1975,7,0,7,6,20
6/23/1975,6,0,10,16,32
6/24/1975,6,0,16,4,26
6/25/1975,10,0,14,5,29
6/26/1975,8,0,14,6,28
6/27/1975,11,0,6,5,22
6/28/1975,5,0,15,6,26
6/29/1975,12,0,7,6,25
6/30/1975,4,0,11,9,24
7/1/1975,8,0,8,11,27
7/2/1975,10,0,7,11,28
7/3/1975,11,0,6,12,29
7/4/1975,6,0,5,1,12
7/5/1975,5,0,9,6,20
7/6/1975,15,0,12,14,41
7/7/1975,16,0,7,15,38
7/8/1975,6,0,7,11,24
7/9/1975,11,0,5,8,24
7/10/1975,8,0,8,15,31
7/11/1975,6,0,3,2,11
7/12/1975,4,0,11,0,15
7/13/1975,7,0,11,12,30
7/14/1975,6,0,2,11,19
7/15/1975,8,0,15,0,23
7/16/1975,12,0,3,14,29
7/17/1975,11,0,9,15,35
7/18/1975,8,0,7,1,16
7/19/1975,12,0,14,12,38
7/20/1975,13,0,4,7,24
7/21/1975,4,0,16,8,28
7/22/1975,7,0,2,12,21
7/23/1975,11,0,4,3,18
7/24/1975,13,0,5,14,32
7/25/1975,11,0,14,0,25
7/26/1975,13,0,2,2,17
7/27/1975,15,0,7,1,23
7/28/1975,13,0,12,9,34
7/29/1975,12,0,13,0,25
7/30/1975,6,0,5,2,13
7/31/1975,9,0,2,9,20
8/1/1975,7,0,7,16,30
8/2/1975,5,0,15,15,35
8/3/1975,5,0,6,10,21
8/4/1975,11,0,14,16,41
8/5/1975,10,0,14,8,32
8/6/1975,15,0,16,3,34
8/7/1975,9,0,10,4,23
8/8/1975,11,0,16,2,29
8/9/1975,12,0,9,4,25
8/10/1975,4,0,16,14,34
8/11/1975,8,0,12,9,29
8/12/1975,16,0,12,3,31
8/13/1975,13,0,8,8,29
8/14/1975,12,0,12,2,26
8/15/1975,10,0,4,9,23
8/16/1975,10,0,16,14,40
8/17/1975,16,0,14,16,46
8/18/1975,4,0,16,7,27
8/19/1975,8,0,9,9,26
8/20/1975,13,0,9,4,26
8/21/1975,4,0,13,5,22
8/22/1975,8,0,11,8,27
8/23/1975,16,0,8,13,37
8/24/1975,14,0,5,3,22
8/25/1975,8,0,15,12,35
8/26/1975,5,0,7,1,13
8/27/1975,16,0,8,16,40
8/28/1975,14,0,16,10,40
8/29/1975,10,0,11,9,30
8/30/1975,13,0,12,4,29
8/31/1975,4,0,16,14,34
9/1/1975,5,0,11,11,27
9/2/1975,8,0,5,0,13
9/3/1975,6,0,5,11,22
9/4/1975,8,0,9,9,26
9/5/1975,10,0,14,1,25
9/6/1975,9,0,12,2,23
9/7/1975,8,0,15,6,29
9/8/1975,12,0,14,2,28
9/9/1975,15,0,9,15,39
9/10/1975,12,0,16,6,34
9/11/1975,9,0,14,6,29
9/12/1975,11,0,16,5,32
9/13/1975,13,0,10,11,34
9/14/1975,12,0,5,6,23
9/15/1975,6,0,12,7,25
9/16/1975,14,0,9,7,30
9/17/1975,6,0,13,12,31
9/18/1975,7,0,12,15,34
9/19/1975,8,0,13,10,31
9/20/1975,10,0,11,11,32
9/21/1975,11,0,8,3,22
9/22/1975,11,0,5,13,29
9/23/1975,12,0,14,6,32
9/24/1975,6,0,2,0,8
9/25/1975,11,0,5,11,27
9/26/1975,5,0,7,8,20
9/27/1975,6,0,9,11,26
9/28/1975,4,0,6,10,20
9/29/1975,11,0,4,9,24
9/30/1975,10,0,16,1,27
10/1/1975,8,0,8,3,19
10/2/1975,15,0,8,14,37
10/3/1975,10,0,4,13,27
10/4/1975,5,0,14,9,28
10/5/1975,5,0,5,0,10
10/6/1975,7,0,16,10,33
10/7/1975,4,0,9,11,24
10/8/1975,15,0,7,7,29
10/9/1975,15,0,16,4,35
10/10/1975,14,0,14,9,37
10/11/1975,10,0,5,9,24
10/12/1975,10,0,16,12,38
10/13/1975,8,0,2,11,21
10/14/1975,8,0,12,12,32
10/15/1975,7,0,15,5,27
10/16/1975,16,0,11,12,39
10/17/1975,5,0,16,11,32
10/18/1975,7,0,12,5,24
10/19/1975,5,0,9,9,23
10/20/1975,13,0,11,13,37
10/21/1975,8,0,16,8,32
10/22/1975,4,0,6,7,17
10/23/1975,4,0,6,7,17
10/24/1975,12,0,14,2,28
10/25/1975,16,0,6,3,25
10/26/1975,6,0,5,3,14
10/27/1975,13,0,10,0,23
10/28/1975,10,0,3,15,28
10/29/1975,14,0,10,10,34
10/30/1975,8,0,8,16,32
10/31/1975,10,0,9,16,35
11/1/1975,13,0,14,4,31
11/2/1975,10,0,7,2,19
11/3/1975,14,0,12,14,40
11/4/1975,11,0,8,12,31
11/5/1975,6,0,4,7,17
11/6/1975,15,0,14,7,36
11/7/1975,12,0,16,2,30
11/8/1975,11,0,12,3,26
11/9/1975,15,0,7,5,27
11/10/1975,4,0,8,16,28
11/11/1975,15,0,2,16,33
11/12/1975,14,0,10,15,39
11/13/1975,4,0,8,5,17
11/14/1975,9,0,10,4,23
11/15/1975,4,0,4,11,19
11/16/1975,10,0,11,14,35
11/17/1975,15,0,15,0,30
11/18/1975,6,0,14,16,36
11/19/1975,8,0,16,15,39
11/20/1975,4,0,5,15,24
11/21/1975,15,0,6,3,24
11/22/1975,6,0,8,13,27
11/23/1975,6,0,16,16,38
11/24/1975,11,0,16,13,40
11/25/1975,15,0,7,10,32
11/26/1975,6,0,7,1,14
11/27/1975,7,0,9,1,17
11/28/1975,15,0,6,6,27
11/29/1975,15,0,8,6,29
11/30/1975,6,0,5,10,21
12/1/1975,11,0,5,16,32
12/2/1975,8,0,6,13,27
12/3/1975,8,0,11,5,24
12/4/1975,10,0,15,16,41
12/5/1975,5,0,10,6,21
12/6/1975,8,0,14,12,34
12/7/1975,16,0,7,5,28
12/8/1975,7,0,14,14,35
12/9/1975,8,0,5,1,14
12/10/1975,16,0,11,11,38
12/11/1975,10,0,2,3,15
12/12/1975,9,0,10,16,35
12/13/1975,12,0,2,10,24
12/14/1975,6,0,15,6,27
12/15/1975,10,0,16,3,29
12/16/1975,6,0,5,11,22
12/17/1975,13,0,15,2,30
12/18/1975,9,0,6,12,27
12/19/1975,14,0,5,2,21
12/20/1975,9,0,7,9,25
12/21/1975,16,0,8,8,32
12/22/1975,6,0,10,10,26
12/23/1975,6,0,12,9,27
12/24/1975,11,0,3,14,28
12/25/1975,8,0,15,7,30
12/26/1975,6,0,10,8,24
12/27/1975,11,0,13,2,26
12/28/1975,8,0,15,12,35
12/29/1975,9,0,7,11,27
12/30/1975,8,0,13,2,23
12/31/1975,12,0,9,3,24
1/1/1976,12,0,7,13,32
1/2/1976,7,0,10,3,20
1/3/1976,7,0,2,16,25
1/4/1976,6,0,7,8,21
1/5/1976,4,0,15,14,33
1/6/1976,5,0,13,6,24
1/7/1976,7,0,12,15,34
1/8/1976,5,0,14,15,34
1/9/1976,4,0,12,1,17
1/10/1976,5,0,7,16,28
1/11/1976,9,0,3,7,19
1/12/1976,13,0,13,5,31
1/13/1976,14,0,13,4,31
1/14/1976,5,0,3,9,17
1/15/1976,15,0,5,15,35
1/16/1976,7,0,13,7,27
1/17/1976,6,0,6,15,27
1/18/1976,14,0,15,14,43
1/19/1976,8,0,15,2,25
1/20/1976,5,0,7,14,26
1/21/1976,15,0,15,2,32
1/22/1976,11,0,11,15,37
1/23/1976,9,0,3,0,12
1/24/1976,8,0,6,2,16
1/25/1976,14,0,9,7,30
1/26/1976,7,0,16,2,25
1/27/1976,13,0,6,1,20
1/28/1976,13,0,9,11,33
1/29/1976,12,0,10,6,28
1/30/1976,15,0,12,3,30
1/31/1976,4,0,9,11,24
2/1/1976,14,0,14,7,35
2/2/1976,6,0,2,10,18
2/3/1976,4,0,5,4,13
2/4/1976,12,0,16,5,33
2/5/1976,4,0,10,9,23
2/6/1976,16,0,14,1,31
2/7/1976,14,0,4,1,19
2/8/1976,13,0,8,8,29
2/9/1976,10,0,14,4,28
2/10/1976,5,0,9,10,24
2/11/1976,16,0,11,11,38
2/12/1976,14,0,14,4,32
2/13/1976,11,0,11,15,37
2/14/1976,15,0,3,3,21
2/15/1976,12,0,16,15,43
2/16/1976,15,0,5,12,32
2/17/1976,5,0,15,9,29
2/18/1976,5,0,8,1,14
2/19/1976,15,0,13,15,43
2/20/1976,15,0,5,8,28
2/21/1976,13,0,13,10,36
2/22/1976,9,0,16,1,26
2/23/1976,12,0,6,2,20
2/24/1976,9,0,9,16,34
2/25/1976,5,0,12,15,32
2/26/1976,7,0,15,13,35
2/27/1976,12,0,12,3,27
2/28/1976,10,0,3,4,17
2/29/1976,14,0,8,2,24
3/1/1976,4,0,6,4,14
3/2/1976,14,0,5,4,23
3/3/1976,14,0,8,7,29
3/4/1976,15,0,7,9,31
3/5/1976,9,0,10,0,19
3/6/1976,6,0,15,4,25
3/7/1976,5,0,12,10,27
3/8/1976,8,0,3,14,25
3/9/1976,6,0,3,8,17
3/10/1976,11,0,2,5,18
3/11/1976,15,0,16,4,35
3/12/1976,8,0,11,9,28
3/13/1976,6,0,10,5,21
3/14/1976,11,0,16,13,40
3/15/1976,12,0,15,11,38
3/16/1976,8,0,4,9,21
3/17/1976,12,0,14,3,29
3/18/1976,11,0,12,11,34
3/19/1976,14,0,5,8,27
3/20/1976,9,0,7,15,31
3/21/1976,4,0,6,8,18
3/22/1976,7,0,16,12,35
3/23/1976,15,0,2,16,33
3/24/1976,7,0,5,5,17
3/25/1976,4,0,2,11,17
3/26/1976,9,0,8,14,31
3/27/1976,13,0,10,6,29
3/28/1976,11,0,8,4,23
3/29/1976,5,0,15,1,21
3/30/1976,9,0,9,15,33
3/31/1976,9,0,15,2,26
4/1/1976,4,0,14,5,23
4/2/1976,11,0,3,10,24
4/3/1976,6,0,9,16,31
4/4/1976,11,0,9,13,33
4/5/1976,11,0,16,13,40
4/6/1976,14,0,16,2,32
4/7/1976,9,0,8,3,20
4/8/1976,12,0,10,6,28
4/9/1976,8,0,3,5,16
4/10/1976,8,0,6,1,15
4/11/1976,11,0,7,16,34
4/12/1976,14,0,9,16,39
4/13/1976,8,0,3,12,23
4/14/1976,14,0,14,9,37
4/15/1976,16,0,13,11,40
4/16/1976,7,0,13,15,35
4/17/1976,15,0,3,1,19
4/18/1976,8,0,10,0,18
4/19/1976,10,0,11,5,26
4/20/1976,8,0,15,12,35
4/21/1976,11,0,10,6,27
4/22/1976,4,0,5,10,19
4/23/1976,8,0,8,8,24
4/24/1976,8,0,4,9,21
4/25/1976,5,0,13,3,21
4/26/1976,14,0,2,10,26
4/27/1976,13,0,5,8,26
4/28/1976,5,0,12,7,24
4/29/1976,11,0,6,12,29
4/30/1976,15,0,15,14,44
5/1/1976,15,0,5,10,30
5/2/1976,11,0,16,1,28
5/3/1976,7,0,15,8,30
5/4/1976,7,0,7,14,28
5/5/1976,10,0,3,16,29
5/6/1976,7,0,2,8,17
5/7/1976,14,0,9,6,29
5/8/1976,10,0,10,15,35
5/9/1976,16,0,6,0,22
5/10/1976,12,0,13,8,33
5/11/1976,13,0,8,0,21
5/12/1976,5,0,15,5,25
5/13/1976,16,0,7,14,37
5/14/1976,5,0,8,0,13
5/15/1976,14,0,8,0,22
5/16/1976,16,0,4,13,33
5/17/1976,10,0,16,5,31
5/18/1976,13,0,10,0,23
5/19/1976,8,0,5,5,18
5/20/1976,11,0,10,8,29
5/21/1976,12,0,2,12,26
5/22/1976,7,0,4,6,17
5/23/1976,5,0,14,1,20
5/24/1976,9,0,2,3,14
5/25/1976,9,0,3,16,28
5/26/1976,16,0,11,1,28
5/27/1976,16,0,10,11,37
5/28/1976,10,0,10,15,35
5/29/1976,6,0,3,8,17
5/30/1976,10,0,2,14,26
5/31/1976,9,0,15,5,29
6/1/1976,12,0,14,0,26
6/2/1976,8,0,13,14,35
6/3/1976,16,0,6,10,32
6/4/1976,9,0,6,9,24
6/5/1976,14,0,8,2,24
6/6/1976,8,0,7,7,22
6/7/1976,8,0,7,12,27
6/8/1976,10,0,8,16,34
6/9/1976,9,0,2,11,22
6/10/1976,4,0,15,0,19
6/11/1976,12,0,7,11,30
6/12/1976,15,0,14,11,40
6/13/1976,7,0,16,13,36
6/14/1976,9,0,2,9,20
6/15/1976,14,0,9,8,31
6/16/1976,4,0,6,7,17
6/17/1976,7,0,13,10,30
6/18/1976,12,0,10,4,26
6/19/1976,14,0,4,8,26
6/20/1976,7,0,10,16,33
6/21/1976,12,0,13,9,34
6/22/1976,4,0,3,8,15
6/23/1976,4,0,5,12,21
6/24/1976,12,0,6,14,32
6/25/1976,10,0,13,0,23
6/26/1976,7,0,2,2,11
6/27/1976,15,0,6,15,36
6/28/1976,7,0,7,10,24
6/29/1976,15,0,15,14,44
6/30/1976,16,0,16,1,33
7/1/1976,6,0,14,15,35
7/2/1976,13,0,9,9,31
7/3/1976,11,0,9,1,21
7/4/1976,15,0,10,2,27
7/5/1976,11,0,10,0,21
7/6/1976,5,0,14,8,27
7/7/1976,11,0,6,14,31
7/8/1976,12,0,2,4,18
7/9/1976,10,0,12,13,35
7/10/1976,8,0,8,0,16
7/11/1976,8,0,12,3,23
7/12/1976,5,0,4,16,25
7/13/1976,7,0,9,5,21
7/14/1976,16,0,6,14,36
7/15/1976,4,0,15,0,19
7/16/1976,7,0,15,14,36
7/17/1976,6,0,15,1,22
7/18/1976,13,0,15,15,43
7/19/1976,4,0,15,10,29
7/20/1976,14,0,7,5,26
7/21/1976,7,0,7,8,22
7/22/1976,15,0,12,8,35
7/23/1976,4,0,9,13,26
7/24/1976,8,0,14,13,35
7/25/1976,16,0,9,3,28
7/26/1976,14,0,11,1,26
7/27/1976,16,0,12,13,41
7/28/1976,8,0,11,4,23
7/29/1976,15,0,4,11,30
7/30/1976,10,0,2,9,21
7/31/1976,14,0,9,11,34
8/1/1976,10,0,3,9,22
8/2/1976,5,0,5,14,24
8/3/1976,16,0,4,13,33
8/4/1976,4,0,11,11,26
8/5/1976,9,0,7,5,21
8/6/1976,12,0,6,0,18
8/7/1976,7,0,13,0,20
8/8/1976,7,0,12,12,31
8/9/1976,13,0,3,13,29
8/10/1976,14,0,10,11,35
8/11/1976,6,0,7,7,20
8/12/1976,9,0,7,15,31
8/13/1976,12,0,2,7,21
8/14/1976,14,0,16,9,39
8/15/1976,16,0,15,6,37
8/16/1976,15,0,7,4,26
8/17/1976,8,0,4,4,16
8/18/1976,5,0,8,6,19
8/19/1976,4,0,4,14,22
8/20/1976,6,0,2,14,22
8/21/1976,10,0,16,15,41
8/22/1976,9,0,13,3,25
8/23/1976,15,0,7,3,25
8/24/1976,15,0,13,8,36
8/25/1976,5,0,2,0,7
8/26/1976,4,0,15,15,34
8/27/1976,15,0,4,10,29
8/28/1976,12,0,13,12,37
8/29/1976,12,0,3,2,17
8/30/1976,13,0,6,14,33
8/31/1976,8,0,12,1,21
9/1/1976,5,0,10,1,16
9/2/1976,5,0,7,9,21
9/3/1976,15,0,11,16,42
9/4/1976,14,0,11,13,38
9/5/1976,5,0,16,8,29
9/6/1976,10,0,14,9,33
9/7/1976,7,0,14,8,29
9/8/1976,10,0,13,7,30
9/9/1976,5,0,3,10,18
9/10/1976,7,0,8,4,19
9/11/1976,13,0,8,2,23
9/12/1976,13,0,12,5,30
9/13/1976,9,0,2,13,24
9/14/1976,8,0,10,7,25
9/15/1976,16,0,13,16,45
9/16/1976,10,0,2,3,15
9/17/1976,7,0,3,5,15
9/18/1976,13,0,2,15,30
9/19/1976,12,0,9,16,37
9/20/1976,12,0,14,2,28
9/21/1976,13,0,9,3,25
9/22/1976,12,0,13,0,25
9/23/1976,6,0,15,14,35
9/24/1976,7,0,12,5,24
9/25/1976,15,0,6,2,23
9/26/1976,16,0,4,6,26
9/27/1976,14,0,11,6,31
9/28/1976,10,0,6,12,28
9/29/1976,14,0,4,2,20
9/30/1976,13,0,15,3,31
10/1/1976,12,0,7,1,20
10/2/1976,12,0,11,8,31
10/3/1976,13,0,2,5,20
10/4/1976,11,0,4,2,17
10/5/1976,6,0,15,5,26
10/6/1976,13,0,14,7,34
10/7/1976,6,0,16,16,38
10/8/1976,9,0,2,9,20
10/9/1976,15,0,13,0,28
10/10/1976,14,0,15,9,38
10/11/1976,12,0,3,9,24
10/12/1976,14,0,4,13,31
10/13/1976,9,0,16,4,29
10/14/1976,8,0,10,2,20
10/15/1976,6,0,5,14,25
10/16/1976,15,0,4,8,27
10/17/1976,4,0,14,0,18
10/18/1976,13,0,16,7,36
10/19/1976,13,0,5,4,22
10/20/1976,7,0,14,16,37
10/21/1976,10,0,8,6,24
10/22/1976,15,0,3,14,32
10/23/1976,15,0,4,1,20
10/24/1976,12,0,5,7,24
10/25/1976,6,0,16,0,22
10/26/1976,16,0,13,13,42
10/27/1976,12,0,7,16,35
10/28/1976,16,0,7,1,24
10/29/1976,8,0,7,14,29
10/30/1976,16,0,7,10,33
10/31/1976,16,0,14,1,31
11/1/1976,13,0,6,5,24
11/2/1976,12,0,4,8,24
11/3/1976,6,0,8,3,17
11/4/1976,4,0,7,12,23
11/5/1976,16,0,7,0,23
11/6/1976,12,0,14,3,29
11/7/1976,11,0,12,9,32
11/8/1976,9,0,14,12,35
11/9/1976,5,0,8,14,27
11/10/1976,6,0,12,16,34
11/11/1976,15,0,8,8,31
11/12/1976,11,0,13,15,39
11/13/1976,8,0,16,11,35
11/14/1976,10,0,5,4,19
11/15/1976,12,0,13,13,38
11/16/1976,13,0,6,1,20
11/17/1976,15,0,10,0,25
11/18/1976,8,0,7,0,15
11/19/1976,10,0,8,16,34
11/20/1976,7,0,6,1,14
11/21/1976,10,0,8,3,21
11/22/1976,7,0,16,10,33
11/23/1976,6,0,6,13,25
11/24/1976,10,0,5,15,30
11/25/1976,9,0,10,13,32
11/26/1976,11,0,16,13,40
11/27/1976,15,0,10,1,26
11/28/1976,15,0,6,8,29
11/29/1976,10,0,5,4,19
11/30/1976,6,0,6,10,22
12/1/1976,10,0,7,5,22
12/2/1976,9,0,4,6,19
12/3/1976,14,0,15,4,33
12/4/1976,8,0,5,12,25
12/5/1976,10,0,16,3,29
12/6/1976,6,0,12,1,19
12/7/1976,16,0,13,9,38
12/8/1976,15,0,2,7,24
12/9/1976,6,0,4,16,26
12/10/1976,9,0,10,3,22
12/11/1976,5,0,6,11,22
12/12/1976,6,0,11,6,23
12/13/1976,15,0,9,0,24
12/14/1976,6,0,14,11,31
12/15/1976,8,0,2,4,14
12/16/1976,4,0,13,12,29
12/17/1976,10,0,7,7,24
12/18/1976,9,0,3,10,22
12/19/1976,16,0,5,4,25
12/20/1976,4,0,9,7,20
12/21/1976,13,0,7,15,35
12/22/1976,12,0,15,12,39
12/23/1976,11,0,13,3,27
12/24/1976,16,0,3,4,23
12/25/1976,14,0,2,10,26
12/26/1976,15,0,4,6,25
12/27/1976,4,0,4,10,18
12/28/1976,5,0,15,15,35
12/29/1976,7,0,16,2,25
12/30/1976,6,0,16,11,33
12/31/1976,10,0,2,11,23
1/1/1977,12,0,16,5,33
1/2/1977,10,0,13,10,33
1/3/1977,10,0,13,3,26
1/4/1977,6,0,10,4,20
1/5/1977,9,0,16,3,28
1/6/1977,6,0,6,16,28
1/7/1977,10,0,12,2,24
1/8/1977,12,0,12,12,36
1/9/1977,14,0,10,8,32
1/10/1977,9,0,14,12,35
1/11/1977,5,0,14,15,34
1/12/1977,16,0,6,0,22
1/13/1977,15,0,14,13,42
1/14/1977,11,0,11,1,23
1/15/1977,8,0,14,1,23
1/16/1977,15,0,8,10,33
1/17/1977,6,0,12,13,31
1/18/1977,15,0,7,16,38
1/19/1977,9,0,5,8,22
1/20/1977,15,0,7,9,31
1/21/1977,4,0,13,7,24
1/22/1977,13,0,6,5,24
1/23/1977,5,0,3,6,14
1/24/1977,13,0,5,12,30
1/25/1977,12,0,16,6,34
1/26/1977,15,0,7,6,28
1/27/1977,6,0,6,2,14
1/28/1977,5,0,8,7,20
1/29/1977,4,0,2,0,6
1/30/1977,16,0,15,14,45
1/31/1977,12,0,12,9,33
2/1/1977,15,0,11,14,40
2/2/1977,9,0,8,11,28
2/3/1977,13,0,13,6,32
2/4/1977,8,0,11,11,30
2/5/1977,16,0,7,3,26
2/6/1977,6,0,15,2,23
2/7/1977,11,0,15,7,33
2/8/1977,11,0,9,12,32
2/9/1977,8,0,5,15,28
2/10/1977,9,0,9,5,23
2/11/1977,8,0,5,12,25
2/12/1977,12,0,11,14,37
2/13/1977,9,0,5,1,15
2/14/1977,6,0,16,15,37
2/15/1977,6,0,13,3,22
2/16/1977,8,0,13,16,37
2/17/1977,4,0,8,16,28
2/18/1977,6,0,15,11,32
2/19/1977,15,0,8,3,26
2/20/1977,14,0,2,5,21
2/21/1977,4,0,9,10,23
2/22/1977,5,0,15,2,22
2/23/1977,12,0,12,16,40
2/24/1977,14,0,15,3,32
2/25/1977,13,0,14,5,32
2/26/1977,14,0,15,7,36
2/27/1977,13,0,6,2,21
2/28/1977,11,0,5,16,32
3/1/1977,14,0,7,0,21
3/2/1977,4,0,16,0,20
3/3/1977,10,0,15,2,27
3/4/1977,11,0,4,16,31
3/5/1977,8,0,11,1,20
3/6/1977,12,0,5,15,32
3/7/1977,4,0,12,2,18
3/8/1977,14,0,13,15,42
3/9/1977,13,0,15,0,28
3/10/1977,12,0,9,12,33
3/11/1977,4,0,3,9,16
3/12/1977,7,0,13,10,30
3/13/1977,11,0,2,13,26
3/14/1977,13,0,9,2,24
3/15/1977,8,0,4,2,14
3/16/1977,6,0,11,2,19
3/17/1977,4,0,11,14,29
3/18/1977,6,0,11,5,22
3/19/1977,10,0,3,7,20
3/20/1977,9,0,13,12,34
3/21/1977,5,0,7,14,26
3/22/1977,7,0,6,4,17
3/23/1977,8,0,16,7,31
3/24/1977,8,0,15,14,37
3/25/1977,10,0,12,13,35
3/26/1977,6,0,4,2,12
3/27/1977,6,0,16,6,28
3/28/1977,11,0,4,11,26
3/29/1977,11,0,5,16,32
3/30/1977,9,0,2,3,14
3/31/1977,4,0,13,9,26
4/1/1977,6,0,10,3,19
4/2/1977,5,0,9,0,14
4/3/1977,4,0,10,13,27
4/4/1977,14,0,2,15,31
4/5/1977,4,0,6,5,15
4/6/1977,14,0,15,13,42
4/7/1977,16,0,13,14,43
4/8/1977,15,0,11,3,29
4/9/1977,8,0,3,9,20
4/10/1977,14,0,10,2,26
4/11/1977,14,0,6,2,22
4/12/1977,11,0,6,1,18
4/13/1977,15,0,9,15,39
4/14/1977,13,0,10,2,25
4/15/1977,10,0,8,4,22
4/16/1977,7,0,4,13,24
4/17/1977,13,0,5,10,28
4/18/1977,9,0,9,15,33
4/19/1977,9,0,16,8,33
4/20/1977,14,0,9,11,34
4/21/1977,8,0,4,7,19
4/22/1977,16,0,7,0,23
4/23/1977,15,0,2,6,23
4/24/1977,5,0,7,12,24
4/25/1977,12,0,16,6,34
4/26/1977,8,0,8,16,32
4/27/1977,11,0,13,1,25
4/28/1977,7,0,2,11,20
4/29/1977,7,0,15,5,27
4/30/1977,4,0,5,11,20
5/1/1977,7,0,8,1,16
5/2/1977,16,0,15,16,47
5/3/1977,13,0,10,12,35
5/4/1977,12,0,3,13,28
5/5/1977,8,0,6,12,26
5/6/1977,14,0,9,6,29
5/7/1977,6,0,11,1,18
5/8/1977,4,0,10,11,25
5/9/1977,7,0,8,14,29
5/10/1977,12,0,7,15,34
5/11/1977,10,0,5,4,19
5/12/1977,10,0,2,4,16
5/13/1977,13,0,9,6,28
5/14/1977,4,0,4,14,22
5/15/1977,5,0,8,0,13
5/16/1977,10,0,16,13,39
5/17/1977,8,0,8,10,26
5/18/1977,6,0,15,8,29
5/19/1977,8,0,2,4,14
5/20/1977,12,0,14,1,27
5/21/1977,7,0,4,14,25
5/22/1977,10,0,13,7,30
5/23/1977,10,0,8,13,31
5/24/1977,15,0,6,12,33
5/25/1977,9,0,12,5,26
5/26/1977,5,0,15,16,36
5/27/1977,13,0,5,0,18
5/28/1977,12,0,10,8,30
5/29/1977,10,0,16,14,40
5/30/1977,5,0,7,8,20
5/31/1977,14,0,7,9,30
6/1/1977,13,0,12,10,35
6/2/1977,11,0,7,3,21
6/3/1977,13,0,14,16,43
6/4/1977,12,0,3,16,31
6/5/1977,7,0,12,5,24
6/6/1977,5,0,8,0,13
6/7/1977,15,0,14,4,33
6/8/1977,6,0,6,16,28
6/9/1977,9,0,8,1,18
6/10/1977,13,0,4,12,29
6/11/1977,8,0,16,6,30
6/12/1977,9,0,13,4,26
6/13/1977,16,0,3,3,22
6/14/1977,8,0,7,7,22
6/15/1977,6,0,3,1,10
6/16/1977,9,0,2,6,17
6/17/1977,12,0,6,12,30
6/18/1977,6,0,11,0,17
6/19/1977,14,0,3,5,22
6/20/1977,14,0,13,3,30
6/21/1977,10,0,10,14,34
6/22/1977,11,0,14,4,29
6/23/1977,8,0,12,15,35
6/24/1977,10,0,6,2,18
6/25/1977,9,0,9,2,20
6/26/1977,16,0,2,6,24
6/27/1977,10,0,2,15,27
6/28/1977,13,0,5,0,18
6/29/1977,11,0,9,14,34
6/30/1977,9,0,16,6,31
7/1/1977,6,0,12,9,27
7/2/1977,15,0,3,11,29
7/3/1977,8,0,7,13,28
7/4/1977,11,0,12,11,34
7/5/1977,12,0,3,16,31
7/6/1977,14,0,10,3,27
7/7/1977,10,0,6,0,16
7/8/1977,13,0,9,15,37
7/9/1977,9,0,14,11,34
7/10/1977,9,0,2,16,27
7/11/1977,9,0,14,15,38
7/12/1977,12,0,4,11,27
7/13/1977,12,0,9,12,33
7/14/1977,13,0,10,11,34
7/15/1977,5,0,13,16,34
7/16/1977,12,0,15,5,32
7/17/1977,5,0,5,1,11
7/18/1977,8,0,3,0,11
7/19/1977,6,0,3,14,23
7/20/1977,9,0,2,3,14
7/21/1977,13,0,6,5,24
7/22/1977,5,0,6,14,25
7/23/1977,15,0,7,0,22
7/24/1977,9,0,13,2,24
7/25/1977,15,0,5,8,28
7/26/1977,4,0,7,12,23
7/27/1977,9,0,4,6,19
7/28/1977,14,0,13,0,27
7/29/1977,10,0,7,1,18
7/30/1977,12,0,2,7,21
7/31/1977,13,0,9,7,29
8/1/1977,4,0,14,13,31
8/2/1977,9,0,7,15,31
8/3/1977,10,0,9,5,24
8/4/1977,11,0,10,7,28
8/5/1977,8,0,16,1,25
8/6/1977,13,0,8,9,30
8/7/1977,13,0,7,3,23
8/8/1977,6,0,3,5,14
8/9/1977,5,0,15,4,24
8/10/1977,13,0,10,9,32
8/11/1977,10,0,13,1,24
8/12/1977,5,0,14,10,29
8/13/1977,6,0,4,4,14
8/14/1977,15,0,13,10,38
8/15/1977,15,0,9,2,26
8/16/1977,8,0,5,12,25
8/17/1977,8,0,10,14,32
8/18/1977,12,0,6,6,24
8/19/1977,8,0,16,16,40
8/20/1977,15,0,11,14,40
8/21/1977,11,0,4,1,16
8/22/1977,15,0,8,5,28
8/23/1977,6,0,15,7,28
8/24/1977,14,0,4,16,34
8/25/1977,10,0,13,16,39
8/26/1977,6,0,16,2,24
8/27/1977,5,0,13,0,18
8/28/1977,5,0,9,15,29
8/29/1977,8,0,4,15,27
8/30/1977,5,0,5,0,10
8/31/1977,9,0,16,12,37
9/1/1977,11,0,2,6,19
9/2/1977,9,0,15,2,26
9/3/1977,14,0,13,12,39
9/4/1977,10,0,15,7,32
9/5/1977,15,0,2,4,21
9/6/1977,11,0,13,6,30
9/7/1977,6,0,8,9,23
9/8/1977,13,0,13,0,26
9/9/1977,15,0,13,8,36
9/10/1977,14,0,5,9,28
9/11/1977,16,0,7,5,28
9/12/1977,8,0,13,15,36
9/13/1977,16,0,7,11,34
9/14/1977,10,0,13,7,30
9/15/1977,10,0,9,3,22
9/16/1977,7,0,8,8,23
9/17/1977,14,0,12,13,39
9/18/1977,15,0,11,15,41
9/19/1977,8,0,7,1,16
9/20/1977,11,0,6,2,19
9/21/1977,7,0,8,0,15
9/22/1977,4,0,2,10,16
9/23/1977,10,0,16,11,37
9/24/1977,16,0,14,4,34
9/25/1977,6,0,16,15,37
9/26/1977,8,0,9,15,32
9/27/1977,4,0,13,10,27
9/28/1977,16,0,9,13,38
9/29/1977,6,0,12,12,30
9/30/1977,7,0,8,13,28
10/1/1977,12,0,16,14,42
10/2/1977,8,0,14,9,31
10/3/1977,8,0,5,10,23
10/4/1977,6,0,4,0,10
10/5/1977,8,0,4,14,26
10/6/1977,6,0,2,8,16
10/7/1977,7,0,12,4,23
10/8/1977,6,0,14,8,28
10/9/1977,13,0,11,2,26
10/10/1977,4,0,5,11,20
10/11/1977,12,0,4,5,21
10/12/1977,8,0,7,8,23
10/13/1977,9,0,7,3,19
10/14/1977,12,0,10,16,38
10/15/1977,4,0,11,16,31
10/16/1977,7,0,9,11,27
10/17/1977,6,0,16,0,22
10/18/1977,11,0,12,5,28
10/19/1977,11,0,13,14,38
10/20/1977,15,0,4,2,21
10/21/1977,6,0,14,9,29
10/22/1977,5,0,7,8,20
10/23/1977,16,0,7,9,32
10/24/1977,9,0,15,3,27
10/25/1977,4,0,16,12,32
10/26/1977,11,0,6,10,27
10/27/1977,12,0,5,2,19
10/28/1977,10,0,8,0,18
10/29/1977,4,0,15,5,24
10/30/1977,4,0,15,7,26
10/31/1977,15,0,5,8,28
11/1/1977,8,0,2,14,24
11/2/1977,16,0,12,3,31
11/3/1977,15,0,13,10,38
11/4/1977,11,0,14,14,39
11/5/1977,5,0,2,0,7
11/6/1977,13,0,2,4,19
11/7/1977,12,0,13,5,30
11/8/1977,15,0,3,15,33
11/9/1977,6,0,14,16,36
11/10/1977,15,0,4,9,28
11/11/1977,9,0,13,2,24
11/12/1977,7,0,8,5,20
11/13/1977,6,0,2,1,9
11/14/1977,6,0,11,5,22
11/15/1977,6,0,13,7,26
11/16/1977,11,0,14,5,30
11/17/1977,6,0,11,1,18
11/18/1977,16,0,10,0,26
11/19/1977,11,0,2,4,17
11/20/1977,11,0,12,7,30
11/21/1977,9,0,16,10,35
11/22/1977,13,0,9,15,37
11/23/1977,10,0,7,7,24
11/24/1977,4,0,9,11,24
11/25/1977,11,0,14,15,40
11/26/1977,10,0,6,14,30
11/27/1977,11,0,11,2,24
11/28/1977,8,0,14,14,36
11/29/1977,12,0,2,0,14
11/30/1977,7,0,11,5,23
12/1/1977,13,0,6,14,33
12/2/1977,14,0,13,11,38
12/3/1977,11,0,16,5,32
12/4/1977,16,0,10,0,26
12/5/1977,10,0,8,15,33
12/6/1977,14,0,9,0,23
12/7/1977,14,0,4,13,31
12/8/1977,8,0,11,9,28
12/9/1977,13,0,11,9,33
12/10/1977,5,0,14,0,19
12/11/1977,4,0,10,12,26
12/12/1977,16,0,8,4,28
12/13/1977,13,0,13,9,35
12/14/1977,4,0,7,0,11
12/15/1977,13,0,7,1,21
12/16/1977,8,0,2,6,16
12/17/1977,6,0,15,1,22
12/18/1977,5,0,11,16,32
12/19/1977,4,0,7,9,20
12/20/1977,4,0,7,10,21
12/21/1977,6,0,13,3,22
12/22/1977,7,0,14,3,24
12/23/1977,6,0,9,7,22
12/24/1977,9,0,16,0,25
12/25/1977,7,0,13,10,30
12/26/1977,4,0,2,3,9
12/27/1977,8,0,11,15,34
12/28/1977,14,0,2,13,29
12/29/1977,7,0,6,15,28
12/30/1977,15,0,10,1,26
12/31/1977,6,0,13,12,31
1/1/1978,15,0,13,15,43
1/2/1978,10,0,3,3,16
1/3/1978,9,0,9,11,29
1/4/1978,7,0,3,13,23
1/5/1978,4,0,5,7,16
1/6/1978,13,0,11,11,35
1/7/1978,15,0,8,0,23
1/8/1978,9,0,3,3,15
1/9/1978,15,0,16,10,41
1/10/1978,13,0,5,5,23
1/11/1978,4,0,11,14,29
1/12/1978,4,0,13,11,28
1/13/1978,11,0,16,2,29
1/14/1978,8,0,10,16,34
1/15/1978,11,0,5,8,24
1/16/1978,5,0,2,4,11
1/17/1978,6,0,10,8,24
1/18/1978,8,0,14,8,30
1/19/1978,6,0,2,7,15
1/20/1978,15,0,9,12,36
1/21/1978,15,0,9,15,39
1/22/1978,10,0,12,9,31
1/23/1978,7,0,10,0,17
1/24/1978,12,0,7,14,33
1/25/1978,5,0,15,7,27
1/26/1978,4,0,3,7,14
1/27/1978,9,0,11,0,20
1/28/1978,13,0,12,15,40
1/29/1978,15,0,8,14,37
1/30/1978,13,0,12,3,28
1/31/1978,15,0,13,8,36
2/1/1978,15,0,12,7,34
2/2/1978,5,0,4,16,25
2/3/1978,16,0,7,0,23
2/4/1978,12,0,11,16,39
2/5/1978,15,0,7,16,38
2/6/1978,14,0,5,12,31
2/7/1978,15,0,5,15,35
2/8/1978,5,0,8,16,29
2/9/1978,16,0,14,3,33
2/10/1978,14,0,15,3,32
2/11/1978,13,0,8,12,33
2/12/1978,7,0,6,2,15
2/13/1978,4,0,14,7,25
2/14/1978,4,0,7,14,25
2/15/1978,8,0,10,6,24
2/16/1978,14,0,4,6,24
2/17/1978,14,0,15,14,43
2/18/1978,4,0,11,6,21
2/19/1978,11,0,11,10,32
2/20/1978,8,0,4,8,20
2/21/1978,14,0,5,11,30
2/22/1978,8,0,5,14,27
2/23/1978,16,0,8,13,37
2/24/1978,8,0,4,11,23
2/25/1978,14,0,5,5,24
2/26/1978,14,0,16,14,44
2/27/1978,8,0,13,8,29
2/28/1978,9,0,8,1,18
3/1/1978,16,0,4,13,33
3/2/1978,9,0,14,4,27
3/3/1978,12,0,5,14,31
3/4/1978,8,0,16,9,33
3/5/1978,11,0,12,8,31
3/6/1978,4,0,12,14,30
3/7/1978,16,0,2,14,32
3/8/1978,14,0,11,16,41
3/9/1978,5,0,12,2,19
3/10/1978,5,0,2,3,10
3/11/1978,16,0,4,4,24
3/12/1978,15,0,12,0,27
3/13/1978,13,0,3,14,30
3/14/1978,4,0,3,8,15
3/15/1978,12,0,10,15,37
3/16/1978,11,0,5,12,28
3/17/1978,6,0,15,12,33
3/18/1978,9,0,10,16,35
3/19/1978,12,0,5,3,20
3/20/1978,7,0,2,16,25
3/21/1978,12,0,9,0,21
3/22/1978,10,0,8,3,21
3/23/1978,15,0,14,1,30
3/24/1978,7,0,8,16,31
3/25/1978,7,0,6,9,22
3/26/1978,8,0,2,14,24
3/27/1978,13,0,2,2,17
3/28/1978,4,0,3,11,18
3/29/1978,15,0,3,4,22
3/30/1978,4,0,15,6,25
3/31/1978,16,0,14,13,43
4/1/1978,8,0,11,7,26
4/2/1978,4,0,5,7,16
4/3/1978,13,0,13,6,32
4/4/1978,7,0,14,16,37
4/5/1978,7,0,3,7,17
4/6/1978,11,0,9,1,21
4/7/1978,15,0,10,14,39
4/8/1978,14,0,11,11,36
4/9/1978,9,0,6,8,23
4/10/1978,12,0,3,13,28
4/11/1978,7,0,2,8,17
4/12/1978,15,0,16,2,33
4/13/1978,14,0,7,10,31
4/14/1978,10,0,10,0,20
4/15/1978,16,0,5,9,30
4/16/1978,7,0,16,8,31
4/17/1978,16,0,4,15,35
4/18/1978,8,0,2,7,17
4/19/1978,9,0,3,6,18
4/20/1978,13,0,15,2,30
4/21/1978,7,0,4,6,17
4/22/1978,6,0,14,10,30
4/23/1978,4,0,13,2,19
4/24/1978,15,0,6,15,36
4/25/1978,16,0,3,9,28
4/26/1978,6,0,12,10,28
4/27/1978,15,0,11,9,35
4/28/1978,14,0,8,16,38
4/29/1978,8,0,16,3,27
4/30/1978,13,0,4,8,25
5/1/1978,11,0,3,11,25
5/2/1978,11,0,2,16,29
5/3/1978,13,0,2,8,23
5/4/1978,7,0,7,2,16
5/5/1978,11,0,6,4,21
5/6/1978,8,0,9,1,18
5/7/1978,9,0,11,15,35
5/8/1978,4,0,6,10,20
5/9/1978,4,0,10,8,22
5/10/1978,5,0,11,10,26
5/11/1978,8,0,4,0,12
5/12/1978,5,0,5,7,17
5/13/1978,9,0,9,2,20
5/14/1978,9,0,13,8,30
5/15/1978,6,0,6,0,12
5/16/1978,6,0,5,12,23
5/17/1978,7,0,13,8,28
5/18/1978,6,0,4,9,19
5/19/1978,15,0,14,9,38
5/20/1978,4,0,6,1,11
5/21/1978,13,0,13,0,26
5/22/1978,4,0,9,8,21
5/23/1978,11,0,8,14,33
5/24/1978,14,0,12,8,34
5/25/1978,16,0,4,7,27
5/26/1978,4,0,2,1,7
5/27/1978,13,0,3,4,20
5/28/1978,13,0,3,7,23
5/29/1978,12,0,13,13,38
5/30/1978,13,0,15,11,39
5/31/1978,13,0,14,8,35
6/1/1978,12,0,5,4,21
6/2/1978,16,0,13,10,39
6/3/1978,13,0,6,7,26
6/4/1978,8,0,16,14,38
6/5/1978,12,0,14,3,29
6/6/1978,15,0,11,16,42
6/7/1978,16,0,10,7,33
6/8/1978,4,0,5,1,10
6/9/1978,13,0,15,0,28
6/10/1978,15,0,9,5,29
6/11/1978,6,0,11,2,19
6/12/1978,12,0,15,11,38
6/13/1978,7,0,7,5,19
6/14/1978,11,0,14,8,33
6/15/1978,14,0,10,3,27
6/16/1978,4,0,15,0,19
6/17/1978,12,0,9,7,28
6/18/1978,7,0,2,12,21
6/19/1978,8,0,16,8,32
6/20/1978,9,0,12,13,34
6/21/1978,12,0,13,13,38
6/22/1978,6,0,13,0,19
6/23/1978,15,0,13,2,30
6/24/1978,12,0,7,1,20
6/25/1978,13,0,3,5,21
6/26/1978,8,0,11,5,24
6/27/1978,12,0,6,1,19
6/28/1978,11,0,6,12,29
6/29/1978,16,0,2,15,33
6/30/1978,12,0,8,14,34
7/1/1978,13,0,5,3,21
7/2/1978,8,0,15,7,30
7/3/1978,7,0,16,4,27
7/4/1978,13,0,5,16,34
7/5/1978,15,0,11,1,27
7/6/1978,9,0,4,3,16
7/7/1978,9,0,12,7,28
7/8/1978,9,0,15,8,32
7/9/1978,9,0,4,10,23
7/10/1978,15,0,15,11,41
7/11/1978,5,0,5,6,16
7/12/1978,13,0,5,2,20
7/13/1978,11,0,14,12,37
7/14/1978,13,0,16,7,36
7/15/1978,12,0,5,9,26
7/16/1978,8,0,7,16,31
7/17/1978,4,0,16,2,22
7/18/1978,11,0,3,5,19
7/19/1978,15,0,13,9,37
7/20/1978,11,0,5,11,27
7/21/1978,8,0,14,12,34
7/22/1978,13,0,2,15,30
7/23/1978,16,0,11,1,28
7/24/1978,12,0,10,9,31
7/25/1978,14,0,5,11,30
7/26/1978,11,0,11,10,32
7/27/1978,7,0,15,11,33
7/28/1978,6,0,7,2,15
7/29/1978,9,0,13,10,32
7/30/1978,12,0,15,9,36
7/31/1978,12,0,16,16,44
8/1/1978,5,0,3,1,9
8/2/1978,5,0,10,2,17
8/3/1978,8,0,7,2,17
8/4/1978,7,0,10,13,30
8/5/1978,15,0,13,15,43
8/6/1978,8,0,16,12,36
8/7/1978,8,0,9,14,31
8/8/1978,8,0,5,8,21
8/9/1978,15,0,13,13,41
8/10/1978,14,0,15,15,44
8/11/1978,11,0,3,14,28
8/12/1978,15,0,9,0,24
8/13/1978,11,0,2,7,20
8/14/1978,13,0,12,3,28
8/15/1978,14,0,10,4,28
8/16/1978,4,0,16,5,25
8/17/1978,14,0,4,15,33
8/18/1978,7,0,12,8,27
8/19/1978,6,0,3,5,14
8/20/1978,12,0,9,7,28
8/21/1978,15,0,3,15,33
8/22/1978,9,0,12,5,26
8/23/1978,7,0,5,14,26
8/24/1978,7,0,8,8,23
8/25/1978,9,0,11,4,24
8/26/1978,12,0,7,4,23
8/27/1978,16,0,7,2,25
8/28/1978,9,0,11,8,28
8/29/1978,5,0,7,11,23
8/30/1978,11,0,11,0,22
8/31/1978,10,0,15,6,31
9/1/1978,7,0,12,2,21
9/2/1978,15,0,5,13,33
9/3/1978,7,0,11,16,34
9/4/1978,15,0,15,7,37
9/5/1978,11,0,3,13,27
9/6/1978,9,0,10,7,26
9/7/1978,16,0,3,16,35
9/8/1978,11,0,11,7,29
9/9/1978,16,0,10,5,31
9/10/1978,6,0,11,16,33
9/11/1978,11,0,14,7,32
9/12/1978,13,0,10,4,27
9/13/1978,6,0,9,4,19
9/14/1978,16,0,6,5,27
9/15/1978,8,0,2,0,10
9/16/1978,9,0,3,6,18
9/17/1978,14,0,9,1,24
9/18/1978,14,0,10,7,31
9/19/1978,11,0,9,9,29
9/20/1978,5,0,16,10,31
9/21/1978,8,0,11,15,34
9/22/1978,11,0,10,1,22
9/23/1978,13,0,4,0,17
9/24/1978,15,0,15,0,30
9/25/1978,16,0,8,12,36
9/26/1978,10,0,9,1,20
9/27/1978,14,0,13,15,42
9/28/1978,15,0,8,16,39
9/29/1978,13,0,8,10,31
9/30/1978,14,0,8,1,23
10/1/1978,7,0,14,8,29
10/2/1978,8,0,7,12,27
10/3/1978,10,0,14,15,39
10/4/1978,10,0,4,5,19
10/5/1978,15,0,16,14,45
10/6/1978,5,0,5,7,17
10/7/1978,13,0,12,1,26
10/8/1978,7,0,7,7,21
10/9/1978,9,0,4,9,22
10/10/1978,12,0,3,11,26
10/11/1978,7,0,6,7,20
10/12/1978,16,0,15,3,34
10/13/1978,13,0,2,1,16
10/14/1978,15,0,4,0,19
10/15/1978,6,0,16,15,37
10/16/1978,7,0,8,11,26
10/17/1978,8,0,14,12,34
10/18/1978,13,0,11,6,30
10/19/1978,10,0,8,7,25
10/20/1978,13,0,5,10,28
10/21/1978,14,0,15,8,37
10/22/1978,10,0,10,5,25
10/23/1978,8,0,14,13,35
10/24/1978,5,0,10,4,19
10/25/1978,7,0,2,2,11
10/26/1978,9,0,3,16,28
10/27/1978,6,0,8,8,22
10/28/1978,8,0,10,0,18
10/29/1978,15,0,12,1,28
10/30/1978,10,0,2,0,12
10/31/1978,12,0,4,11,27
11/1/1978,14,0,10,2,26
11/2/1978,6,0,4,5,15
11/3/1978,7,0,16,14,37
11/4/1978,5,0,11,0,16
11/5/1978,12,0,5,4,21
11/6/1978,11,0,9,12,32
11/7/1978,7,0,10,2,19
11/8/1978,14,0,11,2,27
11/9/1978,13,0,8,12,33
11/10/1978,8,0,11,12,31
11/11/1978,10,0,11,13,34
11/12/1978,5,0,12,13,30
11/13/1978,15,0,8,16,39
11/14/1978,9,0,7,12,28
11/15/1978,16,0,14,9,39
11/16/1978,7,0,2,1,10
11/17/1978,6,0,5,8,19
11/18/1978,14,0,8,11,33
11/19/1978,16,0,7,3,26
11/20/1978,13,0,8,3,24
11/21/1978,9,0,16,13,38
11/22/1978,6,0,13,0,19
11/23/1978,14,0,6,11,31
11/24/1978,15,0,11,7,33
11/25/1978,15,0,16,0,31
11/26/1978,12,0,10,3,25
11/27/1978,14,0,12,4,30
11/28/1978,9,0,5,7,21
11/29/1978,7,0,9,15,31
11/30/1978,11,0,8,13,32
12/1/1978,15,0,16,8,39
12/2/1978,14,0,14,11,39
12/3/1978,5,0,7,9,21
12/4/1978,10,0,2,9,21
12/5/1978,5,0,11,1,17
12/6/1978,15,0,8,6,29
12/7/1978,12,0,14,8,34
12/8/1978,13,0,6,13,32
12/9/1978,5,0,16,10,31
12/10/1978,9,0,8,5,22
12/11/1978,9,0,11,12,32
12/12/1978,8,0,4,2,14
12/13/1978,16,0,2,8,26
12/14/1978,7,0,4,11,22
12/15/1978,9,0,7,14,30
12/16/1978,8,0,4,12,24
12/17/1978,5,0,14,3,22
12/18/1978,5,0,2,3,10
12/19/1978,4,0,3,6,13
12/20/1978,15,0,7,16,38
12/21/1978,13,0,5,16,34
12/22/1978,7,0,13,7,27
12/23/1978,12,0,16,1,29
12/24/1978,6,0,2,0,8
12/25/1978,12,0,2,2,16
12/26/1978,5,0,11,2,18
12/27/1978,6,0,14,1,21
12/28/1978,15,0,10,16,41
12/29/1978,14,0,9,8,31
12/30/1978,7,0,14,15,36
12/31/1978,16,0,13,10,39
1/1/1979,16,0,13,7,36
1/2/1979,10,0,4,3,17
1/3/1979,16,0,7,9,32
1/4/1979,5,0,8,16,29
1/5/1979,5,0,16,8,29
1/6/1979,5,0,11,10,26
1/7/1979,15,0,11,4,30
1/8/1979,7,0,8,16,31
1/9/1979,10,0,15,4,29
1/10/1979,4,0,11,9,24
1/11/1979,10,0,10,6,26
1/12/1979,4,0,12,15,31
1/13/1979,5,0,7,4,16
1/14/1979,13,0,9,9,31
1/15/1979,9,0,6,9,24
1/16/1979,16,0,10,13,39
1/17/1979,6,0,14,14,34
1/18/1979,11,0,14,8,33
1/19/1979,7,0,3,2,12
1/20/1979,8,0,8,0,16
1/21/1979,12,0,8,13,33
1/22/1979,6,0,12,1,19
1/23/1979,7,0,5,9,21
1/24/1979,8,0,6,7,21
1/25/1979,9,0,15,7,31
1/26/1979,11,0,4,1,16
1/27/1979,15,0,7,0,22
1/28/1979,10,0,7,9,26
1/29/1979,7,0,6,7,20
1/30/1979,6,0,12,0,18
1/31/1979,5,0,5,11,21
2/1/1979,8,0,4,6,18
2/2/1979,7,0,16,2,25
2/3/1979,16,0,13,10,39
2/4/1979,12,0,5,7,24
2/5/1979,14,0,7,8,29
2/6/1979,16,0,10,5,31
2/7/1979,15,0,9,6,30
2/8/1979,7,0,9,14,30
2/9/1979,10,0,16,0,26
2/10/1979,5,0,11,4,20
2/11/1979,9,0,6,7,22
2/12/1979,7,0,6,2,15
2/13/1979,5,0,5,15,25
2/14/1979,16,0,2,4,22
2/15/1979,12,0,11,4,27
2/16/1979,9,0,12,14,35
2/17/1979,16,0,5,2,23
2/18/1979,10,0,8,7,25
2/19/1979,10,0,10,6,26
2/20/1979,14,0,9,0,23
2/21/1979,8,0,4,8,20
2/22/1979,4,0,2,9,15
2/23/1979,11,0,9,9,29
2/24/1979,4,0,14,16,34
2/25/1979,12,0,9,6,27
2/26/1979,5,0,12,16,33
2/27/1979,15,0,3,2,20
2/28/1979,8,0,5,6,19
3/1/1979,8,0,2,15,25
3/2/1979,15,0,9,7,31
3/3/1979,13,0,11,3,27
3/4/1979,12,0,15,12,39
3/5/1979,14,0,12,10,36
3/6/1979,12,0,8,10,30
3/7/1979,4,0,9,12,25
3/8/1979,10,0,10,0,20
3/9/1979,10,0,2,2,14
3/10/1979,9,0,7,0,16
3/11/1979,16,0,6,7,29
3/12/1979,11,0,6,6,23
3/13/1979,13,0,4,16,33
3/14/1979,4,0,3,9,16
3/15/1979,14,0,8,6,28
3/16/1979,13,0,8,13,34
3/17/1979,6,0,14,2,22
3/18/1979,15,0,3,4,22
3/19/1979,9,0,7,8,24
3/20/1979,13,0,6,2,21
3/21/1979,13,0,13,14,40
3/22/1979,11,0,16,1,28
3/23/1979,16,0,5,16,37
3/24/1979,14,0,15,11,40
3/25/1979,13,0,16,6,35
3/26/1979,15,0,13,9,37
3/27/1979,12,0,13,4,29
3/28/1979,11,0,4,9,24
3/29/1979,10,0,13,11,34
3/30/1979,14,0,15,15,44
3/31/1979,9,0,15,10,34
4/1/1979,13,0,9,2,24
4/2/1979,14,0,7,16,37
4/3/1979,12,0,13,7,32
4/4/1979,5,0,5,16,26
4/5/1979,12,0,12,12,36
4/6/1979,6,0,5,4,15
4/7/1979,5,0,10,5,20
4/8/1979,9,0,4,2,15
4/9/1979,13,0,8,0,21
4/10/1979,5,0,6,2,13
4/11/1979,8,0,6,3,17
4/12/1979,7,0,2,11,20
4/13/1979,9,0,4,2,15
4/14/1979,6,0,8,11,25
4/15/1979,6,0,9,0,15
4/16/1979,11,0,9,13,33
4/17/1979,16,0,12,12,40
4/18/1979,9,0,9,4,22
4/19/1979,16,0,8,9,33
4/20/1979,6,0,6,7,19
4/21/1979,7,0,2,3,12
4/22/1979,7,0,4,3,14
4/23/1979,11,0,11,11,33
4/24/1979,4,0,16,1,21
4/25/1979,8,0,12,8,28
4/26/1979,16,0,5,1,22
4/27/1979,6,0,13,4,23
4/28/1979,7,0,10,13,30
4/29/1979,5,0,6,8,19
4/30/1979,7,0,4,13,24
5/1/1979,13,0,9,8,30
5/2/1979,12,0,10,7,29
5/3/1979,4,0,7,7,18
5/4/1979,8,0,10,13,31
5/5/1979,12,0,2,1,15
5/6/1979,5,0,13,8,26
5/7/1979,10,0,7,7,24
5/8/1979,7,0,14,10,31
5/9/1979,11,0,10,9,30
5/10/1979,9,0,9,12,30
5/11/1979,16,0,7,2,25
5/12/1979,6,0,3,7,16
5/13/1979,7,0,5,9,21
5/14/1979,11,0,4,12,27
5/15/1979,16,0,3,8,27
5/16/1979,15,0,13,2,30
5/17/1979,9,0,10,2,21
5/18/1979,5,0,15,11,31
5/19/1979,5,0,5,4,14
5/20/1979,10,0,14,3,27
5/21/1979,7,0,16,6,29
5/22/1979,9,0,6,2,17
5/23/1979,5,0,4,11,20
5/24/1979,5,0,16,3,24
5/25/1979,16,0,13,13,42
5/26/1979,11,0,6,9,26
5/27/1979,10,0,3,4,17
5/28/1979,13,0,2,4,19
5/29/1979,5,0,12,12,29
5/30/1979,9,0,13,5,27
5/31/1979,16,0,4,6,26
6/1/1979,15,0,9,15,39
6/2/1979,11,0,13,14,38
6/3/1979,10,0,10,12,32
6/4/1979,12,0,10,8,30
6/5/1979,7,0,11,8,26
6/6/1979,9,0,8,2,19
6/7/1979,13,0,7,0,20
6/8/1979,6,0,7,6,19
6/9/1979,14,0,14,6,34
6/10/1979,16,0,2,6,24
6/11/1979,4,0,13,2,19
6/12/1979,9,0,8,8,25
6/13/1979,11,0,10,5,26
6/14/1979,5,0,16,12,33
6/15/1979,15,0,11,7,33
6/16/1979,10,0,3,14,27
6/17/1979,7,0,6,12,25
6/18/1979,15,0,2,6,23
6/19/1979,13,0,7,4,24
6/20/1979,6,0,6,12,24
6/21/1979,13,0,9,12,34
6/22/1979,9,0,10,1,20
6/23/1979,12,0,14,2,28
6/24/1979,4,0,9,1,14
6/25/1979,15,0,10,3,28
6/26/1979,8,0,5,1,14
6/27/1979,14,0,5,14,33
6/28/1979,14,0,13,10,37
6/29/1979,12,0,10,10,32
6/30/1979,8,0,14,12,34
7/1/1979,9,0,8,16,33
7/2/1979,11,0,16,1,28
7/3/1979,16,0,4,0,20
7/4/1979,6,0,13,3,22
7/5/1979,13,0,4,9,26
7/6/1979,10,0,2,6,18
7/7/1979,6,0,14,4,24
7/8/1979,7,0,11,13,31
7/9/1979,9,0,4,16,29
7/10/1979,5,0,16,4,25
7/11/1979,7,0,6,16,29
7/12/1979,10,0,10,13,33
7/13/1979,9,0,14,2,25
7/14/1979,6,0,15,11,32
7/15/1979,15,0,15,9,39
7/16/1979,4,0,3,7,14
7/17/1979,7,0,7,0,14
7/18/1979,12,0,7,3,22
7/19/1979,10,0,7,5,22
7/20/1979,8,0,6,4,18
7/21/1979,16,0,15,11,42
7/22/1979,9,0,14,11,34
7/23/1979,15,0,11,9,35
7/24/1979,14,0,11,12,37
7/25/1979,13,0,11,5,29
7/26/1979,13,0,4,4,21
7/27/1979,10,0,11,12,33
7/28/1979,15,0,13,0,28
7/29/1979,12,0,8,10,30
7/30/1979,8,0,3,0,11
7/31/1979,9,0,2,12,23
8/1/1979,13,0,6,1,20
8/2/1979,11,0,14,7,32
8/3/1979,11,0,13,7,31
8/4/1979,11,0,2,11,24
8/5/1979,16,0,3,14,33
8/6/1979,10,0,13,1,24
8/7/1979,7,0,14,9,30
8/8/1979,6,0,6,7,19
8/9/1979,15,0,8,3,26
8/10/1979,11,0,5,2,18
8/11/1979,6,0,12,16,34
8/12/1979,15,0,7,7,29
8/13/1979,15,0,16,11,42
8/14/1979,16,0,11,14,41
8/15/1979,8,0,13,3,24
8/16/1979,11,0,11,0,22
8/17/1979,6,0,2,15,23
8/18/1979,14,0,12,16,42
8/19/1979,7,0,9,0,16
8/20/1979,16,0,3,16,35
8/21/1979,14,0,7,8,29
8/22/1979,15,0,11,7,33
8/23/1979,10,0,2,14,26
8/24/1979,8,0,12,6,26
8/25/1979,11,0,5,7,23
8/26/1979,9,0,14,4,27
8/27/1979,6,0,7,2,15
8/28/1979,6,0,11,14,31
8/29/1979,7,0,12,0,19
8/30/1979,7,0,4,9,20
8/31/1979,12,0,3,1,16
9/1/1979,5,0,9,11,25
9/2/1979,4,0,15,10,29
9/3/1979,6,0,16,5,27
9/4/1979,4,0,2,11,17
9/5/1979,11,0,11,16,38
9/6/1979,7,0,6,16,29
9/7/1979,16,0,11,11,38
9/8/1979,14,0,2,14,30
9/9/1979,14,0,11,14,39
9/10/1979,14,0,11,5,30
9/11/1979,5,0,14,13,32
9/12/1979,15,0,10,5,30
9/13/1979,15,0,3,14,32
9/14/1979,11,0,7,9,27
9/15/1979,12,0,8,10,30
9/16/1979,7,0,9,8,24
9/17/1979,5,0,3,7,15
9/18/1979,11,0,11,5,27
9/19/1979,10,0,8,15,33
9/20/1979,4,0,4,4,12
9/21/1979,5,0,11,0,16
9/22/1979,7,0,3,6,16
9/23/1979,5,0,12,2,19
9/24/1979,5,0,6,10,21
9/25/1979,10,0,15,9,34
9/26/1979,12,0,15,14,41
9/27/1979,15,0,5,10,30
9/28/1979,10,0,6,5,21
9/29/1979,10,0,2,5,17
9/30/1979,6,0,9,0,15
10/1/1979,12,0,4,1,17
10/2/1979,12,0,16,4,32
10/3/1979,16,0,10,11,37
10/4/1979,6,0,13,4,23
10/5/1979,12,0,8,14,34
10/6/1979,4,0,14,7,25
10/7/1979,4,0,6,14,24
10/8/1979,11,0,12,8,31
10/9/1979,8,0,10,6,24
10/10/1979,15,0,2,3,20
10/11/1979,6,0,15,2,23
10/12/1979,5,0,15,14,34
10/13/1979,11,0,10,11,32
10/14/1979,7,0,14,0,21
10/15/1979,14,0,11,13,38
10/16/1979,16,0,16,7,39
10/17/1979,11,0,4,14,29
10/18/1979,9,0,16,8,33
10/19/1979,14,0,7,4,25
10/20/1979,16,0,8,15,39
10/21/1979,15,0,6,12,33
10/22/1979,11,0,2,10,23
10/23/1979,11,0,8,12,31
10/24/1979,6,0,6,2,14
10/25/1979,11,0,15,2,28
10/26/1979,6,0,5,16,27
10/27/1979,14,0,15,15,44
10/28/1979,9,0,16,16,41
10/29/1979,8,0,11,9,28
10/30/1979,15,0,7,10,32
10/31/1979,12,0,8,12,32
11/1/1979,12,0,2,0,14
11/2/1979,8,0,15,15,38
11/3/1979,5,0,3,16,24
11/4/1979,12,0,13,15,40
11/5/1979,4,0,9,6,19
11/6/1979,4,0,3,11,18
11/7/1979,11,0,5,6,22
11/8/1979,14,0,16,5,35
11/9/1979,6,0,7,0,13
11/10/1979,13,0,5,3,21
11/11/1979,10,0,2,11,23
11/12/1979,12,0,6,10,28
11/13/1979,10,0,2,1,13
11/14/1979,9,0,3,8,20
11/15/1979,15,0,12,1,28
11/16/1979,16,0,8,14,38
11/17/1979,14,0,14,10,38
11/18/1979,11,0,9,2,22
11/19/1979,5,0,8,3,16
11/20/1979,14,0,16,7,37
11/21/1979,8,0,2,9,19
11/22/1979,8,0,2,13,23
11/23/1979,13,0,15,8,36
11/24/1979,4,0,12,1,17
11/25/1979,8,0,14,13,35
11/26/1979,15,0,15,7,37
11/27/1979,14,0,15,16,45
11/28/1979,9,0,8,10,27
11/29/1979,14,0,12,1,27
11/30/1979,13,0,7,3,23
12/1/1979,10,0,8,5,23
12/2/1979,9,0,5,12,26
12/3/1979,14,0,11,16,41
12/4/1979,16,0,12,10,38
12/5/1979,7,0,2,4,13
12/6/1979,11,0,4,4,19
12/7/1979,15,0,10,11,36
12/8/1979,8,0,3,11,22
12/9/1979,4,0,14,5,23
12/10/1979,13,0,16,1,30
12/11/1979,7,0,7,4,18
12/12/1979,4,0,2,13,19
12/13/1979,5,0,7,1,13
12/14/1979,8,0,3,9,20
12/15/1979,13,0,9,2,24
12/16/1979,7,0,16,9,32
12/17/1979,14,0,13,2,29
12/18/1979,7,0,16,4,27
12/19/1979,15,0,9,0,24
12/20/1979,4,0,12,3,19
12/21/1979,6,0,6,4,16
12/22/1979,9,0,9,11,29
12/23/1979,11,0,3,14,28
12/24/1979,4,0,11,5,20
12/25/1979,13,0,7,1,21
12/26/1979,16,0,8,4,28
12/27/1979,13,0,4,9,26
12/28/1979,7,0,16,12,35
12/29/1979,5,0,16,13,34
12/30/1979,6,0,8,8,22
12/31/1979,8,0,7,14,29
1/1/1980,13,0,5,5,23
1/2/1980,13,0,12,16,41
1/3/1980,5,0,6,9,20
1/4/1980,7,0,16,10,33
1/5/1980,10,0,6,7,23
1/6/1980,4,0,3,6,13
1/7/1980,15,0,8,6,29
1/8/1980,7,0,2,8,17
1/9/1980,15,0,6,1,22
1/10/1980,15,0,4,3,22
1/11/1980,6,0,2,15,23
1/12/1980,14,0,6,5,25
1/13/1980,15,0,15,10,40
1/14/1980,7,0,8,12,27
1/15/1980,11,0,2,5,18
1/16/1980,7,0,15,14,36
1/17/1980,6,0,10,6,22
1/18/1980,14,0,7,10,31
1/19/1980,15,0,4,7,26
1/20/1980,15,0,10,13,38
1/21/1980,15,0,5,4,24
1/22/1980,9,0,6,13,28
1/23/1980,4,0,13,14,31
1/24/1980,10,0,14,6,30
1/25/1980,11,0,16,8,35
1/26/1980,12,0,15,4,31
1/27/1980,9,0,7,12,28
1/28/1980,4,0,14,6,24
1/29/1980,10,0,2,4,16
1/30/1980,12,0,8,2,22
1/31/1980,9,0,7,15,31
2/1/1980,13,0,7,10,30
2/2/1980,14,0,15,12,41
2/3/1980,14,0,3,6,23
2/4/1980,7,0,4,6,17
2/5/1980,11,0,16,13,40
2/6/1980,5,0,9,1,15
2/7/1980,15,0,11,11,37
2/8/1980,8,0,15,9,32
2/9/1980,4,0,5,5,14
2/10/1980,14,0,10,13,37
2/11/1980,6,0,11,0,17
2/12/1980,16,0,16,0,32
2/13/1980,10,0,14,6,30
2/14/1980,16,0,15,15,46
2/15/1980,9,0,11,12,32
2/16/1980,14,0,12,9,35
2/17/1980,6,0,16,3,25
2/18/1980,5,0,9,10,24
2/19/1980,9,0,9,15,33
2/20/1980,7,0,16,2,25
2/21/1980,10,0,14,11,35
2/22/1980,8,0,7,14,29
2/23/1980,13,0,4,1,18
2/24/1980,9,0,3,1,13
2/25/1980,12,0,14,6,32
2/26/1980,11,0,11,4,26
2/27/1980,11,0,10,7,28
2/28/1980,10,0,14,12,36
2/29/1980,11,0,3,9,23
3/1/1980,8,0,3,0,11
3/2/1980,11,0,5,4,20
3/3/1980,12,0,11,12,35
3/4/1980,4,0,8,1,13
3/5/1980,10,0,4,16,30
3/6/1980,10,0,16,11,37
3/7/1980,15,0,8,11,34
3/8/1980,16,0,5,13,34
3/9/1980,14,0,10,5,29
3/10/1980,5,0,12,14,31
3/11/1980,13,0,11,8,32
3/12/1980,11,0,8,16,35
3/13/1980,8,0,2,4,14
3/14/1980,9,0,16,1,26
3/15/1980,6,0,6,4,16
3/16/1980,11,0,5,10,26
3/17/1980,7,0,13,14,34
3/18/1980,10,0,5,16,31
3/19/1980,10,0,16,12,38
3/20/1980,4,0,3,11,18
3/21/1980,6,0,16,7,29
3/22/1980,14,0,8,2,24
3/23/1980,5,0,5,16,26
3/24/1980,4,0,14,3,21
3/25/1980,6,0,2,14,22
3/26/1980,8,0,5,13,26
3/27/1980,15,0,7,9,31
3/28/1980,10,0,10,14,34
3/29/1980,10,0,11,11,32
3/30/1980,14,0,10,7,31
3/31/1980,4,0,5,2,11
4/1/1980,5,0,9,14,28
4/2/1980,16,0,9,10,35
4/3/1980,16,0,13,7,36
4/4/1980,16,0,9,3,28
4/5/1980,5,0,8,6,19
4/6/1980,6,0,2,13,21
4/7/1980,4,0,6,14,24
4/8/1980,16,0,12,3,31
4/9/1980,8,0,15,16,39
4/10/1980,10,0,12,4,26
4/11/1980,11,0,13,0,24
4/12/1980,7,0,6,5,18
4/13/1980,9,0,5,7,21
4/14/1980,13,0,2,11,26
4/15/1980,12,0,2,7,21
4/16/1980,15,0,4,2,21
4/17/1980,7,0,6,6,19
4/18/1980,15,0,15,16,46
4/19/1980,10,0,5,6,21
4/20/1980,5,0,5,10,20
4/21/1980,4,0,7,0,11
4/22/1980,12,0,5,16,33
4/23/1980,13,0,12,12,37
4/24/1980,10,0,12,7,29
4/25/1980,13,0,3,4,20
4/26/1980,14,0,14,7,35
4/27/1980,4,0,11,2,17
4/28/1980,8,0,3,2,13
4/29/1980,5,0,5,7,17
4/30/1980,6,0,15,8,29
5/1/1980,6,0,10,13,29
5/2/1980,8,0,13,0,21
5/3/1980,10,0,8,13,31
5/4/1980,15,0,10,12,37
5/5/1980,14,0,3,10,27
5/6/1980,7,0,7,7,21
5/7/1980,14,0,4,11,29
5/8/1980,5,0,15,1,21
5/9/1980,9,0,14,7,30
5/10/1980,10,0,10,4,24
5/11/1980,8,0,8,15,31
5/12/1980,15,0,10,0,25
5/13/1980,16,0,9,2,27
5/14/1980,16,0,12,12,40
5/15/1980,6,0,2,0,8
5/16/1980,12,0,6,1,19
5/17/1980,12,0,11,15,38
5/18/1980,10,0,15,8,33
5/19/1980,8,0,15,1,24
5/20/1980,10,0,11,7,28
5/21/1980,12,0,12,1,25
5/22/1980,15,0,12,2,29
5/23/1980,15,0,5,6,26
5/24/1980,16,0,10,0,26
5/25/1980,15,0,11,15,41
5/26/1980,13,0,15,10,38
5/27/1980,5,0,3,1,9
5/28/1980,13,0,16,7,36
5/29/1980,12,0,12,16,40
5/30/1980,15,0,9,0,24
5/31/1980,13,0,6,9,28
6/1/1980,10,0,11,0,21
6/2/1980,12,0,11,3,26
6/3/1980,11,0,8,2,21
6/4/1980,7,0,5,8,20
6/5/1980,15,0,3,8,26
6/6/1980,4,0,16,13,33
6/7/1980,6,0,3,2,11
6/8/1980,12,0,5,3,20
6/9/1980,5,0,11,5,21
6/10/1980,8,0,12,11,31
6/11/1980,13,0,14,4,31
6/12/1980,10,0,14,10,34
6/13/1980,5,0,4,0,9
6/14/1980,13,0,11,0,24
6/15/1980,13,0,10,5,28
6/16/1980,9,0,15,0,24
6/17/1980,9,0,13,12,34
6/18/1980,9,0,6,6,21
6/19/1980,4,0,4,16,24
6/20/1980,6,0,5,16,27
6/21/1980,12,0,2,2,16
6/22/1980,15,0,2,15,32
6/23/1980,11,0,4,4,19
6/24/1980,12,0,5,1,18
6/25/1980,8,0,7,12,27
6/26/1980,9,0,3,1,13
6/27/1980,9,0,14,0,23
6/28/1980,7,0,11,16,34
6/29/1980,6,0,4,15,25
6/30/1980,10,0,11,12,33
7/1/1980,8,0,14,16,38
7/2/1980,12,0,14,8,34
7/3/1980,14,0,9,2,25
7/4/1980,11,0,14,9,34
7/5/1980,9,0,2,14,25
7/6/1980,9,0,15,14,38
7/7/1980,7,0,2,8,17
7/8/1980,6,0,12,13,31
7/9/1980,16,0,14,4,34
7/10/1980,8,0,4,0,12
7/11/1980,8,0,2,3,13
7/12/1980,8,0,10,6,24
7/13/1980,5,0,8,1,14
7/14/1980,11,0,4,10,25
7/15/1980,13,0,9,0,22
7/16/1980,6,0,14,14,34
7/17/1980,12,0,13,11,36
7/18/1980,16,0,9,0,25
7/19/1980,13,0,6,8,27
7/20/1980,7,0,14,2,23
7/21/1980,11,0,2,0,13
7/22/1980,5,0,12,7,24
7/23/1980,15,0,9,4,28
7/24/1980,13,0,13,14,40
7/25/1980,12,0,2,3,17
7/26/1980,13,0,5,3,21
7/27/1980,10,0,4,14,28
7/28/1980,13,0,5,9,27
7/29/1980,6,0,14,3,23
7/30/1980,12,0,5,11,28
7/31/1980,9,0,16,6,31
8/1/1980,10,0,3,2,15
8/2/1980,16,0,3,3,22
8/3/1980,7,0,3,2,12
8/4/1980,15,0,5,5,25
8/5/1980,8,0,10,0,18
8/6/1980,6,0,14,16,36
8/7/1980,4,0,6,7,17
8/8/1980,5,0,2,8,15
8/9/1980,5,0,16,7,28
8/10/1980,6,0,10,10,26
8/11/1980,4,0,11,12,27
8/12/1980,9,0,2,12,23
8/13/1980,4,0,7,11,22
8/14/1980,4,0,6,8,18
8/15/1980,11,0,4,9,24
8/16/1980,11,0,7,14,32
8/17/1980,5,0,14,6,25
8/18/1980,12,0,6,9,27
8/19/1980,5,0,2,14,21
8/20/1980,9,0,3,6,18
8/21/1980,7,0,7,13,27
8/22/1980,9,0,2,14,25
8/23/1980,6,0,13,0,19
8/24/1980,10,0,10,1,21
8/25/1980,9,0,12,1,22
8/26/1980,14,0,7,4,25
8/27/1980,11,0,11,7,29
8/28/1980,15,0,5,6,26
8/29/1980,11,0,12,11,34
8/30/1980,13,0,7,12,32
8/31/1980,12,0,4,12,28
9/1/1980,8,0,5,16,29
9/2/1980,8,0,3,15,26
9/3/1980,12,0,9,1,22
9/4/1980,14,0,2,5,21
9/5/1980,8,0,6,12,26
9/6/1980,11,0,11,4,26
9/7/1980,12,0,14,0,26
9/8/1980,11,0,2,10,23
9/9/1980,15,0,5,0,20
9/10/1980,12,0,13,15,40
9/11/1980,10,0,9,2,21
9/12/1980,15,0,9,10,34
9/13/1980,6,0,9,13,28
9/14/1980,7,0,7,7,21
9/15/1980,9,0,12,16,37
9/16/1980,9,0,9,1,19
9/17/1980,16,0,14,8,38
9/18/1980,4,0,7,5,16
9/19/1980,13,0,5,11,29
9/20/1980,9,0,7,6,22
9/21/1980,16,0,11,9,36
9/22/1980,14,0,15,9,38
9/23/1980,15,0,5,2,22
9/24/1980,14,0,9,14,37
9/25/1980,9,0,4,2,15
9/26/1980,14,0,8,2,24
9/27/1980,14,0,12,7,33
9/28/1980,15,0,14,6,35
9/29/1980,9,0,13,13,35
9/30/1980,14,0,2,12,28
10/1/1980,5,0,7,13,25
10/2/1980,16,0,13,10,39
10/3/1980,13,0,11,11,35
10/4/1980,5,0,5,7,17
10/5/1980,9,0,4,16,29
10/6/1980,5,0,9,7,21
10/7/1980,14,0,12,7,33
10/8/1980,15,0,13,1,29
10/9/1980,8,0,8,13,29
10/10/1980,7,0,12,6,25
10/11/1980,11,0,3,5,19
10/12/1980,12,0,11,0,23
10/13/1980,14,0,8,8,30
10/14/1980,5,0,15,14,34
10/15/1980,10,0,14,15,39
10/16/1980,12,0,12,3,27
10/17/1980,11,0,15,16,42
10/18/1980,9,0,2,13,24
10/19/1980,5,0,9,1,15
10/20/1980,5,0,13,8,26
10/21/1980,15,0,5,1,21
10/22/1980,8,0,11,2,21
10/23/1980,10,0,14,10,34
10/24/1980,15,0,15,8,38
10/25/1980,12,0,9,5,26
10/26/1980,5,0,6,2,13
10/27/1980,6,0,15,1,22
10/28/1980,15,0,16,16,47
10/29/1980,15,0,4,9,28
10/30/1980,5,0,4,10,19
10/31/1980,13,0,12,8,33
11/1/1980,10,0,13,16,39
11/2/1980,11,0,2,13,26
11/3/1980,13,0,4,16,33
11/4/1980,15,0,2,6,23
11/5/1980,16,0,16,13,45
11/6/1980,16,0,11,6,33
11/7/1980,7,0,12,9,28
11/8/1980,12,0,8,7,27
11/9/1980,4,0,8,2,14
11/10/1980,9,0,12,0,21
11/11/1980,8,0,10,10,28
11/12/1980,13,0,5,4,22
11/13/1980,13,0,7,12,32
11/14/1980,4,0,8,11,23
11/15/1980,5,0,6,0,11
11/16/1980,14,0,14,15,43
11/17/1980,8,0,11,12,31
11/18/1980,6,0,9,2,17
11/19/1980,14,0,14,0,28
11/20/1980,5,0,13,14,32
11/21/1980,11,0,12,14,37
11/22/1980,11,0,13,14,38
11/23/1980,4,0,15,2,21
11/24/1980,16,0,9,1,26
11/25/1980,8,0,11,13,32
11/26/1980,10,0,2,0,12
11/27/1980,16,0,13,10,39
11/28/1980,6,0,16,14,36
11/29/1980,5,0,3,1,9
11/30/1980,10,0,8,16,34
12/1/1980,10,0,6,0,16
12/2/1980,16,0,7,15,38
12/3/1980,6,0,9,12,27
12/4/1980,12,0,3,6,21
12/5/1980,8,0,12,3,23
12/6/1980,5,0,7,9,21
12/7/1980,6,0,13,1,20
12/8/1980,11,0,9,15,35
12/9/1980,11,0,2,9,22
12/10/1980,9,0,11,13,33
12/11/1980,11,0,14,10,35
12/12/1980,7,0,6,9,22
12/13/1980,4,0,2,7,13
12/14/1980,12,0,15,13,40
12/15/1980,5,0,15,10,30
12/16/1980,14,0,14,7,35
12/17/1980,14,0,5,1,20
12/18/1980,14,0,2,1,17
12/19/1980,9,0,12,4,25
12/20/1980,9,0,3,4,16
12/21/1980,4,0,5,1,10
12/22/1980,11,0,5,9,25
12/23/1980,6,0,9,2,17
12/24/1980,16,0,16,2,34
12/25/1980,7,0,11,4,22
12/26/1980,15,0,10,15,40
12/27/1980,13,0,9,11,33
12/28/1980,13,0,3,11,27
12/29/1980,10,0,13,11,34
12/30/1980,11,0,2,1,14
12/31/1980,13,0,9,16,38
1/1/1981,6,0,14,10,30
1/2/1981,16,0,8,16,40
1/3/1981,5,0,11,7,23
1/4/1981,4,0,8,13,25
1/5/1981,13,0,2,6,21
1/6/1981,4,0,11,5,20
1/7/1981,13,0,8,4,25
1/8/1981,4,0,12,2,18
1/9/1981,6,0,4,9,19
1/10/1981,14,0,10,4,28
1/11/1981,8,0,8,0,16
1/12/1981,5,0,2,16,23
1/13/1981,5,0,14,9,28
1/14/1981,7,0,3,2,12
1/15/1981,15,0,5,16,36
1/16/1981,9,0,6,14,29
1/17/1981,8,0,5,6,19
1/18/1981,7,0,7,7,21
1/19/1981,7,0,14,16,37
1/20/1981,16,0,10,8,34
1/21/1981,12,0,9,16,37
1/22/1981,9,0,5,16,30
1/23/1981,15,0,13,9,37
1/24/1981,11,0,4,4,19
1/25/1981,9,0,16,14,39
1/26/1981,11,0,5,13,29
1/27/1981,7,0,4,10,21
1/28/1981,7,0,12,1,20
1/29/1981,15,0,13,16,44
1/30/1981,14,0,2,0,16
1/31/1981,14,0,11,11,36
2/1/1981,4,0,15,6,25
2/2/1981,13,0,3,3,19
2/3/1981,9,0,10,9,28
2/4/1981,10,0,15,8,33
2/5/1981,9,0,9,3,21
2/6/1981,4,0,9,12,25
2/7/1981,10,0,11,7,28
2/8/1981,10,0,3,9,22
2/9/1981,16,0,10,1,27
2/10/1981,13,0,9,8,30
2/11/1981,15,0,16,4,35
2/12/1981,4,0,7,2,13
2/13/1981,12,0,14,2,28
2/14/1981,5,0,14,2,21
2/15/1981,7,0,9,16,32
2/16/1981,11,0,2,3,16
2/17/1981,5,0,10,4,19
2/18/1981,5,0,3,10,18
2/19/1981,11,0,8,9,28
2/20/1981,15,0,12,12,39
2/21/1981,5,0,11,0,16
2/22/1981,16,0,16,4,36
2/23/1981,7,0,6,10,23
2/24/1981,11,0,16,1,28
2/25/1981,9,0,6,8,23
2/26/1981,7,0,4,8,19
2/27/1981,4,0,9,9,22
2/28/1981,4,0,13,11,28
3/1/1981,14,0,4,0,18
3/2/1981,9,0,6,13,28
3/3/1981,6,0,16,2,24
3/4/1981,10,0,11,6,27
3/5/1981,11,0,13,3,27
3/6/1981,7,0,4,14,25
3/7/1981,16,0,13,5,34
3/8/1981,14,0,4,14,32
3/9/1981,12,0,8,7,27
3/10/1981,10,0,2,8,20
3/11/1981,8,0,10,15,33
3/12/1981,7,0,7,10,24
3/13/1981,14,0,8,16,38
3/14/1981,12,0,5,16,33
3/15/1981,12,0,9,16,37
3/16/1981,15,0,2,13,30
3/17/1981,6,0,11,3,20
3/18/1981,8,0,9,16,33
3/19/1981,9,0,14,14,37
3/20/1981,14,0,9,16,39
3/21/1981,13,0,10,9,32
3/22/1981,12,0,7,2,21
3/23/1981,7,0,8,10,25
3/24/1981,11,0,13,8,32
3/25/1981,4,0,3,14,21
3/26/1981,6,0,16,2,24
3/27/1981,8,0,15,3,26
3/28/1981,16,0,16,7,39
3/29/1981,16,0,3,5,24
3/30/1981,14,0,10,1,25
3/31/1981,6,0,5,12,23
4/1/1981,15,0,15,15,45
4/2/1981,11,0,9,5,25
4/3/1981,13,0,2,1,16
4/4/1981,14,0,3,11,28
4/5/1981,5,0,3,14,22
4/6/1981,15,0,6,13,34
4/7/1981,7,0,7,9,23
4/8/1981,11,0,6,8,25
4/9/1981,11,0,3,12,26
4/10/1981,8,0,5,13,26
4/11/1981,14,0,6,2,22
4/12/1981,9,0,9,7,25
4/13/1981,15,0,4,4,23
4/14/1981,13,0,16,16,45
4/15/1981,13,0,4,13,30
4/16/1981,13,0,7,14,34
4/17/1981,15,0,7,11,33
4/18/1981,8,0,5,3,16
4/19/1981,12,0,4,14,30
4/20/1981,9,0,8,11,28
4/21/1981,11,0,11,14,36
4/22/1981,9,0,15,8,32
4/23/1981,15,0,2,7,24
4/24/1981,11,0,13,12,36
4/25/1981,4,0,12,11,27
4/26/1981,6,0,3,13,22
4/27/1981,10,0,16,1,27
4/28/1981,7,0,9,11,27
4/29/1981,15,0,7,0,22
4/30/1981,6,0,11,13,30
5/1/1981,8,0,8,0,16
5/2/1981,8,0,6,15,29
5/3/1981,14,0,11,1,26
5/4/1981,16,0,12,0,28
5/5/1981,15,0,4,15,34
5/6/1981,8,0,11,11,30
5/7/1981,9,0,15,13,37
5/8/1981,6,0,2,6,14
5/9/1981,9,0,5,3,17
5/10/1981,8,0,10,2,20
5/11/1981,5,0,7,1,13
5/12/1981,16,0,3,8,27
5/13/1981,11,0,8,7,26
5/14/1981,7,0,6,14,27
5/15/1981,12,0,10,3,25
5/16/1981,8,0,4,4,16
5/17/1981,5,0,10,12,27
5/18/1981,10,0,14,8,32
5/19/1981,5,0,11,0,16
5/20/1981,14,0,14,16,44
5/21/1981,13,0,13,7,33
5/22/1981,16,0,8,0,24
5/23/1981,9,0,5,16,30
5/24/1981,16,0,15,11,42
5/25/1981,12,0,8,1,21
5/26/1981,13,0,9,8,30
5/27/1981,8,0,13,7,28
5/28/1981,13,0,9,7,29
5/29/1981,11,0,12,11,34
5/30/1981,11,0,2,16,29
5/31/1981,7,0,14,6,27
6/1/1981,14,0,14,6,34
6/2/1981,5,0,8,14,27
6/3/1981,14,0,15,2,31
6/4/1981,13,0,6,10,29
6/5/1981,13,0,16,1,30
6/6/1981,7,0,5,4,16
6/7/1981,12,0,13,4,29
6/8/1981,11,0,4,15,30
6/9/1981,9,0,16,10,35
6/10/1981,7,0,2,13,22
6/11/1981,13,0,13,6,32
6/12/1981,5,0,8,14,27
6/13/1981,11,0,15,10,36
6/14/1981,12,0,6,2,20
6/15/1981,8,0,15,3,26
6/16/1981,13,0,10,14,37
6/17/1981,11,0,10,11,32
6/18/1981,9,0,16,9,34
6/19/1981,8,0,7,11,26
6/20/1981,13,0,3,7,23
6/21/1981,6,0,13,9,28
6/22/1981,11,0,5,1,17
6/23/1981,15,0,6,9,30
6/24/1981,14,0,7,14,35
6/25/1981,10,0,14,3,27
6/26/1981,6,0,10,7,23
6/27/1981,8,0,11,7,26
6/28/1981,15,0,9,0,24
6/29/1981,4,0,5,10,19
6/30/1981,11,0,13,6,30
7/1/1981,14,0,9,15,38
7/2/1981,6,0,9,4,19
7/3/1981,7,0,2,15,24
7/4/1981,9,0,10,3,22
7/5/1981,15,0,8,16,39
7/6/1981,9,0,13,6,28
7/7/1981,8,0,9,6,23
7/8/1981,13,0,12,10,35
7/9/1981,16,0,14,14,44
7/10/1981,12,0,10,9,31
7/11/1981,8,0,12,16,36
7/12/1981,12,0,12,1,25
7/13/1981,16,0,3,11,30
7/14/1981,7,0,3,7,17
7/15/1981,15,0,16,13,44
7/16/1981,13,0,11,0,24
7/17/1981,14,0,13,4,31
7/18/1981,8,0,5,8,21
7/19/1981,11,0,6,16,33
7/20/1981,10,0,2,0,12
7/21/1981,13,0,16,5,34
7/22/1981,16,0,14,12,42
7/23/1981,8,0,11,8,27
7/24/1981,7,0,9,14,30
7/25/1981,9,0,14,0,23
7/26/1981,9,0,5,12,26
7/27/1981,7,0,9,9,25
7/28/1981,6,0,14,13,33
7/29/1981,16,0,4,3,23
7/30/1981,12,0,9,3,24
7/31/1981,5,0,14,9,28
8/1/1981,16,0,14,0,30
8/2/1981,6,0,2,13,21
8/3/1981,14,0,3,6,23
8/4/1981,11,0,11,2,24
8/5/1981,12,0,8,0,20
8/6/1981,4,0,14,13,31
8/7/1981,12,0,5,11,28
8/8/1981,10,0,16,0,26
8/9/1981,12,0,2,12,26
8/10/1981,6,0,12,6,24
8/11/1981,10,0,4,14,28
8/12/1981,15,0,9,13,37
8/13/1981,9,0,11,5,25
8/14/1981,15,0,3,12,30
8/15/1981,10,0,2,16,28
8/16/1981,16,0,12,7,35
8/17/1981,6,0,10,15,31
8/18/1981,6,0,9,6,21
8/19/1981,4,0,7,12,23
8/20/1981,16,0,13,7,36
8/21/1981,13,0,12,6,31
8/22/1981,7,0,15,9,31
8/23/1981,16,0,3,11,30
8/24/1981,13,0,7,12,32
8/25/1981,13,0,7,0,20
8/26/1981,13,0,11,8,32
8/27/1981,6,0,16,6,28
8/28/1981,7,0,7,9,23
8/29/1981,12,0,14,12,38
8/30/1981,8,0,3,5,16
8/31/1981,4,0,4,10,18
9/1/1981,5,0,14,8,27
9/2/1981,13,0,11,5,29
9/3/1981,15,0,13,6,34
9/4/1981,10,0,15,1,26
9/5/1981,14,0,6,7,27
9/6/1981,14,0,13,14,41
9/7/1981,16,0,11,0,27
9/8/1981,14,0,9,8,31
9/9/1981,16,0,2,5,23
9/10/1981,4,0,15,7,26
9/11/1981,7,0,14,5,26
9/12/1981,13,0,9,11,33
9/13/1981,11,0,2,10,23
9/14/1981,9,0,13,16,38
9/15/1981,12,0,2,12,26
9/16/1981,16,0,4,14,34
9/17/1981,9,0,11,9,29
9/18/1981,8,0,9,6,23
9/19/1981,6,0,14,10,30
9/20/1981,7,0,2,14,23
9/21/1981,7,0,11,6,24
9/22/1981,4,0,6,7,17
9/23/1981,15,0,11,1,27
9/24/1981,12,0,12,5,29
9/25/1981,9,0,15,8,32
9/26/1981,11,0,16,11,38
9/27/1981,4,0,15,2,21
9/28/1981,6,0,13,12,31
9/29/1981,14,0,2,1,17
9/30/1981,11,0,7,11,29
10/1/1981,12,0,11,3,26
10/2/1981,14,0,12,1,27
10/3/1981,16,0,6,2,24
10/4/1981,11,0,4,16,31
10/5/1981,7,0,13,1,21
10/6/1981,15,0,3,16,34
10/7/1981,16,0,7,12,35
10/8/1981,15,0,13,6,34
10/9/1981,6,0,5,1,12
10/10/1981,6,0,4,12,22
10/11/1981,12,0,13,5,30
10/12/1981,7,0,13,9,29
10/13/1981,14,0,6,7,27
10/14/1981,6,0,9,7,22
10/15/1981,15,0,4,1,20
10/16/1981,10,0,14,7,31
10/17/1981,16,0,16,6,38
10/18/1981,16,0,11,8,35
10/19/1981,13,0,13,15,41
10/20/1981,9,0,9,8,26
10/21/1981,11,0,13,1,25
10/22/1981,7,0,4,16,27
10/23/1981,6,0,5,14,25
10/24/1981,8,0,6,6,20
10/25/1981,4,0,10,0,14
10/26/1981,9,0,11,4,24
10/27/1981,4,0,16,3,23
10/28/1981,7,0,9,13,29
10/29/1981,7,0,4,1,12
10/30/1981,15,0,5,12,32
10/31/1981,8,0,8,15,31
11/1/1981,9,0,10,4,23
11/2/1981,12,0,4,10,26
11/3/1981,7,0,13,16,36
11/4/1981,7,0,9,5,21
11/5/1981,13,0,6,13,32
11/6/1981,13,0,14,12,39
11/7/1981,15,0,2,13,30
11/8/1981,11,0,16,6,33
11/9/1981,12,0,13,12,37
11/10/1981,4,0,4,6,14
11/11/1981,12,0,2,3,17
11/12/1981,8,0,7,14,29
11/13/1981,10,0,5,6,21
11/14/1981,13,0,16,9,38
11/15/1981,7,0,2,11,20
11/16/1981,15,0,4,14,33
11/17/1981,5,0,13,11,29
11/18/1981,13,0,2,13,28
11/19/1981,14,0,4,16,34
11/20/1981,14,0,3,12,29
11/21/1981,15,0,8,4,27
11/22/1981,10,0,2,4,16
11/23/1981,11,0,5,7,23
11/24/1981,4,0,6,10,20
11/25/1981,12,0,12,5,29
11/26/1981,16,0,3,6,25
11/27/1981,4,0,15,7,26
11/28/1981,9,0,15,5,29
11/29/1981,9,0,2,14,25
11/30/1981,8,0,12,8,28
12/1/1981,11,0,7,2,20
12/2/1981,15,0,7,13,35
12/3/1981,5,0,13,1,19
12/4/1981,16,0,8,6,30
12/5/1981,13,0,9,7,29
12/6/1981,9,0,2,16,27
12/7/1981,8,0,12,16,36
12/8/1981,9,0,11,8,28
12/9/1981,5,0,3,16,24
12/10/1981,9,0,11,6,26
12/11/1981,14,0,3,10,27
12/12/1981,5,0,11,2,18
12/13/1981,8,0,3,8,19
12/14/1981,13,0,8,12,33
12/15/1981,14,0,4,15,33
12/16/1981,8,0,8,14,30
12/17/1981,9,0,6,5,20
12/18/1981,10,0,16,10,36
12/19/1981,15,0,9,16,40
12/20/1981,13,0,8,1,22
12/21/1981,15,0,7,1,23
12/22/1981,9,0,11,6,26
12/23/1981,14,0,13,7,34
12/24/1981,14,0,10,15,39
12/25/1981,5,0,5,9,19
12/26/1981,14,0,14,4,32
12/27/1981,14,0,11,7,32
12/28/1981,7,0,11,15,33
12/29/1981,7,0,12,15,34
12/30/1981,4,0,10,15,29
12/31/1981,5,0,12,3,20
1/1/1982,12,0,9,10,31
1/2/1982,6,0,3,3,12
1/3/1982,4,0,5,16,25
1/4/1982,8,0,11,9,28
1/5/1982,8,0,16,12,36
1/6/1982,7,0,7,1,15
1/7/1982,4,0,11,7,22
1/8/1982,6,0,13,11,30
1/9/1982,10,0,5,9,24
1/10/1982,4,0,16,16,36
1/11/1982,13,0,5,5,23
1/12/1982,8,0,13,7,28
1/13/1982,10,0,10,13,33
1/14/1982,15,0,5,16,36
1/15/1982,14,0,11,9,34
1/16/1982,16,0,8,9,33
1/17/1982,16,0,2,1,19
1/18/1982,14,0,16,8,38
1/19/1982,6,0,7,8,21
1/20/1982,6,0,8,14,28
1/21/1982,8,0,7,8,23
1/22/1982,15,0,7,13,35
1/23/1982,8,0,10,9,27
1/24/1982,5,0,15,14,34
1/25/1982,8,0,14,0,22
1/26/1982,14,0,12,4,30
1/27/1982,15,0,13,3,31
1/28/1982,5,0,2,8,15
1/29/1982,7,0,13,12,32
1/30/1982,11,0,14,4,29
1/31/1982,11,0,15,13,39
2/1/1982,6,0,10,7,23
2/2/1982,4,0,4,2,10
2/3/1982,14,0,10,11,35
2/4/1982,15,0,8,2,25
2/5/1982,9,0,4,16,29
2/6/1982,15,0,14,8,37
2/7/1982,10,0,15,0,25
2/8/1982,11,0,13,15,39
2/9/1982,7,0,16,0,23
2/10/1982,9,0,12,11,32
2/11/1982,6,0,12,16,34
2/12/1982,13,0,16,14,43
2/13/1982,14,0,14,12,40
2/14/1982,10,0,5,3,18
2/15/1982,12,0,10,16,38
2/16/1982,9,0,4,12,25
2/17/1982,16,0,13,5,34
2/18/1982,7,0,11,5,23
2/19/1982,8,0,15,15,38
2/20/1982,5,0,14,11,30
2/21/1982,9,0,3,8,20
2/22/1982,7,0,2,13,22
2/23/1982,15,0,2,12,29
2/24/1982,13,0,11,9,33
2/25/1982,9,0,16,1,26
2/26/1982,10,0,2,5,17
2/27/1982,5,0,8,10,23
2/28/1982,5,0,14,4,23
3/1/1982,9,0,9,14,32
3/2/1982,9,0,5,15,29
3/3/1982,5,0,2,5,12
3/4/1982,13,0,16,6,35
3/5/1982,13,0,10,16,39
3/6/1982,15,0,4,11,30
3/7/1982,5,0,7,6,18
3/8/1982,16,0,16,6,38
3/9/1982,10,0,12,3,25
3/10/1982,11,0,10,0,21
3/11/1982,10,0,9,13,32
3/12/1982,11,0,12,8,31
3/13/1982,15,0,16,7,38
3/14/1982,8,0,15,8,31
3/15/1982,4,0,12,8,24
3/16/1982,5,0,12,15,32
3/17/1982,15,0,3,10,28
3/18/1982,14,0,12,8,34
3/19/1982,5,0,14,3,22
3/20/1982,7,0,14,11,32
3/21/1982,14,0,6,13,33
3/22/1982,16,0,14,0,30
3/23/1982,14,0,12,7,33
3/24/1982,6,0,14,7,27
3/25/1982,11,0,12,5,28
3/26/1982,5,0,13,5,23
3/27/1982,10,0,2,13,25
3/28/1982,15,0,7,1,23
3/29/1982,6,0,14,3,23
3/30/1982,16,0,3,6,25
3/31/1982,4,0,7,4,15
4/1/1982,6,0,11,6,23
4/2/1982,16,0,14,0,30
4/3/1982,11,0,9,11,31
4/4/1982,5,0,5,11,21
4/5/1982,8,0,14,12,34
4/6/1982,7,0,9,4,20
4/7/1982,12,0,10,2,24
4/8/1982,14,0,12,0,26
4/9/1982,9,0,12,15,36
4/10/1982,14,0,10,15,39
4/11/1982,15,0,2,5,22
4/12/1982,5,0,10,9,24
4/13/1982,4,0,13,14,31
4/14/1982,13,0,11,14,38
4/15/1982,6,0,15,10,31
4/16/1982,4,0,16,3,23
4/17/1982,7,0,4,15,26
4/18/1982,12,0,9,12,33
4/19/1982,5,0,5,14,24
4/20/1982,7,0,4,6,17
4/21/1982,5,0,12,7,24
4/22/1982,4,0,12,10,26
4/23/1982,9,0,5,4,18
4/24/1982,16,0,16,16,48
4/25/1982,8,0,13,4,25
4/26/1982,12,0,6,15,33
4/27/1982,10,0,4,9,23
4/28/1982,15,0,13,1,29
4/29/1982,13,0,5,16,34
4/30/1982,13,0,8,15,36
5/1/1982,10,0,10,15,35
5/2/1982,14,0,4,8,26
5/3/1982,14,0,7,10,31
5/4/1982,13,0,14,14,41
5/5/1982,15,0,15,4,34
5/6/1982,13,0,6,7,26
5/7/1982,11,0,11,5,27
5/8/1982,12,0,7,7,26
5/9/1982,16,0,15,4,35
5/10/1982,6,0,6,12,24
5/11/1982,15,0,6,9,30
5/12/1982,15,0,8,7,30
5/13/1982,15,0,5,13,33
5/14/1982,11,0,13,7,31
5/15/1982,6,0,9,9,24
5/16/1982,11,0,15,2,28
5/17/1982,7,0,3,1,11
5/18/1982,6,0,12,4,22
5/19/1982,9,0,2,12,23
5/20/1982,8,0,6,1,15
5/21/1982,10,0,4,7,21
5/22/1982,7,0,15,10,32
5/23/1982,11,0,12,0,23
5/24/1982,16,0,9,14,39
5/25/1982,16,0,7,9,32
5/26/1982,11,0,11,4,26
5/27/1982,13,0,11,6,30
5/28/1982,14,0,15,7,36
5/29/1982,7,0,6,0,13
5/30/1982,7,0,14,2,23
5/31/1982,16,0,8,9,33
6/1/1982,11,0,5,11,27
6/2/1982,16,0,8,3,27
6/3/1982,16,0,16,13,45
6/4/1982,7,0,9,13,29
6/5/1982,13,0,15,6,34
6/6/1982,14,0,7,11,32
6/7/1982,8,0,8,11,27
6/8/1982,5,0,7,3,15
6/9/1982,6,0,13,12,31
6/10/1982,7,0,16,3,26
6/11/1982,7,0,14,14,35
6/12/1982,10,0,8,9,27
6/13/1982,4,0,2,1,7
6/14/1982,8,0,10,3,21
6/15/1982,16,0,5,14,35
6/16/1982,10,0,10,15,35
6/17/1982,15,0,14,14,43
6/18/1982,14,0,5,6,25
6/19/1982,8,0,14,11,33
6/20/1982,10,0,9,9,28
6/21/1982,8,0,6,8,22
6/22/1982,7,0,4,1,12
6/23/1982,13,0,4,12,29
6/24/1982,6,0,16,2,24
6/25/1982,9,0,15,5,29
6/26/1982,5,0,2,14,21
6/27/1982,15,0,5,11,31
6/28/1982,5,0,14,8,27
6/29/1982,13,0,3,0,16
6/30/1982,11,0,12,15,38
7/1/1982,15,0,9,9,33
7/2/1982,8,0,11,7,26
7/3/1982,6,0,5,5,16
7/4/1982,6,0,6,13,25
7/5/1982,13,0,3,8,24
7/6/1982,14,0,10,11,35
7/7/1982,11,0,8,9,28
7/8/1982,10,0,10,5,25
7/9/1982,16,0,10,0,26
7/10/1982,9,0,13,8,30
7/11/1982,13,0,11,14,38
7/12/1982,11,0,16,14,41
7/13/1982,4,0,12,1,17
7/14/1982,4,0,6,1,11
7/15/1982,6,0,15,4,25
7/16/1982,8,0,3,14,25
7/17/1982,9,0,5,8,22
7/18/1982,5,0,14,4,23
7/19/1982,10,0,11,8,29
7/20/1982,15,0,11,12,38
7/21/1982,5,0,16,8,29
7/22/1982,11,0,16,7,34
7/23/1982,7,0,3,6,16
7/24/1982,14,0,3,4,21
7/25/1982,6,0,6,16,28
7/26/1982,10,0,2,5,17
7/27/1982,16,0,7,0,23
7/28/1982,5,0,6,12,23
7/29/1982,4,0,11,7,22
7/30/1982,6,0,13,12,31
7/31/1982,11,0,4,8,23
8/1/1982,12,0,8,4,24
8/2/1982,4,0,3,16,23
8/3/1982,14,0,7,12,33
8/4/1982,10,0,8,16,34
8/5/1982,11,0,6,16,33
8/6/1982,6,0,3,0,9
8/7/1982,5,0,14,3,22
8/8/1982,4,0,2,16,22
8/9/1982,8,0,10,10,28
8/10/1982,12,0,3,15,30
8/11/1982,9,0,3,16,28
8/12/1982,14,0,15,2,31
8/13/1982,9,0,15,8,32
8/14/1982,15,0,12,6,33
8/15/1982,5,0,7,14,26
8/16/1982,15,0,3,4,22
8/17/1982,12,0,15,10,37
8/18/1982,5,0,5,14,24
8/19/1982,14,0,8,1,23
8/20/1982,11,0,2,11,24
8/21/1982,9,0,15,15,39
8/22/1982,11,0,6,8,25
8/23/1982,11,0,8,16,35
8/24/1982,5,0,14,3,22
8/25/1982,9,0,2,15,26
8/26/1982,16,0,3,16,35
8/27/1982,10,0,9,9,28
8/28/1982,14,0,7,6,27
8/29/1982,8,0,16,5,29
8/30/1982,12,0,15,4,31
8/31/1982,6,0,7,10,23
9/1/1982,10,0,16,6,32
9/2/1982,9,0,13,0,22
9/3/1982,14,0,6,13,33
9/4/1982,5,0,9,0,14
9/5/1982,10,0,14,12,36
9/6/1982,16,0,6,15,37
9/7/1982,5,0,10,15,30
9/8/1982,8,0,7,5,20
9/9/1982,9,0,13,0,22
9/10/1982,14,0,3,9,26
9/11/1982,9,0,12,7,28
9/12/1982,8,0,4,3,15
9/13/1982,9,0,14,2,25
9/14/1982,4,0,10,10,24
9/15/1982,13,0,7,14,34
9/16/1982,5,0,11,14,30
9/17/1982,8,0,11,9,28
9/18/1982,9,0,4,1,14
9/19/1982,13,0,13,9,35
9/20/1982,13,0,11,2,26
9/21/1982,9,0,5,16,30
9/22/1982,8,0,13,1,22
9/23/1982,6,0,3,5,14
9/24/1982,10,0,8,10,28
9/25/1982,15,0,5,13,33
9/26/1982,5,0,6,6,17
9/27/1982,8,0,6,10,24
9/28/1982,6,0,12,3,21
9/29/1982,13,0,7,2,22
9/30/1982,12,0,12,3,27
10/1/1982,5,0,5,14,24
10/2/1982,6,0,7,3,16
10/3/1982,10,0,16,8,34
10/4/1982,9,0,15,5,29
10/5/1982,4,0,3,10,17
10/6/1982,8,0,6,8,22
10/7/1982,11,0,3,7,21
10/8/1982,9,0,7,16,32
10/9/1982,10,0,4,2,16
10/10/1982,5,0,7,14,26
10/11/1982,6,0,14,11,31
10/12/1982,12,0,2,0,14
10/13/1982,4,0,5,13,22
10/14/1982,10,0,7,11,28
10/15/1982,4,0,3,1,8
10/16/1982,13,0,16,12,41
10/17/1982,10,0,15,14,39
10/18/1982,15,0,10,6,31
10/19/1982,8,0,14,8,30
10/20/1982,9,0,9,6,24
10/21/1982,9,0,4,9,22
10/22/1982,11,0,3,16,30
10/23/1982,4,0,15,11,30
10/24/1982,11,0,8,8,27
10/25/1982,8,0,6,4,18
10/26/1982,10,0,3,11,24
10/27/1982,14,0,3,16,33
10/28/1982,7,0,4,4,15
10/29/1982,16,0,8,15,39
10/30/1982,4,0,9,12,25
10/31/1982,16,0,14,15,45
11/1/1982,5,0,6,14,25
11/2/1982,13,0,12,4,29
11/3/1982,16,0,14,5,35
11/4/1982,16,0,10,6,32
11/5/1982,9,0,11,8,28
11/6/1982,12,0,10,7,29
11/7/1982,5,0,9,4,18
11/8/1982,8,0,3,15,26
11/9/1982,8,0,8,9,25
11/10/1982,11,0,13,12,36
11/11/1982,14,0,2,10,26
11/12/1982,7,0,11,4,22
11/13/1982,13,0,15,3,31
11/14/1982,6,0,7,5,18
11/15/1982,12,0,2,14,28
11/16/1982,10,0,10,13,33
11/17/1982,15,0,15,5,35
11/18/1982,11,0,14,4,29
11/19/1982,11,0,14,1,26
11/20/1982,15,0,9,0,24
11/21/1982,15,0,3,9,27
11/22/1982,16,0,11,4,31
11/23/1982,9,0,15,4,28
11/24/1982,13,0,13,8,34
11/25/1982,11,0,4,13,28
11/26/1982,6,0,2,3,11
11/27/1982,15,0,11,1,27
11/28/1982,5,0,16,1,22
11/29/1982,5,0,4,15,24
11/30/1982,10,0,4,11,25
12/1/1982,16,0,11,4,31
12/2/1982,14,0,2,10,26
12/3/1982,11,0,10,9,30
12/4/1982,5,0,2,6,13
12/5/1982,5,0,10,15,30
12/6/1982,9,0,5,12,26
12/7/1982,14,0,3,6,23
12/8/1982,10,0,9,0,19
12/9/1982,5,0,11,2,18
12/10/1982,5,0,3,1,9
12/11/1982,10,0,7,15,32
12/12/1982,15,0,14,14,43
12/13/1982,4,0,6,7,17
12/14/1982,15,0,6,12,33
12/15/1982,7,0,9,6,22
12/16/1982,14,0,2,3,19
12/17/1982,8,0,5,0,13
12/18/1982,11,0,9,9,29
12/19/1982,16,0,14,4,34
12/20/1982,8,0,14,7,29
12/21/1982,10,0,14,8,32
12/22/1982,4,0,2,7,13
12/23/1982,4,0,10,0,14
12/24/1982,9,0,16,15,40
12/25/1982,7,0,2,12,21
12/26/1982,7,0,4,2,13
12/27/1982,14,0,12,11,37
12/28/1982,4,0,10,11,25
12/29/1982,14,0,3,16,33
12/30/1982,12,0,9,2,23
12/31/1982,5,0,6,16,27
1/1/1983,10,0,4,4,18
1/2/1983,9,0,2,10,21
1/3/1983,8,0,3,16,27
1/4/1983,4,0,3,16,23
1/5/1983,4,0,16,12,32
1/6/1983,11,0,2,8,21
1/7/1983,6,0,15,2,23
1/8/1983,6,0,10,3,19
1/9/1983,15,0,11,9,35
1/10/1983,9,0,14,0,23
1/11/1983,14,0,8,8,30
1/12/1983,7,0,4,8,19
1/13/1983,12,0,7,0,19
1/14/1983,4,0,4,10,18
1/15/1983,14,0,11,0,25
1/16/1983,15,0,6,4,25
1/17/1983,4,0,16,13,33
1/18/1983,6,0,9,14,29
1/19/1983,8,0,13,4,25
1/20/1983,5,0,13,2,20
1/21/1983,4,0,12,9,25
1/22/1983,4,0,15,10,29
1/23/1983,6,0,8,7,21
1/24/1983,15,0,15,11,41
1/25/1983,6,0,12,9,27
1/26/1983,9,0,11,10,30
1/27/1983,6,0,4,2,12
1/28/1983,7,0,2,5,14
1/29/1983,8,0,16,1,25
1/30/1983,4,0,14,0,18
1/31/1983,10,0,14,6,30
2/1/1983,16,0,9,0,25
2/2/1983,7,0,5,9,21
2/3/1983,4,0,2,6,12
2/4/1983,5,0,9,16,30
2/5/1983,13,0,12,6,31
2/6/1983,6,0,2,12,20
2/7/1983,8,0,4,11,23
2/8/1983,16,0,2,7,25
2/9/1983,12,0,5,4,21
2/10/1983,9,0,5,13,27
2/11/1983,8,0,14,2,24
2/12/1983,9,0,2,7,18
2/13/1983,14,0,6,14,34
2/14/1983,13,0,3,1,17
2/15/1983,12,0,10,16,38
2/16/1983,7,0,6,3,16
2/17/1983,4,0,14,13,31
2/18/1983,15,0,3,15,33
2/19/1983,5,0,15,1,21
2/20/1983,14,0,15,5,34
2/21/1983,5,0,16,6,27
2/22/1983,12,0,13,3,28
2/23/1983,8,0,16,15,39
2/24/1983,13,0,6,12,31
2/25/1983,6,0,12,15,33
2/26/1983,15,0,11,9,35
2/27/1983,12,0,10,11,33
2/28/1983,15,0,16,4,35
3/1/1983,12,0,2,13,27
3/2/1983,12,0,16,1,29
3/3/1983,7,0,13,10,30
3/4/1983,9,0,14,0,23
3/5/1983,16,0,8,11,35
3/6/1983,6,0,11,13,30
3/7/1983,5,0,3,2,10
3/8/1983,12,0,5,1,18
3/9/1983,10,0,12,10,32
3/10/1983,11,0,2,14,27
3/11/1983,14,0,11,13,38
3/12/1983,8,0,7,6,21
3/13/1983,8,0,4,2,14
3/14/1983,15,0,13,9,37
3/15/1983,4,0,5,7,16
3/16/1983,15,0,10,10,35
3/17/1983,8,0,10,8,26
3/18/1983,5,0,12,1,18
3/19/1983,10,0,7,2,19
3/20/1983,15,0,9,14,38
3/21/1983,12,0,14,16,42
3/22/1983,8,0,13,12,33
3/23/1983,13,0,13,15,41
3/24/1983,7,0,9,2,18
3/25/1983,13,0,3,6,22
3/26/1983,7,0,3,7,17
3/27/1983,7,0,15,1,23
3/28/1983,16,0,3,12,31
3/29/1983,4,0,14,2,20
3/30/1983,16,0,7,4,27
3/31/1983,8,0,16,9,33
4/1/1983,9,0,3,11,23
4/2/1983,9,0,15,16,40
4/3/1983,5,0,3,5,13
4/4/1983,6,0,10,11,27
4/5/1983,6,0,9,3,18
4/6/1983,10,0,4,14,28
4/7/1983,4,0,2,14,20
4/8/1983,10,0,13,10,33
4/9/1983,13,0,4,6,23
4/10/1983,5,0,11,14,30
4/11/1983,4,0,10,16,30
4/12/1983,7,0,10,16,33
4/13/1983,9,0,8,9,26
4/14/1983,5,0,15,5,25
4/15/1983,7,0,11,12,30
4/16/1983,6,0,11,3,20
4/17/1983,6,0,16,12,34
4/18/1983,9,0,14,8,31
4/19/1983,16,0,3,7,26
4/20/1983,11,0,2,9,22
4/21/1983,4,0,6,10,20
4/22/1983,15,0,12,15,42
4/23/1983,4,0,10,14,28
4/24/1983,11,0,12,6,29
4/25/1983,9,0,11,3,23
4/26/1983,11,0,9,16,36
4/27/1983,8,0,8,15,31
4/28/1983,9,0,12,3,24
4/29/1983,14,0,13,8,35
4/30/1983,15,0,14,9,38
5/1/1983,11,0,10,16,37
5/2/1983,8,0,12,6,26
5/3/1983,16,0,3,12,31
5/4/1983,12,0,11,10,33
5/5/1983,4,0,12,3,19
5/6/1983,4,0,14,8,26
5/7/1983,6,0,13,11,30
5/8/1983,12,0,12,4,28
5/9/1983,13,0,2,7,22
5/10/1983,6,0,8,5,19
5/11/1983,10,0,8,12,30
5/12/1983,4,0,5,1,10
5/13/1983,4,0,16,9,29
5/14/1983,7,0,9,5,21
5/15/1983,8,0,12,4,24
5/16/1983,14,0,6,5,25
5/17/1983,15,0,6,2,23
5/18/1983,12,0,7,11,30
5/19/1983,8,0,9,1,18
5/20/1983,15,0,15,12,42
5/21/1983,14,0,12,1,27
5/22/1983,15,0,6,1,22
5/23/1983,15,0,11,2,28
5/24/1983,16,0,3,0,19
5/25/1983,10,0,3,8,21
5/26/1983,8,0,10,3,21
5/27/1983,14,0,7,10,31
5/28/1983,13,0,16,4,33
5/29/1983,10,0,16,7,33
5/30/1983,11,0,12,9,32
5/31/1983,7,0,13,4,24
6/1/1983,13,0,14,8,35
6/2/1983,13,0,3,6,22
6/3/1983,9,0,6,13,28
6/4/1983,16,0,14,2,32
6/5/1983,5,0,9,5,19
6/6/1983,12,0,12,2,26
6/7/1983,10,0,15,11,36
6/8/1983,7,0,14,10,31
6/9/1983,13,0,6,1,20
6/10/1983,14,0,11,7,32
6/11/1983,5,0,5,9,19
6/12/1983,5,0,8,2,15
6/13/1983,8,0,15,6,29
6/14/1983,11,0,5,14,30
6/15/1983,4,0,14,8,26
6/16/1983,9,0,4,9,22
6/17/1983,12,0,12,12,36
6/18/1983,4,0,5,7,16
6/19/1983,11,0,9,9,29
6/20/1983,7,0,6,5,18
6/21/1983,5,0,13,9,27
6/22/1983,11,0,13,4,28
6/23/1983,16,0,13,11,40
6/24/1983,15,0,6,15,36
6/25/1983,13,0,9,9,31
6/26/1983,4,0,2,15,21
6/27/1983,15,0,11,8,34
6/28/1983,4,0,12,12,28
6/29/1983,16,0,12,3,31
6/30/1983,10,0,8,12,30
7/1/1983,13,0,12,2,27
7/2/1983,6,0,3,0,9
7/3/1983,11,0,14,5,30
7/4/1983,14,0,10,6,30
7/5/1983,4,0,2,13,19
7/6/1983,14,0,13,11,38
7/7/1983,8,0,4,0,12
7/8/1983,16,0,14,13,43
7/9/1983,15,0,10,15,40
7/10/1983,8,0,7,11,26
7/11/1983,15,0,3,11,29
7/12/1983,10,0,8,5,23
7/13/1983,7,0,6,11,24
7/14/1983,16,0,2,9,27
7/15/1983,14,0,8,10,32
7/16/1983,8,0,15,6,29
7/17/1983,12,0,13,15,40
7/18/1983,16,0,16,7,39
7/19/1983,6,0,6,0,12
7/20/1983,7,0,4,12,23
7/21/1983,5,0,3,11,19
7/22/1983,16,0,11,2,29
7/23/1983,6,0,10,5,21
7/24/1983,12,0,15,7,34
7/25/1983,7,0,12,6,25
7/26/1983,4,0,4,16,24
7/27/1983,10,0,16,4,30
7/28/1983,9,0,6,10,25
7/29/1983,6,0,11,9,26
7/30/1983,14,0,12,1,27
7/31/1983,16,0,11,14,41
8/1/1983,7,0,6,1,14
8/2/1983,6,0,14,16,36
8/3/1983,14,0,3,6,23
8/4/1983,15,0,12,8,35
8/5/1983,6,0,11,4,21
8/6/1983,6,0,6,14,26
8/7/1983,7,0,15,7,29
8/8/1983,10,0,15,8,33
8/9/1983,16,0,3,0,19
8/10/1983,10,0,8,4,22
8/11/1983,14,0,11,9,34
8/12/1983,5,0,3,5,13
8/13/1983,15,0,4,6,25
8/14/1983,7,0,12,6,25
8/15/1983,11,0,2,2,15
8/16/1983,5,0,8,10,23
8/17/1983,11,0,6,12,29
8/18/1983,9,0,9,11,29
8/19/1983,9,0,9,8,26
8/20/1983,15,0,11,12,38
8/21/1983,6,0,13,1,20
8/22/1983,6,0,8,15,29
8/23/1983,4,0,6,5,15
8/24/1983,12,0,14,0,26
8/25/1983,10,0,15,4,29
8/26/1983,12,0,16,3,31
8/27/1983,13,0,12,8,33
8/28/1983,15,0,2,12,29
8/29/1983,13,0,13,13,39
8/30/1983,8,0,5,13,26
8/31/1983,12,0,3,9,24
9/1/1983,9,0,12,13,34
9/2/1983,7,0,5,1,13
9/3/1983,10,0,16,12,38
9/4/1983,12,0,10,13,35
9/5/1983,11,0,13,8,32
9/6/1983,14,0,4,10,28
9/7/1983,5,0,11,14,30
9/8/1983,14,0,11,4,29
9/9/1983,7,0,7,13,27
9/10/1983,7,0,7,13,27
9/11/1983,9,0,15,16,40
9/12/1983,4,0,6,5,15
9/13/1983,8,0,4,8,20
9/14/1983,14,0,15,8,37
9/15/1983,7,0,2,6,15
9/16/1983,15,0,4,12,31
9/17/1983,8,0,15,10,33
9/18/1983,12,0,13,6,31
9/19/1983,14,0,11,13,38
9/20/1983,11,0,6,7,24
9/21/1983,13,0,13,3,29
9/22/1983,16,0,8,5,29
9/23/1983,4,0,8,10,22
9/24/1983,14,0,8,3,25
9/25/1983,12,0,11,15,38
9/26/1983,5,0,6,8,19
9/27/1983,6,0,13,11,30
9/28/1983,11,0,16,15,42
9/29/1983,12,0,14,3,29
9/30/1983,11,0,6,10,27
10/1/1983,14,0,9,4,27
10/2/1983,11,0,6,10,27
10/3/1983,9,0,10,10,29
10/4/1983,4,0,15,16,35
10/5/1983,14,0,12,4,30
10/6/1983,8,0,9,3,20
10/7/1983,5,0,15,6,26
10/8/1983,4,0,8,8,20
10/9/1983,11,0,12,6,29
10/10/1983,11,0,14,0,25
10/11/1983,9,0,13,11,33
10/12/1983,9,0,5,11,25
10/13/1983,7,0,4,7,18
10/14/1983,7,0,8,16,31
10/15/1983,9,0,16,16,41
10/16/1983,12,0,12,4,28
10/17/1983,9,0,5,16,30
10/18/1983,5,0,3,0,8
10/19/1983,4,0,2,12,18
10/20/1983,10,0,8,7,25
10/21/1983,12,0,13,7,32
10/22/1983,15,0,12,7,34
10/23/1983,14,0,10,16,40
10/24/1983,7,0,3,9,19
10/25/1983,5,0,15,10,30
10/26/1983,6,0,16,1,23
10/27/1983,16,0,15,3,34
10/28/1983,8,0,4,4,16
10/29/1983,7,0,6,7,20
10/30/1983,10,0,6,11,27
10/31/1983,5,0,2,13,20
11/1/1983,4,0,15,11,30
11/2/1983,16,0,13,5,34
11/3/1983,11,0,13,12,36
11/4/1983,13,0,16,5,34
11/5/1983,15,0,13,5,33
11/6/1983,15,0,13,16,44
11/7/1983,7,0,12,11,30
11/8/1983,4,0,5,15,24
11/9/1983,9,0,3,15,27
11/10/1983,11,0,15,15,41
11/11/1983,11,0,14,4,29
11/12/1983,6,0,6,11,23
11/13/1983,14,0,3,4,21
11/14/1983,11,0,11,12,34
11/15/1983,9,0,13,16,38
11/16/1983,7,0,16,15,38
11/17/1983,11,0,7,14,32
11/18/1983,16,0,10,16,42
11/19/1983,11,0,2,10,23
11/20/1983,15,0,16,3,34
11/21/1983,14,0,2,6,22
11/22/1983,7,0,8,8,23
11/23/1983,8,0,11,6,25
11/24/1983,14,0,13,0,27
11/25/1983,13,0,15,16,44
11/26/1983,15,0,12,12,39
11/27/1983,4,0,15,7,26
11/28/1983,5,0,2,3,10
11/29/1983,8,0,13,2,23
11/30/1983,16,0,3,14,33
12/1/1983,7,0,8,2,17
12/2/1983,6,0,5,9,20
12/3/1983,6,0,4,15,25
12/4/1983,12,0,12,5,29
12/5/1983,13,0,12,5,30
12/6/1983,13,0,2,4,19
12/7/1983,6,0,4,6,16
12/8/1983,14,0,8,11,33
12/9/1983,11,0,2,2,15
12/10/1983,6,0,10,11,27
12/11/1983,15,0,16,0,31
12/12/1983,9,0,13,3,25
12/13/1983,13,0,8,15,36
12/14/1983,8,0,14,2,24
12/15/1983,6,0,14,16,36
12/16/1983,11,0,12,10,33
12/17/1983,5,0,3,14,22
12/18/1983,5,0,15,14,34
12/19/1983,10,0,12,2,24
12/20/1983,9,0,15,15,39
12/21/1983,7,0,11,8,26
12/22/1983,8,0,16,2,26
12/23/1983,12,0,7,14,33
12/24/1983,15,0,5,10,30
12/25/1983,15,0,11,8,34
12/26/1983,13,0,9,13,35
12/27/1983,11,0,4,5,20
12/28/1983,12,0,12,13,37
12/29/1983,11,0,8,13,32
12/30/1983,12,0,4,4,20
12/31/1983,12,0,12,5,29
1/1/1984,13,0,12,1,26
1/2/1984,11,0,15,0,26
1/3/1984,12,0,10,7,29
1/4/1984,7,0,6,5,18
1/5/1984,6,0,4,16,26
1/6/1984,11,0,2,5,18
1/7/1984,9,0,10,3,22
1/8/1984,4,0,2,4,10
1/9/1984,4,0,10,15,29
1/10/1984,13,0,10,3,26
1/11/1984,6,0,3,14,23
1/12/1984,11,0,13,6,30
1/13/1984,9,0,4,6,19
1/14/1984,6,0,15,4,25
1/15/1984,14,0,12,8,34
1/16/1984,15,0,4,13,32
1/17/1984,7,0,11,1,19
1/18/1984,14,0,4,6,24
1/19/1984,11,0,10,6,27
1/20/1984,16,0,9,14,39
1/21/1984,5,0,8,6,19
1/22/1984,8,0,12,12,32
1/23/1984,10,0,5,15,30
1/24/1984,8,0,2,3,13
1/25/1984,10,0,11,8,29
1/26/1984,8,0,7,14,29
1/27/1984,7,0,7,16,30
1/28/1984,12,0,11,11,34
1/29/1984,14,0,5,13,32
1/30/1984,16,0,12,8,36
1/31/1984,8,0,9,4,21
2/1/1984,8,0,7,16,31
2/2/1984,8,0,6,16,30
2/3/1984,5,0,14,2,21
2/4/1984,9,0,10,9,28
2/5/1984,14,0,10,14,38
2/6/1984,16,0,16,13,45
2/7/1984,14,0,6,9,29
2/8/1984,10,0,3,11,24
2/9/1984,15,0,9,15,39
2/10/1984,5,0,12,16,33
2/11/1984,4,0,5,15,24
2/12/1984,14,0,2,2,18
2/13/1984,16,0,5,9,30
2/14/1984,8,0,2,13,23
2/15/1984,12,0,15,13,40
2/16/1984,14,0,3,12,29
2/17/1984,12,0,2,7,21
2/18/1984,12,0,13,4,29
2/19/1984,11,0,2,15,28
2/20/1984,13,0,14,0,27
2/21/1984,16,0,4,0,20
2/22/1984,16,0,3,12,31
2/23/1984,16,0,10,16,42
2/24/1984,4,0,11,13,28
2/25/1984,5,0,3,2,10
2/26/1984,4,0,9,5,18
2/27/1984,13,0,3,16,32
2/28/1984,14,0,16,3,33
2/29/1984,12,0,12,0,24
3/1/1984,12,0,9,4,25
3/2/1984,4,0,4,14,22
3/3/1984,13,0,14,12,39
3/4/1984,10,0,9,12,31
3/5/1984,14,0,14,14,42
3/6/1984,8,0,7,15,30
3/7/1984,11,0,10,4,25
3/8/1984,7,0,16,4,27
3/9/1984,8,0,12,8,28
3/10/1984,16,0,5,12,33
3/11/1984,10,0,15,10,35
3/12/1984,4,0,6,14,24
3/13/1984,14,0,2,16,32
3/14/1984,4,0,8,16,28
3/15/1984,11,0,11,6,28
3/16/1984,14,0,10,4,28
3/17/1984,11,0,12,13,36
3/18/1984,16,0,4,16,36
3/19/1984,16,0,2,4,22
3/20/1984,15,0,13,3,31
3/21/1984,8,0,12,9,29
3/22/1984,5,0,2,11,18
3/23/1984,10,0,6,5,21
3/24/1984,14,0,13,11,38
3/25/1984,16,0,9,9,34
3/26/1984,4,0,13,0,17
3/27/1984,12,0,15,12,39
3/28/1984,11,0,14,16,41
3/29/1984,7,0,5,2,14
3/30/1984,11,0,4,5,20
3/31/1984,8,0,4,11,23
4/1/1984,5,0,13,12,30
4/2/1984,14,0,2,4,20
4/3/1984,4,0,6,16,26
4/4/1984,14,0,11,9,34
4/5/1984,10,0,12,15,37
4/6/1984,4,0,12,3,19
4/7/1984,15,0,4,10,29
4/8/1984,14,0,3,0,17
4/9/1984,12,0,15,0,27
4/10/1984,7,0,3,7,17
4/11/1984,6,0,11,11,28
4/12/1984,15,0,8,16,39
4/13/1984,10,0,5,16,31
4/14/1984,15,0,12,2,29
4/15/1984,14,0,14,13,41
4/16/1984,4,0,2,7,13
4/17/1984,14,0,9,10,33
4/18/1984,16,0,6,8,30
4/19/1984,5,0,4,6,15
4/20/1984,14,0,15,3,32
4/21/1984,10,0,6,14,30
4/22/1984,15,0,13,1,29
4/23/1984,11,0,13,14,38
4/24/1984,4,0,9,1,14
4/25/1984,6,0,5,9,20
4/26/1984,11,0,14,9,34
4/27/1984,12,0,3,3,18
4/28/1984,5,0,6,2,13
4/29/1984,11,0,5,12,28
4/30/1984,13,0,6,8,27
5/1/1984,4,0,15,4,23
5/2/1984,10,0,7,16,33
5/3/1984,9,0,10,16,35
5/4/1984,9,0,12,11,32
5/5/1984,7,0,16,12,35
5/6/1984,15,0,2,12,29
5/7/1984,6,0,12,2,20
5/8/1984,11,0,10,14,35
5/9/1984,11,0,6,6,23
5/10/1984,16,0,4,1,21
5/11/1984,4,0,15,3,22
5/12/1984,11,0,3,5,19
5/13/1984,6,0,2,7,15
5/14/1984,15,0,8,2,25
5/15/1984,11,0,3,8,22
5/16/1984,4,0,10,4,18
5/17/1984,16,0,7,2,25
5/18/1984,16,0,9,0,25
5/19/1984,12,0,12,6,30
5/20/1984,8,0,5,14,27
5/21/1984,5,0,9,16,30
5/22/1984,12,0,5,3,20
5/23/1984,8,0,10,5,23
5/24/1984,15,0,16,13,44
5/25/1984,7,0,13,2,22
5/26/1984,6,0,16,4,26
5/27/1984,7,0,14,16,37
5/28/1984,8,0,11,16,35
5/29/1984,15,0,13,14,42
5/30/1984,13,0,8,2,23
5/31/1984,5,0,3,2,10
6/1/1984,7,0,15,15,37
6/2/1984,12,0,6,7,25
6/3/1984,8,0,15,7,30
6/4/1984,7,0,12,6,25
6/5/1984,4,0,13,5,22
6/6/1984,6,0,5,0,11
6/7/1984,7,0,10,5,22
6/8/1984,7,0,6,4,17
6/9/1984,8,0,12,16,36
6/10/1984,5,0,8,11,24
6/11/1984,4,0,7,10,21
6/12/1984,4,0,8,8,20
6/13/1984,14,0,10,1,25
6/14/1984,4,0,14,7,25
6/15/1984,7,0,13,11,31
6/16/1984,8,0,3,0,11
6/17/1984,11,0,9,5,25
6/18/1984,9,0,7,7,23
6/19/1984,4,0,5,16,25
6/20/1984,10,0,16,11,37
6/21/1984,10,0,13,11,34
6/22/1984,13,0,2,10,25
6/23/1984,14,0,16,15,45
6/24/1984,15,0,15,11,41
6/25/1984,7,0,13,4,24
6/26/1984,14,0,11,1,26
6/27/1984,8,0,3,1,12
6/28/1984,11,0,10,7,28
6/29/1984,7,0,16,4,27
6/30/1984,5,0,11,9,25
7/1/1984,12,0,5,12,29
7/2/1984,14,0,3,1,18
7/3/1984,12,0,7,11,30
7/4/1984,5,0,11,9,25
7/5/1984,9,0,9,15,33
7/6/1984,14,0,9,0,23
7/7/1984,10,0,7,16,33
7/8/1984,11,0,15,0,26
7/9/1984,11,0,2,5,18
7/10/1984,12,0,11,7,30
7/11/1984,14,0,4,3,21
7/12/1984,4,0,14,8,26
7/13/1984,12,0,15,5,32
7/14/1984,13,0,5,7,25
7/15/1984,6,0,6,0,12
7/16/1984,16,0,12,0,28
7/17/1984,4,0,7,12,23
7/18/1984,8,0,16,9,33
7/19/1984,9,0,14,4,27
7/20/1984,6,0,16,13,35
7/21/1984,11,0,7,4,22
7/22/1984,6,0,15,2,23
7/23/1984,8,0,2,1,11
7/24/1984,4,0,12,14,30
7/25/1984,8,0,3,0,11
7/26/1984,10,0,2,4,16
7/27/1984,15,0,6,6,27
7/28/1984,7,0,15,1,23
7/29/1984,7,0,9,6,22
7/30/1984,5,0,10,14,29
7/31/1984,12,0,15,8,35
8/1/1984,11,0,2,8,21
8/2/1984,13,0,5,4,22
8/3/1984,8,0,2,8,18
8/4/1984,12,0,16,12,40
8/5/1984,16,0,11,13,40
8/6/1984,8,0,12,3,23
8/7/1984,14,0,10,8,32
8/8/1984,4,0,8,15,27
8/9/1984,13,0,7,2,22
8/10/1984,9,0,3,1,13
8/11/1984,7,0,14,1,22
8/12/1984,13,0,2,6,21
8/13/1984,4,0,11,0,15
8/14/1984,7,0,9,14,30
8/15/1984,13,0,10,10,33
8/16/1984,11,0,2,9,22
8/17/1984,7,0,12,4,23
8/18/1984,12,0,12,3,27
8/19/1984,9,0,6,13,28
8/20/1984,16,0,2,6,24
8/21/1984,9,0,8,16,33
8/22/1984,6,0,8,11,25
8/23/1984,15,0,4,14,33
8/24/1984,9,0,7,16,32
8/25/1984,11,0,2,2,15
8/26/1984,12,0,9,11,32
8/27/1984,16,0,11,14,41
8/28/1984,4,0,15,6,25
8/29/1984,10,0,3,16,29
8/30/1984,14,0,14,7,35
8/31/1984,11,0,6,0,17
9/1/1984,14,0,16,6,36
9/2/1984,13,0,14,15,42
9/3/1984,11,0,16,5,32
9/4/1984,9,0,6,10,25
9/5/1984,16,0,6,0,22
9/6/1984,11,0,13,3,27
9/7/1984,6,0,10,6,22
9/8/1984,8,0,3,4,15
9/9/1984,16,0,8,9,33
9/10/1984,13,0,11,10,34
9/11/1984,16,0,13,16,45
9/12/1984,15,0,6,15,36
9/13/1984,8,0,10,8,26
9/14/1984,12,0,11,16,39
9/15/1984,9,0,16,7,32
9/16/1984,16,0,4,6,26
9/17/1984,11,0,5,9,25
9/18/1984,15,0,11,14,40
9/19/1984,11,0,6,9,26
9/20/1984,8,0,7,12,27
9/21/1984,6,0,2,4,12
9/22/1984,13,0,11,6,30
9/23/1984,14,0,3,4,21
9/24/1984,6,0,10,6,22
9/25/1984,15,0,3,15,33
9/26/1984,11,0,10,1,22
9/27/1984,15,0,6,0,21
9/28/1984,11,0,6,16,33
9/29/1984,6,0,8,4,18
9/30/1984,15,0,9,1,25
10/1/1984,5,0,2,5,12
10/2/1984,6,0,8,5,19
10/3/1984,8,0,15,3,26
10/4/1984,8,0,6,1,15
10/5/1984,10,0,10,8,28
10/6/1984,15,0,5,2,22
10/7/1984,10,0,8,12,30
10/8/1984,14,0,14,9,37
10/9/1984,16,0,14,5,35
10/10/1984,8,0,4,1,13
10/11/1984,4,0,16,11,31
10/12/1984,6,0,16,1,23
10/13/1984,4,0,6,4,14
10/14/1984,8,0,4,8,20
10/15/1984,8,0,9,5,22
10/16/1984,11,0,12,11,34
10/17/1984,8,0,8,10,26
10/18/1984,13,0,14,9,36
10/19/1984,10,0,16,14,40
10/20/1984,10,0,8,1,19
10/21/1984,7,0,11,7,25
10/22/1984,6,0,6,13,25
10/23/1984,15,0,15,14,44
10/24/1984,8,0,5,10,23
10/25/1984,9,0,8,14,31
10/26/1984,16,0,9,7,32
10/27/1984,8,0,3,15,26
10/28/1984,7,0,10,13,30
10/29/1984,8,0,5,2,15
10/30/1984,9,0,16,15,40
10/31/1984,4,0,6,2,12
11/1/1984,4,0,4,11,19
11/2/1984,11,0,12,14,37
11/3/1984,14,0,13,3,30
11/4/1984,7,0,4,15,26
11/5/1984,5,0,4,1,10
11/6/1984,11,0,14,7,32
11/7/1984,7,0,11,7,25
11/8/1984,5,0,12,7,24
11/9/1984,7,0,8,14,29
11/10/1984,7,0,16,4,27
11/11/1984,12,0,5,4,21
11/12/1984,8,0,15,4,27
11/13/1984,7,0,10,1,18
11/14/1984,8,0,5,1,14
11/15/1984,5,0,14,5,24
11/16/1984,7,0,3,16,26
11/17/1984,13,0,5,5,23
11/18/1984,12,0,11,8,31
11/19/1984,14,0,3,11,28
11/20/1984,16,0,10,3,29
11/21/1984,4,0,12,16,32
11/22/1984,4,0,5,0,9
11/23/1984,6,0,5,7,18
11/24/1984,12,0,5,0,17
11/25/1984,4,0,7,15,26
11/26/1984,5,0,3,5,13
11/27/1984,7,0,3,6,16
11/28/1984,9,0,2,14,25
11/29/1984,15,0,16,2,33
11/30/1984,5,0,15,7,27
12/1/1984,10,0,7,6,23
12/2/1984,15,0,12,6,33
12/3/1984,5,0,5,14,24
12/4/1984,8,0,9,4,21
12/5/1984,14,0,15,3,32
12/6/1984,14,0,7,0,21
12/7/1984,4,0,7,16,27
12/8/1984,7,0,5,9,21
12/9/1984,7,0,7,16,30
12/10/1984,8,0,3,6,17
12/11/1984,8,0,7,11,26
12/12/1984,6,0,12,14,32
12/13/1984,13,0,12,12,37
12/14/1984,13,0,8,11,32
12/15/1984,16,0,10,16,42
12/16/1984,8,0,15,8,31
12/17/1984,11,0,4,11,26
12/18/1984,13,0,4,6,23
12/19/1984,16,0,6,7,29
12/20/1984,13,0,16,5,34
12/21/1984,7,0,16,11,34
12/22/1984,14,0,7,6,27
12/23/1984,9,0,7,15,31
12/24/1984,14,0,13,9,36
12/25/1984,14,0,15,12,41
12/26/1984,10,0,10,1,21
12/27/1984,7,0,8,15,30
12/28/1984,11,0,11,13,35
12/29/1984,5,0,5,15,25
12/30/1984,14,0,5,11,30
12/31/1984,12,0,9,14,35
1/1/1985,16,0,9,14,39
1/2/1985,6,0,2,11,19
1/3/1985,14,0,5,6,25
1/4/1985,8,0,11,0,19
1/5/1985,4,0,10,10,24
1/6/1985,8,0,8,16,32
1/7/1985,11,0,9,9,29
1/8/1985,5,0,15,7,27
1/9/1985,15,0,3,14,32
1/10/1985,6,0,10,6,22
1/11/1985,12,0,11,16,39
1/12/1985,10,0,11,9,30
1/13/1985,9,0,4,8,21
1/14/1985,12,0,5,0,17
1/15/1985,11,0,11,11,33
1/16/1985,16,0,5,7,28
1/17/1985,5,0,3,16,24
1/18/1985,12,0,14,12,38
1/19/1985,4,0,16,3,23
1/20/1985,9,0,9,6,24
1/21/1985,16,0,5,7,28
1/22/1985,14,0,3,10,27
1/23/1985,5,0,2,9,16
1/24/1985,11,0,9,12,32
1/25/1985,13,0,14,5,32
1/26/1985,7,0,5,7,19
1/27/1985,7,0,8,14,29
1/28/1985,10,0,5,7,22
1/29/1985,14,0,16,12,42
1/30/1985,15,0,7,10,32
1/31/1985,15,0,16,0,31
2/1/1985,8,0,3,3,14
2/2/1985,5,0,11,13,29
2/3/1985,14,0,3,0,17
2/4/1985,8,0,12,16,36
2/5/1985,8,0,12,1,21
2/6/1985,4,0,10,9,23
2/7/1985,7,0,16,9,32
2/8/1985,15,0,10,9,34
2/9/1985,6,0,2,12,20
2/10/1985,8,0,5,2,15
2/11/1985,6,0,7,7,20
2/12/1985,12,0,15,8,35
2/13/1985,10,0,10,15,35
2/14/1985,10,0,7,6,23
2/15/1985,5,0,5,12,22
2/16/1985,4,0,2,6,12
2/17/1985,4,0,9,4,17
2/18/1985,7,0,10,5,22
2/19/1985,9,0,5,8,22
2/20/1985,14,0,12,11,37
2/21/1985,8,0,11,9,28
2/22/1985,14,0,16,12,42
2/23/1985,13,0,3,6,22
2/24/1985,16,0,14,3,33
2/25/1985,12,0,9,9,30
2/26/1985,13,0,6,14,33
2/27/1985,9,0,16,10,35
2/28/1985,7,0,7,2,16
3/1/1985,8,0,7,0,15
3/2/1985,9,0,10,15,34
3/3/1985,13,0,8,0,21
3/4/1985,10,0,5,12,27
3/5/1985,9,0,6,0,15
3/6/1985,12,0,11,3,26
3/7/1985,4,0,11,13,28
3/8/1985,4,0,3,9,16
3/9/1985,5,0,15,12,32
3/10/1985,7,0,2,8,17
3/11/1985,12,0,6,8,26
3/12/1985,13,0,8,1,22
3/13/1985,13,0,5,12,30
3/14/1985,5,0,8,14,27
3/15/1985,14,0,3,10,27
3/16/1985,10,0,13,9,32
3/17/1985,13,0,9,6,28
3/18/1985,4,0,16,1,21
3/19/1985,10,0,12,14,36
3/20/1985,4,0,6,13,23
3/21/1985,15,0,4,9,28
3/22/1985,16,0,16,7,39
3/23/1985,10,0,13,11,34
3/24/1985,12,0,7,5,24
3/25/1985,16,0,3,16,35
3/26/1985,6,0,14,10,30
3/27/1985,7,0,16,1,24
3/28/1985,12,0,12,3,27
3/29/1985,7,0,5,5,17
3/30/1985,11,0,4,5,20
3/31/1985,11,0,13,8,32
4/1/1985,9,0,16,15,40
4/2/1985,10,0,7,13,30
4/3/1985,13,0,16,5,34
4/4/1985,7,0,9,10,26
4/5/1985,15,0,6,9,30
4/6/1985,8,0,11,3,22
4/7/1985,4,0,6,8,18
4/8/1985,8,0,11,2,21
4/9/1985,6,0,9,2,17
4/10/1985,14,0,13,11,38
4/11/1985,7,0,15,2,24
4/12/1985,5,0,9,9,23
4/13/1985,12,0,4,0,16
4/14/1985,15,0,5,6,26
4/15/1985,15,0,6,8,29
4/16/1985,14,0,3,9,26
4/17/1985,16,0,4,7,27
4/18/1985,4,0,13,15,32
4/19/1985,10,0,16,5,31
4/20/1985,16,0,8,6,30
4/21/1985,11,0,16,7,34
4/22/1985,16,0,4,8,28
4/23/1985,10,0,2,13,25
4/24/1985,8,0,8,5,21
4/25/1985,13,0,16,3,32
4/26/1985,14,0,4,8,26
4/27/1985,9,0,2,2,13
4/28/1985,7,0,16,11,34
4/29/1985,4,0,4,4,12
4/30/1985,8,0,3,16,27
5/1/1985,9,0,11,16,36
5/2/1985,6,0,3,16,25
5/3/1985,5,0,10,10,25
5/4/1985,12,0,8,15,35
5/5/1985,16,0,16,0,32
5/6/1985,10,0,5,1,16
5/7/1985,4,0,14,0,18
5/8/1985,7,0,13,8,28
5/9/1985,10,0,12,0,22
5/10/1985,5,0,4,12,21
5/11/1985,16,0,12,16,44
5/12/1985,12,0,16,9,37
5/13/1985,10,0,16,7,33
5/14/1985,5,0,15,5,25
5/15/1985,16,0,8,7,31
5/16/1985,4,0,9,0,13
5/17/1985,14,0,10,16,40
5/18/1985,4,0,7,12,23
5/19/1985,7,0,9,15,31
5/20/1985,9,0,4,11,24
5/21/1985,10,0,8,5,23
5/22/1985,10,0,7,12,29
5/23/1985,12,0,3,0,15
5/24/1985,9,0,2,6,17
5/25/1985,11,0,8,5,24
5/26/1985,11,0,6,1,18
5/27/1985,7,0,13,0,20
5/28/1985,13,0,15,16,44
5/29/1985,4,0,5,7,16
5/30/1985,8,0,8,2,18
5/31/1985,12,0,6,14,32
6/1/1985,8,0,7,2,17
6/2/1985,8,0,5,3,16
6/3/1985,9,0,5,3,17
6/4/1985,15,0,8,10,33
6/5/1985,11,0,4,11,26
6/6/1985,5,0,16,11,32
6/7/1985,13,0,8,10,31
6/8/1985,8,0,2,11,21
6/9/1985,5,0,14,12,31
6/10/1985,7,0,10,3,20
6/11/1985,13,0,15,5,33
6/12/1985,13,0,6,4,23
6/13/1985,10,0,13,11,34
6/14/1985,9,0,3,6,18
6/15/1985,13,0,16,10,39
6/16/1985,10,0,6,13,29
6/17/1985,10,0,3,1,14
6/18/1985,10,0,5,10,25
6/19/1985,10,0,9,15,34
6/20/1985,8,0,5,11,24
6/21/1985,11,0,10,8,29
6/22/1985,16,0,15,5,36
6/23/1985,6,0,3,13,22
6/24/1985,5,0,9,9,23
6/25/1985,11,0,12,7,30
6/26/1985,4,0,5,12,21
6/27/1985,6,0,6,5,17
6/28/1985,16,0,11,11,38
6/29/1985,16,0,15,2,33
6/30/1985,14,0,5,10,29
7/1/1985,7,0,9,3,19
7/2/1985,9,0,13,13,35
7/3/1985,12,0,2,3,17
7/4/1985,13,0,7,15,35
7/5/1985,13,0,12,0,25
7/6/1985,10,0,5,12,27
7/7/1985,15,0,9,13,37
7/8/1985,10,0,16,9,35
7/9/1985,7,0,11,5,23
7/10/1985,10,0,2,14,26
7/11/1985,16,0,6,2,24
7/12/1985,11,0,6,16,33
7/13/1985,13,0,10,7,30
7/14/1985,14,0,12,12,38
7/15/1985,8,0,7,13,28
7/16/1985,12,0,4,3,19
7/17/1985,14,0,12,15,41
7/18/1985,8,0,16,0,24
7/19/1985,12,0,10,10,32
7/20/1985,15,0,10,6,31
7/21/1985,15,0,8,10,33
7/22/1985,11,0,3,11,25
7/23/1985,12,0,14,15,41
7/24/1985,7,0,7,12,26
7/25/1985,12,0,16,1,29
7/26/1985,7,0,6,14,27
7/27/1985,4,0,4,1,9
7/28/1985,5,0,15,3,23
7/29/1985,11,0,15,8,34
7/30/1985,7,0,10,2,19
7/31/1985,8,0,3,6,17
8/1/1985,9,0,8,12,29
8/2/1985,14,0,12,5,31
8/3/1985,14,0,2,6,22
8/4/1985,12,0,12,8,32
8/5/1985,16,0,11,5,32
8/6/1985,16,0,4,4,24
8/7/1985,14,0,2,0,16
8/8/1985,4,0,4,0,8
8/9/1985,12,0,4,7,23
8/10/1985,7,0,14,9,30
8/11/1985,8,0,5,2,15
8/12/1985,9,0,15,13,37
8/13/1985,12,0,7,15,34
8/14/1985,4,0,16,4,24
8/15/1985,15,0,16,3,34
8/16/1985,5,0,14,0,19
8/17/1985,8,0,7,16,31
8/18/1985,10,0,2,4,16
8/19/1985,15,0,2,16,33
8/20/1985,6,0,16,9,31
8/21/1985,9,0,11,8,28
8/22/1985,6,0,13,12,31
8/23/1985,15,0,11,5,31
8/24/1985,11,0,16,2,29
8/25/1985,10,0,4,7,21
8/26/1985,16,0,14,1,31
8/27/1985,4,0,11,13,28
8/28/1985,8,0,5,3,16
8/29/1985,6,0,5,5,16
8/30/1985,12,0,7,3,22
8/31/1985,10,0,14,12,36
9/1/1985,12,0,6,15,33
9/2/1985,15,0,8,7,30
9/3/1985,8,0,8,14,30
9/4/1985,15,0,6,1,22
9/5/1985,8,0,7,14,29
9/6/1985,15,0,15,9,39
9/7/1985,9,0,7,5,21
9/8/1985,12,0,10,3,25
9/9/1985,15,0,13,13,41
9/10/1985,9,0,15,8,32
9/11/1985,11,0,13,14,38
9/12/1985,14,0,15,0,29
9/13/1985,11,0,8,8,27
9/14/1985,12,0,6,0,18
9/15/1985,13,0,4,1,18
9/16/1985,7,0,4,9,20
9/17/1985,5,0,12,6,23
9/18/1985,8,0,16,8,32
9/19/1985,7,0,3,12,22
9/20/1985,9,0,3,16,28
9/21/1985,14,0,12,11,37
9/22/1985,9,0,8,14,31
9/23/1985,7,0,14,8,29
9/24/1985,16,0,16,7,39
9/25/1985,10,0,2,0,12
9/26/1985,6,0,6,12,24
9/27/1985,16,0,10,8,34
9/28/1985,13,0,6,13,32
9/29/1985,9,0,12,11,32
9/30/1985,13,0,4,14,31
10/1/1985,15,0,16,14,45
10/2/1985,7,0,15,14,36
10/3/1985,6,0,9,6,21
10/4/1985,12,0,13,3,28
10/5/1985,14,0,2,9,25
10/6/1985,16,0,15,11,42
10/7/1985,14,0,13,10,37
10/8/1985,14,0,12,8,34
10/9/1985,15,0,6,8,29
10/10/1985,4,0,10,2,16
10/11/1985,8,0,7,11,26
10/12/1985,6,0,13,15,34
10/13/1985,13,0,12,5,30
10/14/1985,10,0,16,10,36
10/15/1985,13,0,5,12,30
10/16/1985,15,0,10,10,35
10/17/1985,8,0,12,7,27
10/18/1985,13,0,3,5,21
10/19/1985,4,0,15,9,28
10/20/1985,12,0,6,2,20
10/21/1985,5,0,10,7,22
10/22/1985,14,0,12,6,32
10/23/1985,6,0,7,16,29
10/24/1985,10,0,6,2,18
10/25/1985,4,0,9,6,19
10/26/1985,11,0,3,3,17
10/27/1985,10,0,10,1,21
10/28/1985,9,0,11,2,22
10/29/1985,9,0,5,8,22
10/30/1985,10,0,5,7,22
10/31/1985,6,0,6,15,27
11/1/1985,6,0,13,11,30
11/2/1985,9,0,5,11,25
11/3/1985,7,0,6,16,29
11/4/1985,15,0,5,8,28
11/5/1985,16,0,4,5,25
11/6/1985,7,0,7,9,23
11/7/1985,4,0,4,12,20
11/8/1985,5,0,5,4,14
11/9/1985,16,0,2,12,30
11/10/1985,16,0,15,4,35
11/11/1985,4,0,4,12,20
11/12/1985,10,0,13,12,35
11/13/1985,13,0,9,7,29
11/14/1985,11,0,4,8,23
11/15/1985,13,0,15,15,43
11/16/1985,13,0,2,3,18
11/17/1985,4,0,11,5,20
11/18/1985,5,0,15,0,20
11/19/1985,15,0,6,6,27
11/20/1985,13,0,8,2,23
11/21/1985,11,0,10,14,35
11/22/1985,5,0,15,6,26
11/23/1985,7,0,4,13,24
11/24/1985,10,0,11,4,25
11/25/1985,10,0,11,16,37
11/26/1985,12,0,13,0,25
11/27/1985,5,0,6,11,22
11/28/1985,12,0,6,13,31
11/29/1985,10,0,15,6,31
11/30/1985,16,0,8,1,25
12/1/1985,15,0,7,15,37
12/2/1985,12,0,12,7,31
12/3/1985,13,0,8,7,28
12/4/1985,14,0,13,11,38
12/5/1985,6,0,16,5,27
12/6/1985,4,0,10,5,19
12/7/1985,10,0,9,6,25
12/8/1985,11,0,6,5,22
12/9/1985,7,0,9,10,26
12/10/1985,5,0,7,8,20
12/11/1985,8,0,14,6,28
12/12/1985,13,0,9,6,28
12/13/1985,4,0,14,5,23
12/14/1985,13,0,5,8,26
12/15/1985,7,0,5,0,12
12/16/1985,6,0,14,7,27
12/17/1985,4,0,7,7,18
12/18/1985,6,0,15,8,29
12/19/1985,14,0,14,9,37
12/20/1985,12,0,14,11,37
12/21/1985,16,0,2,3,21
12/22/1985,12,0,5,4,21
12/23/1985,11,0,6,5,22
12/24/1985,7,0,13,1,21
12/25/1985,10,0,6,1,17
12/26/1985,14,0,3,10,27
12/27/1985,15,0,8,1,24
12/28/1985,11,0,5,4,20
12/29/1985,15,0,6,12,33
12/30/1985,15,0,10,6,31
12/31/1985,10,0,12,11,33
1/1/1986,11,0,15,5,31
1/2/1986,6,0,2,15,23
1/3/1986,8,0,16,7,31
1/4/1986,4,0,3,14,21
1/5/1986,5,0,14,11,30
1/6/1986,8,0,10,1,19
1/7/1986,6,0,8,6,20
1/8/1986,16,0,9,12,37
1/9/1986,6,0,9,13,28
1/10/1986,8,0,11,2,21
1/11/1986,14,0,5,6,25
1/12/1986,8,0,10,7,25
1/13/1986,16,0,12,5,33
1/14/1986,12,0,12,2,26
1/15/1986,12,0,2,12,26
1/16/1986,11,0,11,7,29
1/17/1986,8,0,6,5,19
1/18/1986,11,0,3,1,15
1/19/1986,7,0,10,6,23
1/20/1986,12,0,9,0,21
1/21/1986,9,0,10,10,29
1/22/1986,12,0,9,15,36
1/23/1986,4,0,4,12,20
1/24/1986,15,0,10,4,29
1/25/1986,13,0,16,7,36
1/26/1986,6,0,14,11,31
1/27/1986,16,0,10,7,33
1/28/1986,8,0,16,0,24
1/29/1986,9,0,5,14,28
1/30/1986,4,0,4,13,21
1/31/1986,12,0,11,5,28
2/1/1986,15,0,6,3,24
2/2/1986,9,0,4,6,19
2/3/1986,7,0,11,2,20
2/4/1986,6,0,9,2,17
2/5/1986,7,0,3,12,22
2/6/1986,7,0,2,6,15
2/7/1986,7,0,5,2,14
2/8/1986,5,0,14,4,23
2/9/1986,4,0,4,15,23
2/10/1986,5,0,4,6,15
2/11/1986,11,0,13,1,25
2/12/1986,7,0,16,7,30
2/13/1986,10,0,13,11,34
2/14/1986,7,0,15,10,32
2/15/1986,13,0,2,6,21
2/16/1986,4,0,11,1,16
2/17/1986,4,0,12,9,25
2/18/1986,15,0,15,10,40
2/19/1986,12,0,5,15,32
2/20/1986,9,0,15,13,37
2/21/1986,11,0,8,6,25
2/22/1986,12,0,12,10,34
2/23/1986,15,0,4,1,20
2/24/1986,11,0,15,8,34
2/25/1986,9,0,2,14,25
2/26/1986,12,0,14,15,41
2/27/1986,12,0,10,8,30
2/28/1986,11,0,15,10,36
3/1/1986,15,0,8,8,31
3/2/1986,7,0,3,6,16
3/3/1986,12,0,11,3,26
3/4/1986,7,0,3,14,24
3/5/1986,7,0,10,6,23
3/6/1986,8,0,7,13,28
3/7/1986,15,0,9,13,37
3/8/1986,10,0,12,2,24
3/9/1986,12,0,7,8,27
3/10/1986,16,0,12,3,31
3/11/1986,10,0,15,3,28
3/12/1986,9,0,16,0,25
3/13/1986,6,0,4,15,25
3/14/1986,4,0,11,4,19
3/15/1986,15,0,4,15,34
3/16/1986,12,0,3,11,26
3/17/1986,6,0,5,0,11
3/18/1986,13,0,6,10,29
3/19/1986,14,0,5,14,33
3/20/1986,16,0,10,6,32
3/21/1986,8,0,16,15,39
3/22/1986,7,0,15,0,22
3/23/1986,15,0,10,14,39
3/24/1986,6,0,8,15,29
3/25/1986,4,0,12,8,24
3/26/1986,12,0,12,7,31
3/27/1986,9,0,12,7,28
3/28/1986,8,0,9,12,29
3/29/1986,15,0,15,7,37
3/30/1986,4,0,5,15,24
3/31/1986,16,0,10,3,29
4/1/1986,14,0,10,7,31
4/2/1986,14,0,15,10,39
4/3/1986,10,0,3,12,25
4/4/1986,8,0,6,7,21
4/5/1986,10,0,9,2,21
4/6/1986,15,0,7,9,31
4/7/1986,9,0,13,5,27
4/8/1986,13,0,8,5,26
4/9/1986,14,0,6,12,32
4/10/1986,9,0,8,9,26
4/11/1986,5,0,15,3,23
4/12/1986,16,0,2,12,30
4/13/1986,11,0,16,11,38
4/14/1986,14,0,12,5,31
4/15/1986,10,0,13,8,31
4/16/1986,14,0,6,5,25
4/17/1986,8,0,15,1,24
4/18/1986,10,0,11,4,25
4/19/1986,6,0,3,1,10
4/20/1986,7,0,15,6,28
4/21/1986,9,0,13,3,25
4/22/1986,12,0,13,10,35
4/23/1986,10,0,16,6,32
4/24/1986,7,0,6,14,27
4/25/1986,6,0,5,12,23
4/26/1986,4,0,9,16,29
4/27/1986,8,0,12,7,27
4/28/1986,6,0,4,9,19
4/29/1986,14,0,5,15,34
4/30/1986,7,0,3,11,21
5/1/1986,10,0,9,5,24
5/2/1986,6,0,12,7,25
5/3/1986,6,0,2,14,22
5/4/1986,8,0,12,6,26
5/5/1986,8,0,6,3,17
5/6/1986,10,0,13,1,24
5/7/1986,14,0,13,12,39
5/8/1986,14,0,5,15,34
5/9/1986,7,0,3,4,14
5/10/1986,15,0,7,3,25
5/11/1986,9,0,11,16,36
5/12/1986,15,0,8,7,30
5/13/1986,8,0,11,5,24
5/14/1986,5,0,16,15,36
5/15/1986,8,0,3,0,11
5/16/1986,8,0,16,4,28
5/17/1986,12,0,2,4,18
5/18/1986,9,0,4,2,15
5/19/1986,6,0,10,12,28
5/20/1986,13,0,6,5,24
5/21/1986,13,0,16,3,32
5/22/1986,10,0,10,9,29
5/23/1986,9,0,13,6,28
5/24/1986,14,0,14,13,41
5/25/1986,7,0,3,16,26
5/26/1986,10,0,9,2,21
5/27/1986,11,0,16,16,43
5/28/1986,15,0,14,5,34
5/29/1986,7,0,2,4,13
5/30/1986,7,0,13,7,27
5/31/1986,4,0,4,13,21
6/1/1986,15,0,11,1,27
6/2/1986,9,0,3,5,17
6/3/1986,14,0,6,15,35
6/4/1986,5,0,5,5,15
6/5/1986,5,0,11,3,19
6/6/1986,16,0,9,3,28
6/7/1986,13,0,6,4,23
6/8/1986,4,0,5,0,9
6/9/1986,11,0,8,5,24
6/10/1986,9,0,9,0,18
6/11/1986,4,0,11,1,16
6/12/1986,5,0,15,9,29
6/13/1986,7,0,2,4,13
6/14/1986,16,0,5,6,27
6/15/1986,7,0,11,1,19
6/16/1986,13,0,10,3,26
6/17/1986,9,0,2,9,20
6/18/1986,11,0,12,9,32
6/19/1986,15,0,4,1,20
6/20/1986,10,0,5,13,28
6/21/1986,5,0,11,16,32
6/22/1986,5,0,11,11,27
6/23/1986,4,0,15,1,20
6/24/1986,8,0,15,15,38
6/25/1986,15,0,12,2,29
6/26/1986,5,0,2,12,19
6/27/1986,15,0,14,10,39
6/28/1986,11,0,9,15,35
6/29/1986,13,0,12,15,40
6/30/1986,6,0,6,8,20
7/1/1986,7,0,3,8,18
7/2/1986,15,0,16,5,36
7/3/1986,12,0,14,12,38
7/4/1986,8,0,4,15,27
7/5/1986,5,0,9,6,20
7/6/1986,12,0,8,3,23
7/7/1986,8,0,3,3,14
7/8/1986,13,0,5,1,19
7/9/1986,15,0,16,6,37
7/10/1986,10,0,8,15,33
7/11/1986,13,0,13,0,26
7/12/1986,16,0,12,3,31
7/13/1986,11,0,13,11,35
7/14/1986,4,0,13,12,29
7/15/1986,7,0,15,1,23
7/16/1986,6,0,11,12,29
7/17/1986,13,0,3,13,29
7/18/1986,7,0,13,5,25
7/19/1986,9,0,12,8,29
7/20/1986,16,0,14,10,40
7/21/1986,11,0,4,12,27
7/22/1986,6,0,16,0,22
7/23/1986,14,0,5,16,35
7/24/1986,4,0,7,11,22
7/25/1986,8,0,4,13,25
7/26/1986,11,0,3,14,28
7/27/1986,10,0,12,0,22
7/28/1986,7,0,13,14,34
7/29/1986,10,0,2,6,18
7/30/1986,15,0,5,3,23
7/31/1986,14,0,14,2,30
8/1/1986,9,0,13,15,37
8/2/1986,10,0,3,13,26
8/3/1986,11,0,5,15,31
8/4/1986,13,0,14,12,39
8/5/1986,6,0,7,8,21
8/6/1986,16,0,13,11,40
8/7/1986,12,0,9,10,31
8/8/1986,6,0,14,11,31
8/9/1986,16,0,9,13,38
8/10/1986,10,0,2,5,17
8/11/1986,14,0,9,12,35
8/12/1986,15,0,10,1,26
8/13/1986,7,0,4,4,15
8/14/1986,5,0,3,2,10
8/15/1986,14,0,11,10,35
8/16/1986,12,0,9,4,25
8/17/1986,14,0,9,11,34
8/18/1986,12,0,14,4,30
8/19/1986,10,0,7,0,17
8/20/1986,15,0,4,13,32
8/21/1986,14,0,14,13,41
8/22/1986,14,0,14,8,36
8/23/1986,9,0,3,15,27
8/24/1986,6,0,16,4,26
8/25/1986,8,0,5,5,18
8/26/1986,6,0,7,3,16
8/27/1986,8,0,15,6,29
8/28/1986,16,0,6,4,26
8/29/1986,13,0,10,3,26
8/30/1986,9,0,12,13,34
8/31/1986,5,0,8,15,28
9/1/1986,13,0,12,10,35
9/2/1986,4,0,15,8,27
9/3/1986,11,0,4,9,24
9/4/1986,6,0,11,11,28
9/5/1986,15,0,9,2,26
9/6/1986,16,0,15,14,45
9/7/1986,9,0,12,8,29
9/8/1986,7,0,10,0,17
9/9/1986,10,0,16,4,30
9/10/1986,8,0,16,15,39
9/11/1986,10,0,16,10,36
9/12/1986,15,0,15,0,30
9/13/1986,16,0,7,15,38
9/14/1986,7,0,6,3,16
9/15/1986,7,0,16,12,35
9/16/1986,16,0,5,1,22
9/17/1986,4,0,10,16,30
9/18/1986,9,0,9,16,34
9/19/1986,5,0,14,12,31
9/20/1986,11,0,16,0,27
9/21/1986,13,0,8,1,22
9/22/1986,8,0,10,2,20
9/23/1986,4,0,3,12,19
9/24/1986,13,0,11,13,37
9/25/1986,6,0,15,5,26
9/26/1986,12,0,2,3,17
9/27/1986,4,0,7,16,27
9/28/1986,12,0,9,7,28
9/29/1986,7,0,16,2,25
9/30/1986,5,0,16,13,34
10/1/1986,12,0,2,4,18
10/2/1986,6,0,9,7,22
10/3/1986,10,0,13,7,30
10/4/1986,12,0,6,5,23
10/5/1986,6,0,7,9,22
10/6/1986,10,0,13,9,32
10/7/1986,4,0,9,5,18
10/8/1986,11,0,9,14,34
10/9/1986,15,0,13,5,33
10/10/1986,5,0,15,4,24
10/11/1986,7,0,13,4,24
10/12/1986,12,0,5,0,17
10/13/1986,15,0,4,12,31
10/14/1986,5,0,4,0,9
10/15/1986,8,0,12,14,34
10/16/1986,15,0,16,2,33
10/17/1986,4,0,4,8,16
10/18/1986,15,0,16,9,40
10/19/1986,6,0,9,11,26
10/20/1986,6,0,15,11,32
10/21/1986,16,0,16,0,32
10/22/1986,8,0,12,13,33
10/23/1986,10,0,11,6,27
10/24/1986,7,0,5,16,28
10/25/1986,15,0,3,4,22
10/26/1986,7,0,14,9,30
10/27/1986,5,0,3,8,16
10/28/1986,7,0,14,12,33
10/29/1986,6,0,10,3,19
10/30/1986,7,0,9,9,25
10/31/1986,7,0,11,12,30
11/1/1986,16,0,16,5,37
11/2/1986,9,0,15,1,25
11/3/1986,13,0,15,9,37
11/4/1986,16,0,13,10,39
11/5/1986,16,0,12,9,37
11/6/1986,13,0,6,3,22
11/7/1986,13,0,2,6,21
11/8/1986,10,0,16,14,40
11/9/1986,5,0,6,13,24
11/10/1986,8,0,8,11,27
11/11/1986,13,0,7,4,24
11/12/1986,4,0,6,3,13
11/13/1986,4,0,7,14,25
11/14/1986,6,0,11,13,30
11/15/1986,6,0,14,11,31
11/16/1986,6,0,9,15,30
11/17/1986,12,0,7,16,35
11/18/1986,9,0,11,1,21
11/19/1986,13,0,7,11,31
11/20/1986,7,0,3,8,18
11/21/1986,10,0,14,16,40
11/22/1986,9,0,5,0,14
11/23/1986,13,0,16,11,40
11/24/1986,7,0,5,14,26
11/25/1986,6,0,11,6,23
11/26/1986,15,0,12,11,38
11/27/1986,16,0,14,3,33
11/28/1986,6,0,12,15,33
11/29/1986,4,0,16,1,21
11/30/1986,9,0,13,8,30
12/1/1986,11,0,15,16,42
12/2/1986,10,0,2,9,21
12/3/1986,5,0,8,12,25
12/4/1986,13,0,9,15,37
12/5/1986,15,0,14,8,37
12/6/1986,8,0,5,13,26
12/7/1986,11,0,15,13,39
12/8/1986,16,0,12,5,33
12/9/1986,9,0,7,14,30
12/10/1986,7,0,13,7,27
12/11/1986,13,0,12,7,32
12/12/1986,4,0,6,0,10
12/13/1986,4,0,5,2,11
12/14/1986,15,0,11,3,29
12/15/1986,5,0,15,11,31
12/16/1986,6,0,8,6,20
12/17/1986,10,0,14,15,39
12/18/1986,5,0,8,4,17
12/19/1986,7,0,3,4,14
12/20/1986,4,0,9,0,13
12/21/1986,8,0,15,6,29
12/22/1986,4,0,9,11,24
12/23/1986,13,0,3,8,24
12/24/1986,10,0,13,0,23
12/25/1986,6,0,11,4,21
12/26/1986,13,0,12,4,29
12/27/1986,8,0,5,3,16
12/28/1986,6,0,8,1,15
12/29/1986,9,0,12,14,35
12/30/1986,8,0,9,11,28
12/31/1986,5,0,2,3,10
1/1/1987,11,0,5,14,30
1/2/1987,7,0,7,11,25
1/3/1987,11,0,15,15,41
1/4/1987,14,0,4,16,34
1/5/1987,12,0,6,12,30
1/6/1987,9,0,12,16,37
1/7/1987,15,0,9,14,38
1/8/1987,9,0,4,2,15
1/9/1987,16,0,12,11,39
1/10/1987,8,0,11,12,31
1/11/1987,6,0,16,2,24
1/12/1987,15,0,13,5,33
1/13/1987,9,0,14,0,23
1/14/1987,14,0,11,3,28
1/15/1987,8,0,5,11,24
1/16/1987,8,0,3,15,26
1/17/1987,11,0,2,7,20
1/18/1987,12,0,11,2,25
1/19/1987,9,0,16,4,29
1/20/1987,8,0,5,13,26
1/21/1987,6,0,5,12,23
1/22/1987,10,0,4,12,26
1/23/1987,7,0,6,2,15
1/24/1987,8,0,7,5,20
1/25/1987,16,0,3,6,25
1/26/1987,9,0,7,7,23
1/27/1987,10,0,13,0,23
1/28/1987,8,0,7,5,20
1/29/1987,7,0,14,9,30
1/30/1987,8,0,2,3,13
1/31/1987,12,0,6,3,21
2/1/1987,10,0,12,15,37
2/2/1987,5,0,9,15,29
2/3/1987,16,0,5,1,22
2/4/1987,9,0,15,4,28
2/5/1987,10,0,5,3,18
2/6/1987,12,0,14,7,33
2/7/1987,5,0,7,14,26
2/8/1987,10,0,10,6,26
2/9/1987,15,0,5,12,32
2/10/1987,14,0,6,4,24
2/11/1987,13,0,7,5,25
2/12/1987,9,0,15,9,33
2/13/1987,10,0,10,14,34
2/14/1987,8,0,12,2,22
2/15/1987,5,0,15,4,24
2/16/1987,15,0,14,8,37
2/17/1987,6,0,10,11,27
2/18/1987,10,0,5,10,25
2/19/1987,8,0,3,9,20
2/20/1987,10,0,5,6,21
2/21/1987,8,0,3,13,24
2/22/1987,4,0,13,5,22
2/23/1987,13,0,12,8,33
2/24/1987,10,0,4,0,14
2/25/1987,13,0,13,15,41
2/26/1987,10,0,8,0,18
2/27/1987,5,0,12,8,25
2/28/1987,15,0,7,11,33
3/1/1987,14,0,13,12,39
3/2/1987,4,0,9,7,20
3/3/1987,11,0,13,13,37
3/4/1987,9,0,11,11,31
3/5/1987,6,0,4,15,25
3/6/1987,14,0,7,15,36
3/7/1987,13,0,9,14,36
3/8/1987,7,0,7,12,26
3/9/1987,8,0,16,5,29
3/10/1987,10,0,8,3,21
3/11/1987,10,0,4,10,24
3/12/1987,11,0,2,14,27
3/13/1987,11,0,16,0,27
3/14/1987,11,0,12,1,24
3/15/1987,5,0,7,12,24
3/16/1987,14,0,7,14,35
3/17/1987,13,0,10,9,32
3/18/1987,4,0,16,8,28
3/19/1987,16,0,3,6,25
3/20/1987,10,0,9,7,26
3/21/1987,10,0,15,15,40
3/22/1987,14,0,2,12,28
3/23/1987,8,0,3,13,24
3/24/1987,9,0,15,2,26
3/25/1987,13,0,2,2,17
3/26/1987,16,0,13,8,37
3/27/1987,13,0,13,5,31
3/28/1987,7,0,11,3,21
3/29/1987,12,0,8,7,27
3/30/1987,4,0,3,16,23
3/31/1987,6,0,6,9,21
4/1/1987,9,0,10,13,32
4/2/1987,12,0,2,1,15
4/3/1987,8,0,15,14,37
4/4/1987,6,0,3,13,22
4/5/1987,7,0,2,5,14
4/6/1987,11,0,10,0,21
4/7/1987,9,0,4,6,19
4/8/1987,9,0,2,1,12
4/9/1987,15,0,10,14,39
4/10/1987,13,0,15,14,42
4/11/1987,4,0,13,4,21
4/12/1987,6,0,13,15,34
4/13/1987,15,0,5,2,22
4/14/1987,7,0,15,4,26
4/15/1987,16,0,3,16,35
4/16/1987,6,0,6,11,23
4/17/1987,11,0,10,3,24
4/18/1987,16,0,14,2,32
4/19/1987,13,0,4,7,24
4/20/1987,7,0,4,5,16
4/21/1987,4,0,2,16,22
4/22/1987,16,0,13,0,29
4/23/1987,16,0,7,5,28
4/24/1987,10,0,6,5,21
4/25/1987,11,0,6,4,21
4/26/1987,8,0,6,5,19
4/27/1987,8,0,6,12,26
4/28/1987,7,0,4,16,27
4/29/1987,10,0,13,13,36
4/30/1987,9,0,7,9,25
5/1/1987,9,0,2,1,12
5/2/1987,4,0,5,10,19
5/3/1987,6,0,6,7,19
5/4/1987,11,0,8,13,32
5/5/1987,15,0,13,15,43
5/6/1987,4,0,3,7,14
5/7/1987,12,0,11,10,33
5/8/1987,16,0,6,1,23
5/9/1987,12,0,12,1,25
5/10/1987,12,0,6,16,34
5/11/1987,16,0,12,0,28
5/12/1987,15,0,8,16,39
5/13/1987,4,0,11,1,16
5/14/1987,15,0,7,15,37
5/15/1987,16,0,8,13,37
5/16/1987,6,0,14,4,24
5/17/1987,6,0,16,3,25
5/18/1987,8,0,9,10,27
5/19/1987,10,0,7,2,19
5/20/1987,12,0,5,16,33
5/21/1987,5,0,13,0,18
5/22/1987,8,0,4,9,21
5/23/1987,7,0,6,2,15
5/24/1987,11,0,2,6,19
5/25/1987,4,0,7,3,14
5/26/1987,11,0,16,15,42
5/27/1987,16,0,4,9,29
5/28/1987,4,0,3,13,20
5/29/1987,8,0,8,3,19
5/30/1987,11,0,5,10,26
5/31/1987,10,0,10,12,32
6/1/1987,11,0,10,6,27
6/2/1987,5,0,8,2,15
6/3/1987,7,0,13,9,29
6/4/1987,8,0,12,11,31
6/5/1987,6,0,12,3,21
6/6/1987,5,0,13,0,18
6/7/1987,8,0,4,3,15
6/8/1987,10,0,2,13,25
6/9/1987,14,0,13,5,32
6/10/1987,4,0,2,6,12
6/11/1987,13,0,11,9,33
6/12/1987,10,0,13,10,33
6/13/1987,7,0,3,15,25
6/14/1987,10,0,15,5,30
6/15/1987,4,0,16,11,31
6/16/1987,15,0,3,0,18
6/17/1987,8,0,2,9,19
6/18/1987,5,0,4,9,18
6/19/1987,15,0,2,10,27
6/20/1987,10,0,8,2,20
6/21/1987,12,0,3,13,28
6/22/1987,7,0,11,11,29
6/23/1987,10,0,14,16,40
6/24/1987,7,0,13,8,28
6/25/1987,10,0,7,8,25
6/26/1987,16,0,10,11,37
6/27/1987,16,0,6,8,30
6/28/1987,4,0,14,6,24
6/29/1987,11,0,8,9,28
6/30/1987,8,0,2,4,14
7/1/1987,12,0,16,0,28
7/2/1987,5,0,7,11,23
7/3/1987,7,0,14,5,26
7/4/1987,10,0,12,16,38
7/5/1987,5,0,15,4,24
7/6/1987,14,0,3,10,27
7/7/1987,14,0,10,3,27
7/8/1987,15,0,5,7,27
7/9/1987,16,0,10,14,40
7/10/1987,5,0,12,4,21
7/11/1987,7,0,9,2,18
7/12/1987,14,0,16,11,41
7/13/1987,13,0,6,13,32
7/14/1987,15,0,7,3,25
7/15/1987,9,0,4,11,24
7/16/1987,13,0,9,12,34
7/17/1987,16,0,5,2,23
7/18/1987,6,0,10,13,29
7/19/1987,9,0,12,3,24
7/20/1987,11,0,9,0,20
7/21/1987,14,0,9,12,35
7/22/1987,13,0,8,4,25
7/23/1987,11,0,5,9,25
7/24/1987,11,0,10,3,24
7/25/1987,11,0,8,1,20
7/26/1987,16,0,8,15,39
7/27/1987,14,0,9,14,37
7/28/1987,5,0,16,8,29
7/29/1987,9,0,9,8,26
7/30/1987,12,0,7,7,26
7/31/1987,8,0,3,10,21
8/1/1987,6,0,5,4,15
8/2/1987,5,0,4,11,20
8/3/1987,15,0,3,13,31
8/4/1987,16,0,8,3,27
8/5/1987,11,0,10,13,34
8/6/1987,5,0,16,3,24
8/7/1987,12,0,8,0,20
8/8/1987,7,0,3,12,22
8/9/1987,10,0,7,12,29
8/10/1987,11,0,11,0,22
8/11/1987,14,0,14,2,30
8/12/1987,16,0,5,10,31
8/13/1987,12,0,11,5,28
8/14/1987,16,0,3,11,30
8/15/1987,13,0,12,10,35
8/16/1987,8,0,6,0,14
8/17/1987,12,0,14,7,33
8/18/1987,11,0,16,2,29
8/19/1987,6,0,15,0,21
8/20/1987,13,0,16,16,45
8/21/1987,10,0,5,8,23
8/22/1987,12,0,11,8,31
8/23/1987,6,0,6,6,18
8/24/1987,16,0,16,13,45
8/25/1987,8,0,14,16,38
8/26/1987,10,0,12,10,32
8/27/1987,14,0,15,10,39
8/28/1987,14,0,10,6,30
8/29/1987,9,0,9,10,28
8/30/1987,13,0,10,12,35
8/31/1987,6,0,15,13,34
9/1/1987,7,0,6,11,24
9/2/1987,10,0,3,4,17
9/3/1987,7,0,11,10,28
9/4/1987,13,0,13,16,42
9/5/1987,9,0,12,7,28
9/6/1987,11,0,2,13,26
9/7/1987,9,0,14,3,26
9/8/1987,9,0,4,9,22
9/9/1987,5,0,3,10,18
9/10/1987,5,0,10,2,17
9/11/1987,7,0,4,14,25
9/12/1987,7,0,6,9,22
9/13/1987,8,0,7,13,28
9/14/1987,6,0,2,3,11
9/15/1987,15,0,7,7,29
9/16/1987,16,0,7,13,36
9/17/1987,6,0,4,2,12
9/18/1987,10,0,14,12,36
9/19/1987,11,0,10,11,32
9/20/1987,12,0,8,10,30
9/21/1987,7,0,14,13,34
9/22/1987,16,0,9,8,33
9/23/1987,9,0,16,7,32
9/24/1987,15,0,2,15,32
9/25/1987,7,0,13,3,23
9/26/1987,5,0,5,13,23
9/27/1987,4,0,2,15,21
9/28/1987,13,0,14,12,39
9/29/1987,15,0,8,16,39
9/30/1987,11,0,11,3,25
10/1/1987,16,0,7,7,30
10/2/1987,10,0,10,4,24
10/3/1987,14,0,13,7,34
10/4/1987,4,0,11,15,30
10/5/1987,11,0,10,15,36
10/6/1987,15,0,11,16,42
10/7/1987,16,0,13,4,33
10/8/1987,7,0,14,2,23
10/9/1987,11,0,7,15,33
10/10/1987,11,0,9,14,34
10/11/1987,15,0,14,3,32
10/12/1987,7,0,14,11,32
10/13/1987,9,0,7,13,29
10/14/1987,7,0,6,8,21
10/15/1987,7,0,9,15,31
10/16/1987,14,0,10,9,33
10/17/1987,5,0,11,8,24
10/18/1987,8,0,16,7,31
10/19/1987,7,0,8,16,31
10/20/1987,14,0,4,5,23
10/21/1987,16,0,16,0,32
10/22/1987,13,0,4,9,26
10/23/1987,14,0,8,9,31
10/24/1987,15,0,2,7,24
10/25/1987,15,0,2,12,29
10/26/1987,16,0,13,4,33
10/27/1987,9,0,12,1,22
10/28/1987,9,0,7,12,28
10/29/1987,11,0,13,0,24
10/30/1987,4,0,9,16,29
10/31/1987,10,0,2,5,17
11/1/1987,9,0,13,1,23
11/2/1987,5,0,6,12,23
11/3/1987,5,0,14,4,23
11/4/1987,14,0,13,11,38
11/5/1987,11,0,12,16,39
11/6/1987,13,0,2,7,22
11/7/1987,7,0,5,14,26
11/8/1987,11,0,6,15,32
11/9/1987,16,0,7,4,27
11/10/1987,9,0,4,12,25
11/11/1987,14,0,16,5,35
11/12/1987,5,0,2,15,22
11/13/1987,5,0,15,5,25
11/14/1987,12,0,5,15,32
11/15/1987,16,0,9,9,34
11/16/1987,15,0,14,11,40
11/17/1987,10,0,3,10,23
11/18/1987,9,0,7,4,20
11/19/1987,16,0,6,10,32
11/20/1987,7,0,4,7,18
11/21/1987,12,0,11,0,23
11/22/1987,10,0,11,11,32
11/23/1987,16,0,16,12,44
11/24/1987,9,0,3,1,13
11/25/1987,13,0,11,9,33
11/26/1987,14,0,8,3,25
11/27/1987,9,0,5,1,15
11/28/1987,14,0,13,8,35
11/29/1987,11,0,12,7,30
11/30/1987,8,0,12,8,28
12/1/1987,15,0,16,1,32
12/2/1987,10,0,3,14,27
12/3/1987,5,0,11,9,25
12/4/1987,11,0,3,6,20
12/5/1987,9,0,16,1,26
12/6/1987,9,0,16,8,33
12/7/1987,9,0,14,14,37
12/8/1987,13,0,11,10,34
12/9/1987,7,0,10,5,22
12/10/1987,8,0,3,3,14
12/11/1987,7,0,4,1,12
12/12/1987,8,0,4,9,21
12/13/1987,15,0,11,6,32
12/14/1987,13,0,2,16,31
12/15/1987,5,0,16,2,23
12/16/1987,16,0,11,8,35
12/17/1987,4,0,16,12,32
12/18/1987,14,0,2,4,20
12/19/1987,16,0,8,15,39
12/20/1987,12,0,6,7,25
12/21/1987,12,0,15,11,38
12/22/1987,10,0,16,9,35
12/23/1987,14,0,5,15,34
12/24/1987,10,0,14,0,24
12/25/1987,5,0,16,13,34
12/26/1987,12,0,11,5,28
12/27/1987,11,0,11,3,25
12/28/1987,8,0,3,9,20
12/29/1987,12,0,4,12,28
12/30/1987,8,0,8,7,23
12/31/1987,4,0,15,11,30
1/1/1988,14,0,15,6,35
1/2/1988,6,0,6,4,16
1/3/1988,8,0,11,1,20
1/4/1988,14,0,9,15,38
1/5/1988,12,0,5,5,22
1/6/1988,14,0,6,10,30
1/7/1988,12,0,6,9,27
1/8/1988,5,0,8,5,18
1/9/1988,4,0,10,14,28
1/10/1988,14,0,2,13,29
1/11/1988,12,0,7,7,26
1/12/1988,7,0,3,14,24
1/13/1988,10,0,15,9,34
1/14/1988,5,0,5,10,20
1/15/1988,13,0,8,2,23
1/16/1988,4,0,14,1,19
1/17/1988,11,0,10,0,21
1/18/1988,6,0,5,13,24
1/19/1988,10,0,4,10,24
1/20/1988,6,0,13,0,19
1/21/1988,11,0,16,1,28
1/22/1988,9,0,16,8,33
1/23/1988,8,0,4,10,22
1/24/1988,16,0,6,1,23
1/25/1988,9,0,11,8,28
1/26/1988,7,0,3,5,15
1/27/1988,13,0,2,1,16
1/28/1988,6,0,7,3,16
1/29/1988,12,0,15,13,40
1/30/1988,13,0,16,14,43
1/31/1988,15,0,15,3,33
2/1/1988,16,0,9,13,38
2/2/1988,11,0,7,1,19
2/3/1988,4,0,10,8,22
2/4/1988,6,0,7,9,22
2/5/1988,6,0,2,11,19
2/6/1988,12,0,14,11,37
2/7/1988,15,0,9,10,34
2/8/1988,11,0,13,13,37
2/9/1988,6,0,3,13,22
2/10/1988,12,0,8,4,24
2/11/1988,14,0,14,7,35
2/12/1988,6,0,11,8,25
2/13/1988,8,0,10,6,24
2/14/1988,9,0,5,14,28
2/15/1988,8,0,9,2,19
2/16/1988,5,0,4,16,25
2/17/1988,15,0,10,2,27
2/18/1988,7,0,8,14,29
2/19/1988,11,0,13,2,26
2/20/1988,14,0,15,14,43
2/21/1988,13,0,6,16,35
2/22/1988,10,0,8,1,19
2/23/1988,6,0,5,3,14
2/24/1988,11,0,15,12,38
2/25/1988,9,0,6,10,25
2/26/1988,7,0,16,2,25
2/27/1988,15,0,14,16,45
2/28/1988,8,0,12,1,21
2/29/1988,4,0,3,16,23
3/1/1988,8,0,8,3,19
3/2/1988,9,0,4,1,14
3/3/1988,9,0,6,5,20
3/4/1988,5,0,11,8,24
3/5/1988,7,0,5,11,23
3/6/1988,4,0,10,15,29
3/7/1988,7,0,11,12,30
3/8/1988,13,0,7,12,32
3/9/1988,11,0,15,0,26
3/10/1988,14,0,16,9,39
3/11/1988,12,0,12,1,25
3/12/1988,6,0,14,7,27
3/13/1988,16,0,6,16,38
3/14/1988,15,0,5,10,30
3/15/1988,12,0,5,15,32
3/16/1988,14,0,16,1,31
3/17/1988,7,0,15,7,29
3/18/1988,14,0,14,3,31
3/19/1988,6,0,8,12,26
3/20/1988,7,0,4,7,18
3/21/1988,4,0,11,0,15
3/22/1988,6,0,3,11,20
3/23/1988,16,0,15,7,38
3/24/1988,6,0,11,4,21
3/25/1988,16,0,15,1,32
3/26/1988,11,0,3,0,14
3/27/1988,11,0,6,2,19
3/28/1988,13,0,16,16,45
3/29/1988,6,0,6,0,12
3/30/1988,16,0,15,11,42
3/31/1988,5,0,10,9,24
4/1/1988,9,0,10,16,35
4/2/1988,12,0,15,15,42
4/3/1988,14,0,9,10,33
4/4/1988,8,0,6,16,30
4/5/1988,4,0,11,7,22
4/6/1988,7,0,11,3,21
4/7/1988,5,0,3,3,11
4/8/1988,8,0,6,5,19
4/9/1988,13,0,13,7,33
4/10/1988,14,0,6,15,35
4/11/1988,4,0,2,11,17
4/12/1988,10,0,3,14,27
4/13/1988,13,0,16,8,37
4/14/1988,9,0,11,2,22
4/15/1988,12,0,7,11,30
4/16/1988,12,0,14,14,40
4/17/1988,4,0,15,13,32
4/18/1988,11,0,6,9,26
4/19/1988,13,0,16,13,42
4/20/1988,12,0,11,16,39
4/21/1988,10,0,11,8,29
4/22/1988,10,0,2,11,23
4/23/1988,9,0,8,12,29
4/24/1988,6,0,15,6,27
4/25/1988,7,0,4,8,19
4/26/1988,16,0,9,15,40
4/27/1988,9,0,13,2,24
4/28/1988,14,0,5,5,24
4/29/1988,15,0,5,5,25
4/30/1988,15,0,4,1,20
5/1/1988,10,0,2,0,12
5/2/1988,9,0,3,0,12
5/3/1988,10,0,15,12,37
5/4/1988,13,0,8,5,26
5/5/1988,16,0,5,6,27
5/6/1988,13,0,7,9,29
5/7/1988,13,0,12,4,29
5/8/1988,4,0,8,5,17
5/9/1988,16,0,12,6,34
5/10/1988,13,0,4,4,21
5/11/1988,8,0,11,16,35
5/12/1988,7,0,15,9,31
5/13/1988,6,0,13,11,30
5/14/1988,9,0,3,7,19
5/15/1988,11,0,6,8,25
5/16/1988,13,0,3,12,28
5/17/1988,6,0,9,9,24
5/18/1988,8,0,14,13,35
5/19/1988,6,0,9,9,24
5/20/1988,15,0,4,9,28
5/21/1988,9,0,10,2,21
5/22/1988,11,0,14,13,38
5/23/1988,15,0,15,1,31
5/24/1988,4,0,7,0,11
5/25/1988,6,0,8,3,17
5/26/1988,9,0,16,0,25
5/27/1988,7,0,16,14,37
5/28/1988,15,0,7,0,22
5/29/1988,10,0,15,14,39
5/30/1988,8,0,2,6,16
5/31/1988,5,0,5,0,10
6/1/1988,9,0,12,6,27
6/2/1988,11,0,4,6,21
6/3/1988,4,0,15,4,23
6/4/1988,5,0,8,2,15
6/5/1988,7,0,2,8,17
6/6/1988,10,0,11,10,31
6/7/1988,16,0,16,2,34
6/8/1988,4,0,16,4,24
6/9/1988,9,0,15,14,38
6/10/1988,8,0,2,2,12
6/11/1988,15,0,7,3,25
6/12/1988,14,0,8,4,26
6/13/1988,9,0,9,4,22
6/14/1988,16,0,2,4,22
6/15/1988,14,0,8,0,22
6/16/1988,5,0,13,3,21
6/17/1988,14,0,15,0,29
6/18/1988,7,0,2,8,17
6/19/1988,14,0,14,2,30
6/20/1988,14,0,16,4,34
6/21/1988,7,0,3,12,22
6/22/1988,7,0,15,0,22
6/23/1988,15,0,3,6,24
6/24/1988,14,0,7,5,26
6/25/1988,12,0,12,3,27
6/26/1988,11,0,6,3,20
6/27/1988,12,0,3,0,15
6/28/1988,16,0,2,7,25
6/29/1988,7,0,8,12,27
6/30/1988,9,0,5,15,29
7/1/1988,7,0,10,6,23
7/2/1988,5,0,6,12,23
7/3/1988,16,0,10,2,28
7/4/1988,4,0,14,12,30
7/5/1988,15,0,15,5,35
7/6/1988,15,0,8,6,29
7/7/1988,6,0,4,12,22
7/8/1988,11,0,5,15,31
7/9/1988,16,0,15,4,35
7/10/1988,4,0,12,4,20
7/11/1988,16,0,14,16,46
7/12/1988,4,0,15,8,27
7/13/1988,16,0,9,5,30
7/14/1988,15,0,5,7,27
7/15/1988,7,0,14,13,34
7/16/1988,11,0,6,9,26
7/17/1988,4,0,5,7,16
7/18/1988,15,0,13,16,44
7/19/1988,6,0,13,9,28
7/20/1988,10,0,10,3,23
7/21/1988,7,0,4,9,20
7/22/1988,12,0,2,8,22
7/23/1988,12,0,7,8,27
7/24/1988,15,0,6,9,30
7/25/1988,15,0,9,1,25
7/26/1988,13,0,13,11,37
7/27/1988,15,0,7,2,24
7/28/1988,12,0,11,6,29
7/29/1988,7,0,10,12,29
7/30/1988,7,0,12,5,24
7/31/1988,12,0,5,11,28
8/1/1988,4,0,11,14,29
8/2/1988,7,0,10,4,21
8/3/1988,4,0,3,13,20
8/4/1988,7,0,9,13,29
8/5/1988,12,0,16,6,34
8/6/1988,9,0,9,9,27
8/7/1988,10,0,2,9,21
8/8/1988,9,0,12,0,21
8/9/1988,9,0,8,6,23
8/10/1988,6,0,2,13,21
8/11/1988,9,0,6,1,16
8/12/1988,5,0,9,5,19
8/13/1988,10,0,15,1,26
8/14/1988,10,0,4,11,25
8/15/1988,9,0,4,8,21
8/16/1988,14,0,12,2,28
8/17/1988,11,0,4,2,17
8/18/1988,14,0,11,9,34
8/19/1988,15,0,13,11,39
8/20/1988,14,0,13,0,27
8/21/1988,5,0,15,2,22
8/22/1988,8,0,14,14,36
8/23/1988,6,0,4,4,14
8/24/1988,11,0,4,15,30
8/25/1988,7,0,8,1,16
8/26/1988,15,0,11,16,42
8/27/1988,4,0,10,0,14
8/28/1988,16,0,15,2,33
8/29/1988,14,0,14,2,30
8/30/1988,12,0,11,7,30
8/31/1988,11,0,12,10,33
9/1/1988,12,0,5,4,21
9/2/1988,14,0,7,0,21
9/3/1988,15,0,5,4,24
9/4/1988,11,0,13,12,36
9/5/1988,9,0,12,9,30
9/6/1988,15,0,14,0,29
9/7/1988,14,0,12,1,27
9/8/1988,11,0,3,10,24
9/9/1988,11,0,2,16,29
9/10/1988,11,0,14,10,35
9/11/1988,13,0,11,4,28
9/12/1988,10,0,14,7,31
9/13/1988,14,0,6,12,32
9/14/1988,8,0,12,11,31
9/15/1988,14,0,4,13,31
9/16/1988,9,0,12,11,32
9/17/1988,16,0,7,6,29
9/18/1988,7,0,15,1,23
9/19/1988,11,0,15,12,38
9/20/1988,13,0,12,0,25
9/21/1988,7,0,6,10,23
9/22/1988,11,0,12,6,29
9/23/1988,14,0,4,11,29
9/24/1988,10,0,3,8,21
9/25/1988,5,0,3,15,23
9/26/1988,4,0,3,16,23
9/27/1988,9,0,5,2,16
9/28/1988,7,0,11,8,26
9/29/1988,12,0,5,10,27
9/30/1988,5,0,4,8,17
10/1/1988,12,0,14,12,38
10/2/1988,16,0,5,13,34
10/3/1988,16,0,15,4,35
10/4/1988,8,0,15,3,26
10/5/1988,10,0,15,10,35
10/6/1988,9,0,7,12,28
10/7/1988,15,0,2,8,25
10/8/1988,6,0,10,7,23
10/9/1988,14,0,12,11,37
10/10/1988,12,0,10,11,33
10/11/1988,15,0,12,14,41
10/12/1988,5,0,16,12,33
10/13/1988,6,0,5,15,26
10/14/1988,6,0,11,0,17
10/15/1988,15,0,14,12,41
10/16/1988,4,0,13,9,26
10/17/1988,4,0,6,10,20
10/18/1988,9,0,7,10,26
10/19/1988,8,0,4,10,22
10/20/1988,14,0,7,2,23
10/21/1988,7,0,12,0,19
10/22/1988,5,0,5,14,24
10/23/1988,7,0,7,10,24
10/24/1988,9,0,5,8,22
10/25/1988,10,0,5,1,16
10/26/1988,4,0,15,15,34
10/27/1988,4,0,16,2,22
10/28/1988,7,0,13,2,22
10/29/1988,15,0,4,10,29
10/30/1988,13,0,3,14,30
10/31/1988,14,0,11,12,37
11/1/1988,8,0,3,4,15
11/2/1988,4,0,13,0,17
11/3/1988,10,0,16,16,42
11/4/1988,8,0,13,7,28
11/5/1988,13,0,5,1,19
11/6/1988,4,0,2,7,13
11/7/1988,8,0,6,3,17
11/8/1988,6,0,6,11,23
11/9/1988,15,0,6,15,36
11/10/1988,14,0,2,1,17
11/11/1988,13,0,11,5,29
11/12/1988,13,0,15,11,39
11/13/1988,14,0,14,5,33
11/14/1988,16,0,13,8,37
11/15/1988,10,0,6,2,18
11/16/1988,4,0,9,11,24
11/17/1988,5,0,14,4,23
11/18/1988,16,0,12,11,39
11/19/1988,16,0,10,10,36
11/20/1988,5,0,10,9,24
11/21/1988,13,0,9,10,32
11/22/1988,4,0,4,5,13
11/23/1988,8,0,5,0,13
11/24/1988,4,0,8,14,26
11/25/1988,6,0,9,3,18
11/26/1988,15,0,5,9,29
11/27/1988,7,0,15,0,22
11/28/1988,9,0,3,11,23
11/29/1988,13,0,13,6,32
11/30/1988,15,0,10,6,31
12/1/1988,7,0,11,12,30
12/2/1988,12,0,14,12,38
12/3/1988,10,0,16,5,31
12/4/1988,14,0,6,3,23
12/5/1988,11,0,6,0,17
12/6/1988,7,0,10,0,17
12/7/1988,7,0,15,9,31
12/8/1988,11,0,4,3,18
12/9/1988,14,0,3,4,21
12/10/1988,7,0,4,3,14
12/11/1988,7,0,2,15,24
12/12/1988,15,0,9,8,32
12/13/1988,8,0,5,1,14
12/14/1988,7,0,16,6,29
12/15/1988,14,0,8,2,24
12/16/1988,8,0,14,15,37
12/17/1988,13,0,10,7,30
12/18/1988,14,0,5,9,28
12/19/1988,12,0,6,6,24
12/20/1988,9,0,14,3,26
12/21/1988,6,0,4,13,23
12/22/1988,4,0,9,11,24
12/23/1988,5,0,9,16,30
12/24/1988,13,0,16,15,44
12/25/1988,5,0,9,15,29
12/26/1988,10,0,2,14,26
12/27/1988,11,0,8,13,32
12/28/1988,13,0,9,10,32
12/29/1988,5,0,16,9,30
12/30/1988,15,0,4,11,30
12/31/1988,9,0,16,3,28
1/1/1989,15,0,9,13,37
1/2/1989,13,0,15,6,34
1/3/1989,9,0,10,12,31
1/4/1989,16,0,7,2,25
1/5/1989,8,0,8,6,22
1/6/1989,11,0,16,9,36
1/7/1989,13,0,6,11,30
1/8/1989,13,0,8,0,21
1/9/1989,11,0,5,16,32
1/10/1989,12,0,9,6,27
1/11/1989,9,0,15,4,28
1/12/1989,16,0,15,15,46
1/13/1989,5,0,12,6,23
1/14/1989,4,0,13,7,24
1/15/1989,5,0,3,6,14
1/16/1989,11,0,6,9,26
1/17/1989,7,0,8,2,17
1/18/1989,15,0,13,7,35
1/19/1989,4,0,13,4,21
1/20/1989,13,0,8,0,21
1/21/1989,15,0,12,3,30
1/22/1989,5,0,13,10,28
1/23/1989,7,0,9,3,19
1/24/1989,15,0,10,9,34
1/25/1989,5,0,2,11,18
1/26/1989,15,0,14,10,39
1/27/1989,15,0,6,9,30
1/28/1989,5,0,10,3,18
1/29/1989,15,0,5,7,27
1/30/1989,5,0,6,12,23
1/31/1989,13,0,15,10,38
2/1/1989,14,0,14,4,32
2/2/1989,16,0,13,15,44
2/3/1989,9,0,11,4,24
2/4/1989,4,0,9,16,29
2/5/1989,14,0,2,11,27
2/6/1989,12,0,15,8,35
2/7/1989,6,0,9,15,30
2/8/1989,4,0,9,14,27
2/9/1989,12,0,7,11,30
2/10/1989,16,0,7,5,28
2/11/1989,7,0,16,3,26
2/12/1989,4,0,8,5,17
2/13/1989,12,0,14,2,28
2/14/1989,8,0,3,9,20
2/15/1989,6,0,6,3,15
2/16/1989,7,0,10,10,27
2/17/1989,12,0,16,4,32
2/18/1989,15,0,4,1,20
2/19/1989,11,0,7,7,25
2/20/1989,10,0,6,2,18
2/21/1989,5,0,12,1,18
2/22/1989,11,0,16,12,39
2/23/1989,9,0,8,14,31
2/24/1989,9,0,4,15,28
2/25/1989,15,0,10,15,40
2/26/1989,12,0,2,3,17
2/27/1989,11,0,16,9,36
2/28/1989,9,0,4,2,15
3/1/1989,11,0,7,10,28
3/2/1989,14,0,2,8,24
3/3/1989,15,0,8,13,36
3/4/1989,16,0,3,7,26
3/5/1989,6,0,13,0,19
3/6/1989,5,0,16,3,24
3/7/1989,11,0,4,9,24
3/8/1989,13,0,14,13,40
3/9/1989,7,0,2,9,18
3/10/1989,7,0,13,7,27
3/11/1989,10,0,2,13,25
3/12/1989,4,0,7,13,24
3/13/1989,6,0,10,6,22
3/14/1989,16,0,10,8,34
3/15/1989,14,0,6,8,28
3/16/1989,13,0,4,2,19
3/17/1989,7,0,10,13,30
3/18/1989,13,0,9,0,22
3/19/1989,15,0,6,9,30
3/20/1989,7,0,2,9,18
3/21/1989,10,0,4,1,15
3/22/1989,12,0,6,10,28
3/23/1989,10,0,8,14,32
3/24/1989,6,0,10,14,30
3/25/1989,8,0,14,16,38
3/26/1989,6,0,12,6,24
3/27/1989,6,0,4,0,10
3/28/1989,16,0,10,4,30
3/29/1989,13,0,9,7,29
3/30/1989,16,0,2,10,28
3/31/1989,11,0,3,5,19
4/1/1989,5,0,13,0,18
4/2/1989,9,0,15,11,35
4/3/1989,14,0,13,4,31
4/4/1989,4,0,15,14,33
4/5/1989,4,0,5,11,20
4/6/1989,5,0,4,15,24
4/7/1989,13,0,6,16,35
4/8/1989,13,0,12,5,30
4/9/1989,5,0,11,3,19
4/10/1989,14,0,2,6,22
4/11/1989,6,0,6,5,17
4/12/1989,15,0,11,14,40
4/13/1989,16,0,7,0,23
4/14/1989,8,0,15,14,37
4/15/1989,12,0,13,14,39
4/16/1989,5,0,9,4,18
4/17/1989,5,0,7,13,25
4/18/1989,15,0,7,1,23
4/19/1989,9,0,10,15,34
4/20/1989,5,0,14,15,34
4/21/1989,10,0,15,6,31
4/22/1989,9,0,2,9,20
4/23/1989,12,0,14,0,26
4/24/1989,16,0,14,9,39
4/25/1989,12,0,16,2,30
4/26/1989,14,0,16,9,39
4/27/1989,13,0,7,5,25
4/28/1989,8,0,15,10,33
4/29/1989,5,0,7,9,21
4/30/1989,11,0,7,5,23
5/1/1989,15,0,6,5,26
5/2/1989,13,0,11,6,30
5/3/1989,4,0,10,5,19
5/4/1989,8,0,3,2,13
5/5/1989,5,0,16,3,24
5/6/1989,9,0,16,5,30
5/7/1989,13,0,6,1,20
5/8/1989,9,0,3,14,26
5/9/1989,14,0,14,16,44
5/10/1989,15,0,4,0,19
5/11/1989,4,0,16,2,22
5/12/1989,11,0,14,11,36
5/13/1989,12,0,2,6,20
5/14/1989,4,0,4,0,8
5/15/1989,5,0,10,5,20
5/16/1989,10,0,10,7,27
5/17/1989,14,0,6,16,36
5/18/1989,9,0,14,4,27
5/19/1989,13,0,11,7,31
5/20/1989,15,0,14,5,34
5/21/1989,12,0,15,1,28
5/22/1989,15,0,13,7,35
5/23/1989,11,0,16,8,35
5/24/1989,12,0,16,4,32
5/25/1989,6,0,16,3,25
5/26/1989,8,0,8,9,25
5/27/1989,15,0,5,12,32
5/28/1989,16,0,10,7,33
5/29/1989,14,0,15,13,42
5/30/1989,11,0,15,10,36
5/31/1989,8,0,2,11,21
6/1/1989,7,0,13,11,31
6/2/1989,11,0,6,6,23
6/3/1989,16,0,16,11,43
6/4/1989,6,0,2,4,12
6/5/1989,4,0,12,14,30
6/6/1989,5,0,3,9,17
6/7/1989,15,0,13,11,39
6/8/1989,4,0,5,3,12
6/9/1989,16,0,3,0,19
6/10/1989,13,0,14,14,41
6/11/1989,5,0,15,7,27
6/12/1989,11,0,8,0,19
6/13/1989,15,0,7,8,30
6/14/1989,16,0,13,9,38
6/15/1989,15,0,8,7,30
6/16/1989,8,0,5,10,23
6/17/1989,7,0,2,5,14
6/18/1989,5,0,9,8,22
6/19/1989,4,0,14,3,21
6/20/1989,4,0,13,4,21
6/21/1989,6,0,10,16,32
6/22/1989,5,0,11,8,24
6/23/1989,5,0,11,7,23
6/24/1989,16,0,14,10,40
6/25/1989,6,0,7,15,28
6/26/1989,13,0,5,6,24
6/27/1989,14,0,15,0,29
6/28/1989,14,0,7,10,31
6/29/1989,9,0,11,8,28
6/30/1989,8,0,2,15,25
7/1/1989,11,0,5,16,32
7/2/1989,15,0,3,1,19
7/3/1989,14,0,9,11,34
7/4/1989,13,0,11,12,36
7/5/1989,5,0,14,16,35
7/6/1989,9,0,15,9,33
7/7/1989,11,0,10,10,31
7/8/1989,14,0,10,3,27
7/9/1989,14,0,3,1,18
7/10/1989,13,0,11,10,34
7/11/1989,4,0,5,12,21
7/12/1989,7,0,11,8,26
7/13/1989,4,0,6,0,10
7/14/1989,16,0,5,3,24
7/15/1989,12,0,11,13,36
7/16/1989,5,0,3,9,17
7/17/1989,15,0,13,1,29
7/18/1989,12,0,16,12,40
7/19/1989,15,0,16,7,38
7/20/1989,4,0,8,1,13
7/21/1989,7,0,2,14,23
7/22/1989,16,0,6,15,37
7/23/1989,12,0,6,4,22
7/24/1989,4,0,6,16,26
7/25/1989,11,0,9,4,24
7/26/1989,10,0,10,16,36
7/27/1989,12,0,11,4,27
7/28/1989,9,0,15,5,29
7/29/1989,16,0,14,3,33
7/30/1989,4,0,12,9,25
7/31/1989,7,0,2,12,21
8/1/1989,11,0,10,6,27
8/2/1989,4,0,13,13,30
8/3/1989,6,0,6,5,17
8/4/1989,14,0,12,0,26
8/5/1989,8,0,14,14,36
8/6/1989,7,0,9,14,30
8/7/1989,4,0,4,9,17
8/8/1989,12,0,2,9,23
8/9/1989,13,0,10,15,38
8/10/1989,7,0,12,16,35
8/11/1989,15,0,8,0,23
8/12/1989,10,0,13,0,23
8/13/1989,4,0,4,11,19
8/14/1989,12,0,6,16,34
8/15/1989,6,0,4,6,16
8/16/1989,10,0,14,3,27
8/17/1989,11,0,4,2,17
8/18/1989,11,0,15,6,32
8/19/1989,16,0,13,7,36
8/20/1989,9,0,15,16,40
8/21/1989,4,0,7,16,27
8/22/1989,10,0,8,0,18
8/23/1989,6,0,7,14,27
8/24/1989,4,0,7,14,25
8/25/1989,10,0,13,9,32
8/26/1989,5,0,9,2,16
8/27/1989,11,0,10,5,26
8/28/1989,6,0,9,5,20
8/29/1989,12,0,9,4,25
8/30/1989,7,0,3,11,21
8/31/1989,8,0,4,4,16
9/1/1989,9,0,3,10,22
9/2/1989,15,0,5,10,30
9/3/1989,6,0,16,3,25
9/4/1989,11,0,14,0,25
9/5/1989,8,0,15,12,35
9/6/1989,9,0,10,2,21
9/7/1989,10,0,16,9,35
9/8/1989,6,0,16,4,26
9/9/1989,13,0,9,14,36
9/10/1989,16,0,15,4,35
9/11/1989,14,0,3,16,33
9/12/1989,9,0,3,15,27
9/13/1989,15,0,6,7,28
9/14/1989,10,0,2,16,28
9/15/1989,14,0,10,14,38
9/16/1989,4,0,7,7,18
9/17/1989,12,0,14,14,40
9/18/1989,6,0,3,4,13
9/19/1989,13,0,14,1,28
9/20/1989,10,0,2,4,16
9/21/1989,16,0,5,12,33
9/22/1989,9,0,11,11,31
9/23/1989,14,0,8,7,29
9/24/1989,16,0,16,4,36
9/25/1989,4,0,8,7,19
9/26/1989,10,0,3,11,24
9/27/1989,9,0,9,5,23
9/28/1989,5,0,15,7,27
9/29/1989,4,0,12,12,28
9/30/1989,10,0,14,6,30
10/1/1989,5,0,4,10,19
10/2/1989,11,0,15,13,39
10/3/1989,10,0,15,1,26
10/4/1989,11,0,4,9,24
10/5/1989,12,0,16,8,36
10/6/1989,13,0,2,10,25
10/7/1989,4,0,9,7,20
10/8/1989,14,0,16,3,33
10/9/1989,14,0,6,10,30
10/10/1989,14,0,13,8,35
10/11/1989,4,0,7,4,15
10/12/1989,13,0,2,11,26
10/13/1989,8,0,16,6,30
10/14/1989,12,0,13,0,25
10/15/1989,15,0,2,16,33
10/16/1989,14,0,14,14,42
10/17/1989,13,0,2,6,21
10/18/1989,5,0,15,8,28
10/19/1989,12,0,7,10,29
10/20/1989,8,0,2,13,23
10/21/1989,5,0,11,4,20
10/22/1989,6,0,13,13,32
10/23/1989,12,0,15,6,33
10/24/1989,11,0,11,6,28
10/25/1989,5,0,7,10,22
10/26/1989,6,0,16,9,31
10/27/1989,12,0,9,8,29
10/28/1989,7,0,8,5,20
10/29/1989,10,0,15,16,41
10/30/1989,14,0,11,14,39
10/31/1989,11,0,5,5,21
11/1/1989,15,0,6,16,37
11/2/1989,16,0,14,0,30
11/3/1989,12,0,8,1,21
11/4/1989,10,0,3,7,20
11/5/1989,6,0,2,12,20
11/6/1989,10,0,3,14,27
11/7/1989,13,0,4,3,20
11/8/1989,8,0,13,0,21
11/9/1989,4,0,4,9,17
11/10/1989,4,0,12,16,32
11/11/1989,7,0,9,6,22
11/12/1989,13,0,7,13,33
11/13/1989,16,0,14,0,30
11/14/1989,7,0,8,5,20
11/15/1989,10,0,7,1,18
11/16/1989,15,0,13,3,31
11/17/1989,11,0,3,0,14
11/18/1989,4,0,13,9,26
11/19/1989,4,0,12,1,17
11/20/1989,14,0,16,3,33
11/21/1989,4,0,6,14,24
11/22/1989,16,0,7,10,33
11/23/1989,8,0,11,10,29
11/24/1989,16,0,5,2,23
11/25/1989,5,0,12,2,19
11/26/1989,4,0,16,6,26
11/27/1989,15,0,5,14,34
11/28/1989,5,0,15,14,34
11/29/1989,13,0,11,10,34
11/30/1989,8,0,6,12,26
12/1/1989,12,0,14,10,36
12/2/1989,6,0,7,0,13
12/3/1989,6,0,14,11,31
12/4/1989,6,0,14,0,20
12/5/1989,10,0,16,13,39
12/6/1989,7,0,4,10,21
12/7/1989,10,0,13,7,30
12/8/1989,13,0,15,8,36
12/9/1989,4,0,6,4,14
12/10/1989,14,0,13,6,33
12/11/1989,13,0,6,8,27
12/12/1989,5,0,7,16,28
12/13/1989,16,0,13,11,40
12/14/1989,14,0,12,10,36
12/15/1989,14,0,8,12,34
12/16/1989,9,0,4,6,19
12/17/1989,12,0,15,16,43
12/18/1989,16,0,13,1,30
12/19/1989,6,0,12,15,33
12/20/1989,9,0,12,3,24
12/21/1989,11,0,4,3,18
12/22/1989,5,0,14,16,35
12/23/1989,14,0,9,16,39
12/24/1989,4,0,16,11,31
12/25/1989,13,0,2,2,17
12/26/1989,11,0,5,9,25
12/27/1989,7,0,7,1,15
12/28/1989,13,0,12,4,29
12/29/1989,8,0,14,1,23
12/30/1989,7,0,16,4,27
12/31/1989,16,0,2,2,20
1/1/1990,15,0,10,2,27
1/2/1990,4,0,13,15,32
1/3/1990,11,0,10,7,28
1/4/1990,16,0,4,3,23
1/5/1990,16,0,5,15,36
1/6/1990,14,0,13,2,29
1/7/1990,12,0,15,16,43
1/8/1990,11,0,9,9,29
1/9/1990,8,0,3,12,23
1/10/1990,13,0,11,15,39
1/11/1990,4,0,11,2,17
1/12/1990,11,0,6,11,28
1/13/1990,8,0,3,5,16
1/14/1990,11,0,9,7,27
1/15/1990,7,0,16,7,30
1/16/1990,12,0,5,10,27
1/17/1990,11,0,6,2,19
1/18/1990,4,0,13,15,32
1/19/1990,14,0,10,4,28
1/20/1990,16,0,8,1,25
1/21/1990,12,0,2,9,23
1/22/1990,16,0,8,3,27
1/23/1990,4,0,3,5,12
1/24/1990,16,0,4,2,22
1/25/1990,5,0,6,2,13
1/26/1990,4,0,10,3,17
1/27/1990,15,0,11,2,28
1/28/1990,15,0,3,9,27
1/29/1990,16,0,2,5,23
1/30/1990,16,0,16,8,40
1/31/1990,8,0,8,11,27
2/1/1990,5,0,4,13,22
2/2/1990,12,0,6,1,19
2/3/1990,13,0,10,8,31
2/4/1990,9,0,9,12,30
2/5/1990,8,0,3,14,25
2/6/1990,11,0,9,1,21
2/7/1990,16,0,4,15,35
2/8/1990,11,0,10,10,31
2/9/1990,14,0,15,16,45
2/10/1990,9,0,5,3,17
2/11/1990,8,0,6,5,19
2/12/1990,8,0,10,0,18
2/13/1990,15,0,3,0,18
2/14/1990,10,0,5,1,16
2/15/1990,16,0,11,11,38
2/16/1990,15,0,12,7,34
2/17/1990,13,0,13,16,42
2/18/1990,14,0,10,16,40
2/19/1990,7,0,14,14,35
2/20/1990,13,0,12,2,27
2/21/1990,8,0,5,0,13
2/22/1990,15,0,14,8,37
2/23/1990,15,0,8,6,29
2/24/1990,4,0,4,5,13
2/25/1990,15,0,7,5,27
2/26/1990,7,0,2,15,24
2/27/1990,13,0,14,0,27
2/28/1990,16,0,16,10,42
3/1/1990,6,0,6,11,23
3/2/1990,15,0,5,10,30
3/3/1990,12,0,10,3,25
3/4/1990,9,0,4,6,19
3/5/1990,5,0,4,3,12
3/6/1990,15,0,5,10,30
3/7/1990,7,0,10,0,17
3/8/1990,15,0,14,14,43
3/9/1990,15,0,10,4,29
3/10/1990,13,0,6,16,35
3/11/1990,9,0,15,0,24
3/12/1990,16,0,10,4,30
3/13/1990,7,0,3,10,20
3/14/1990,15,0,9,14,38
3/15/1990,15,0,10,15,40
3/16/1990,6,0,3,12,21
3/17/1990,10,0,5,8,23
3/18/1990,12,0,8,14,34
3/19/1990,10,0,3,1,14
3/20/1990,15,0,11,1,27
3/21/1990,16,0,5,4,25
3/22/1990,7,0,14,7,28
3/23/1990,16,0,4,14,34
3/24/1990,10,0,3,8,21
3/25/1990,11,0,4,0,15
3/26/1990,7,0,12,11,30
3/27/1990,12,0,11,7,30
3/28/1990,8,0,15,9,32
3/29/1990,16,0,6,6,28
3/30/1990,13,0,3,8,24
3/31/1990,10,0,8,16,34
4/1/1990,11,0,11,5,27
4/2/1990,5,0,3,10,18
4/3/1990,16,0,7,13,36
4/4/1990,16,0,4,10,30
4/5/1990,5,0,10,13,28
4/6/1990,7,0,6,3,16
4/7/1990,14,0,6,16,36
4/8/1990,9,0,12,3,24
4/9/1990,11,0,11,9,31
4/10/1990,7,0,6,5,18
4/11/1990,4,0,6,2,12
4/12/1990,16,0,4,7,27
4/13/1990,16,0,2,13,31
4/14/1990,6,0,3,10,19
4/15/1990,14,0,5,3,22
4/16/1990,13,0,11,4,28
4/17/1990,5,0,8,2,15
4/18/1990,15,0,10,0,25
4/19/1990,6,0,15,9,30
4/20/1990,7,0,9,13,29
4/21/1990,7,0,11,1,19
4/22/1990,10,0,12,3,25
4/23/1990,16,0,14,9,39
4/24/1990,12,0,10,9,31
4/25/1990,4,0,13,1,18
4/26/1990,5,0,14,14,33
4/27/1990,5,0,16,5,26
4/28/1990,14,0,9,0,23
4/29/1990,7,0,10,9,26
4/30/1990,7,0,12,9,28
5/1/1990,8,0,7,7,22
5/2/1990,6,0,7,12,25
5/3/1990,4,0,4,4,12
5/4/1990,13,0,12,6,31
5/5/1990,15,0,7,13,35
5/6/1990,14,0,5,0,19
5/7/1990,11,0,2,11,24
5/8/1990,4,0,11,15,30
5/9/1990,12,0,13,4,29
5/10/1990,15,0,5,12,32
5/11/1990,4,0,14,16,34
5/12/1990,4,0,16,13,33
5/13/1990,5,0,6,7,18
5/14/1990,16,0,13,13,42
5/15/1990,10,0,4,13,27
5/16/1990,7,0,8,14,29
5/17/1990,10,0,5,1,16
5/18/1990,5,0,16,4,25
5/19/1990,13,0,16,14,43
5/20/1990,6,0,16,8,30
5/21/1990,9,0,2,16,27
5/22/1990,15,0,10,15,40
5/23/1990,13,0,4,7,24
5/24/1990,4,0,7,2,13
5/25/1990,10,0,5,11,26
5/26/1990,11,0,7,8,26
5/27/1990,15,0,6,3,24
5/28/1990,6,0,13,5,24
5/29/1990,15,0,16,10,41
5/30/1990,8,0,14,0,22
5/31/1990,11,0,6,6,23
6/1/1990,4,0,15,2,21
6/2/1990,4,0,2,8,14
6/3/1990,10,0,11,6,27
6/4/1990,5,0,11,12,28
6/5/1990,14,0,15,12,41
6/6/1990,9,0,12,7,28
6/7/1990,11,0,7,14,32
6/8/1990,9,0,5,12,26
6/9/1990,4,0,14,13,31
6/10/1990,16,0,10,13,39
6/11/1990,16,0,10,12,38
6/12/1990,15,0,3,16,34
6/13/1990,7,0,9,15,31
6/14/1990,7,0,13,4,24
6/15/1990,14,0,8,16,38
6/16/1990,7,0,3,10,20
6/17/1990,10,0,9,0,19
6/18/1990,14,0,12,9,35
6/19/1990,14,0,16,1,31
6/20/1990,6,0,13,4,23
6/21/1990,12,0,4,15,31
6/22/1990,8,0,12,5,25
6/23/1990,6,0,16,1,23
6/24/1990,15,0,13,4,32
6/25/1990,12,0,2,3,17
6/26/1990,16,0,10,8,34
6/27/1990,10,0,4,13,27
6/28/1990,15,0,14,16,45
6/29/1990,4,0,5,14,23
6/30/1990,6,0,3,3,12
7/1/1990,12,0,16,7,35
7/2/1990,12,0,12,3,27
7/3/1990,12,0,3,0,15
7/4/1990,15,0,7,3,25
7/5/1990,8,0,10,3,21
7/6/1990,10,0,9,9,28
7/7/1990,14,0,3,16,33
7/8/1990,13,0,14,15,42
7/9/1990,14,0,5,12,31
7/10/1990,14,0,3,11,28
7/11/1990,14,0,16,7,37
7/12/1990,12,0,6,4,22
7/13/1990,5,0,3,16,24
7/14/1990,8,0,3,3,14
7/15/1990,9,0,15,7,31
7/16/1990,7,0,2,2,11
7/17/1990,16,0,8,0,24
7/18/1990,15,0,5,4,24
7/19/1990,12,0,7,4,23
7/20/1990,8,0,2,3,13
7/21/1990,8,0,14,12,34
7/22/1990,8,0,7,1,16
7/23/1990,10,0,2,0,12
7/24/1990,5,0,6,8,19
7/25/1990,11,0,9,4,24
7/26/1990,7,0,10,11,28
7/27/1990,7,0,11,11,29
7/28/1990,5,0,16,12,33
7/29/1990,10,0,6,4,20
7/30/1990,13,0,16,4,33
7/31/1990,6,0,10,11,27
8/1/1990,16,0,15,9,40
8/2/1990,9,0,14,14,37
8/3/1990,12,0,9,10,31
8/4/1990,13,0,4,8,25
8/5/1990,5,0,9,12,26
8/6/1990,9,0,4,16,29
8/7/1990,11,0,6,16,33
8/8/1990,10,0,14,11,35
8/9/1990,14,0,3,4,21
8/10/1990,8,0,13,10,31
8/11/1990,16,0,5,14,35
8/12/1990,6,0,2,8,16
8/13/1990,14,0,3,6,23
8/14/1990,14,0,8,7,29
8/15/1990,11,0,16,5,32
8/16/1990,5,0,8,10,23
8/17/1990,5,0,4,10,19
8/18/1990,5,0,2,15,22
8/19/1990,9,0,11,4,24
8/20/1990,15,0,15,2,32
8/21/1990,5,0,5,13,23
8/22/1990,9,0,4,10,23
8/23/1990,7,0,11,8,26
8/24/1990,6,0,12,5,23
8/25/1990,16,0,2,4,22
8/26/1990,11,0,2,2,15
8/27/1990,5,0,6,14,25
8/28/1990,11,0,7,15,33
8/29/1990,16,0,11,7,34
8/30/1990,16,0,16,16,48
8/31/1990,9,0,15,15,39
9/1/1990,13,0,12,13,38
9/2/1990,10,0,9,10,29
9/3/1990,13,0,15,2,30
9/4/1990,13,0,8,1,22
9/5/1990,13,0,12,3,28
9/6/1990,5,0,13,6,24
9/7/1990,10,0,11,9,30
9/8/1990,8,0,2,16,26
9/9/1990,6,0,8,0,14
9/10/1990,16,0,14,4,34
9/11/1990,7,0,4,7,18
9/12/1990,7,0,13,12,32
9/13/1990,6,0,13,9,28
9/14/1990,13,0,14,6,33
9/15/1990,11,0,2,5,18
9/16/1990,7,0,7,1,15
9/17/1990,14,0,11,10,35
9/18/1990,16,0,14,15,45
9/19/1990,15,0,7,5,27
9/20/1990,16,0,7,4,27
9/21/1990,14,0,9,8,31
9/22/1990,4,0,12,4,20
9/23/1990,13,0,4,13,30
9/24/1990,9,0,9,5,23
9/25/1990,12,0,7,1,20
9/26/1990,8,0,4,6,18
9/27/1990,5,0,5,11,21
9/28/1990,12,0,12,16,40
9/29/1990,7,0,16,14,37
9/30/1990,5,0,14,14,33
10/1/1990,15,0,8,7,30
10/2/1990,9,0,5,7,21
10/3/1990,10,0,9,0,19
10/4/1990,8,0,8,10,26
10/5/1990,15,0,6,8,29
10/6/1990,10,0,13,13,36
10/7/1990,11,0,13,2,26
10/8/1990,16,0,5,15,36
10/9/1990,10,0,8,3,21
10/10/1990,6,0,3,15,24
10/11/1990,15,0,14,0,29
10/12/1990,15,0,14,0,29
10/13/1990,10,0,5,15,30
10/14/1990,4,0,10,4,18
10/15/1990,10,0,12,16,38
10/16/1990,14,0,9,4,27
10/17/1990,5,0,3,8,16
10/18/1990,10,0,16,16,42
10/19/1990,6,0,16,3,25
10/20/1990,15,0,8,11,34
10/21/1990,12,0,6,11,29
10/22/1990,7,0,15,5,27
10/23/1990,11,0,13,1,25
10/24/1990,12,0,4,6,22
10/25/1990,10,0,10,8,28
10/26/1990,9,0,2,8,19
10/27/1990,6,0,12,12,30
10/28/1990,5,0,5,6,16
10/29/1990,13,0,2,3,18
10/30/1990,14,0,11,9,34
10/31/1990,7,0,5,0,12
11/1/1990,7,0,10,9,26
11/2/1990,12,0,14,0,26
11/3/1990,4,0,16,7,27
11/4/1990,14,0,4,6,24
11/5/1990,11,0,15,5,31
11/6/1990,16,0,11,6,33
11/7/1990,9,0,9,2,20
11/8/1990,12,0,11,9,32
11/9/1990,15,0,6,16,37
11/10/1990,10,0,15,13,38
11/11/1990,14,0,7,0,21
11/12/1990,16,0,4,13,33
11/13/1990,5,0,5,12,22
11/14/1990,9,0,13,7,29
11/15/1990,16,0,10,5,31
11/16/1990,13,0,11,9,33
11/17/1990,11,0,13,10,34
11/18/1990,9,0,16,1,26
11/19/1990,13,0,4,11,28
11/20/1990,16,0,16,14,46
11/21/1990,7,0,14,1,22
11/22/1990,10,0,10,12,32
11/23/1990,10,0,7,11,28
11/24/1990,16,0,9,3,28
11/25/1990,10,0,4,3,17
11/26/1990,9,0,12,12,33
11/27/1990,9,0,6,9,24
11/28/1990,10,0,14,16,40
11/29/1990,16,0,13,6,35
11/30/1990,6,0,14,12,32
12/1/1990,12,0,10,15,37
12/2/1990,14,0,4,14,32
12/3/1990,15,0,10,6,31
12/4/1990,16,0,7,10,33
12/5/1990,10,0,4,2,16
12/6/1990,6,0,12,1,19
12/7/1990,8,0,4,1,13
12/8/1990,5,0,2,0,7
12/9/1990,11,0,8,5,24
12/10/1990,12,0,10,4,26
12/11/1990,12,0,11,14,37
12/12/1990,9,0,4,15,28
12/13/1990,13,0,15,12,40
12/14/1990,15,0,9,0,24
12/15/1990,11,0,14,11,36
12/16/1990,12,0,11,7,30
12/17/1990,14,0,14,11,39
12/18/1990,16,0,2,4,22
12/19/1990,5,0,10,12,27
12/20/1990,8,0,4,14,26
12/21/1990,10,0,15,0,25
12/22/1990,16,0,4,6,26
12/23/1990,11,0,15,6,32
12/24/1990,7,0,15,13,35
12/25/1990,12,0,2,11,25
12/26/1990,12,0,14,9,35
12/27/1990,8,0,14,2,24
12/28/1990,7,0,6,12,25
12/29/1990,16,0,10,8,34
12/30/1990,13,0,13,0,26
12/31/1990,10,0,3,3,16
1/1/1991,4,0,14,5,23
1/2/1991,6,0,10,9,25
1/3/1991,10,0,15,6,31
1/4/1991,14,0,12,6,32
1/5/1991,12,0,11,5,28
1/6/1991,5,0,2,2,9
1/7/1991,6,0,14,10,30
1/8/1991,14,0,10,1,25
1/9/1991,13,0,15,3,31
1/10/1991,11,0,6,3,20
1/11/1991,8,0,2,6,16
1/12/1991,16,0,12,4,32
1/13/1991,16,0,7,10,33
1/14/1991,4,0,7,2,13
1/15/1991,12,0,11,0,23
1/16/1991,6,0,14,3,23
1/17/1991,5,0,9,14,28
1/18/1991,4,0,4,9,17
1/19/1991,9,0,7,9,25
1/20/1991,9,0,8,0,17
1/21/1991,15,0,8,11,34
1/22/1991,6,0,5,3,14
1/23/1991,13,0,6,16,35
1/24/1991,4,0,5,1,10
1/25/1991,13,0,9,0,22
1/26/1991,13,0,13,14,40
1/27/1991,4,0,3,15,22
1/28/1991,15,0,8,2,25
1/29/1991,9,0,3,10,22
1/30/1991,4,0,16,12,32
1/31/1991,12,0,12,14,38
2/1/1991,6,0,4,8,18
2/2/1991,16,0,11,11,38
2/3/1991,11,0,16,2,29
2/4/1991,8,0,13,11,32
2/5/1991,4,0,16,14,34
2/6/1991,14,0,7,11,32
2/7/1991,15,0,11,13,39
2/8/1991,4,0,12,0,16
2/9/1991,8,0,9,4,21
2/10/1991,10,0,6,1,17
2/11/1991,4,0,13,5,22
2/12/1991,4,0,2,13,19
2/13/1991,13,0,4,3,20
2/14/1991,13,0,10,2,25
2/15/1991,7,0,8,1,16
2/16/1991,5,0,5,12,22
2/17/1991,13,0,15,8,36
2/18/1991,8,0,12,11,31
2/19/1991,10,0,12,4,26
2/20/1991,9,0,5,6,20
2/21/1991,13,0,12,2,27
2/22/1991,6,0,3,12,21
2/23/1991,16,0,11,14,41
2/24/1991,13,0,8,15,36
2/25/1991,8,0,4,11,23
2/26/1991,11,0,10,0,21
2/27/1991,13,0,16,9,38
2/28/1991,15,0,13,12,40
3/1/1991,7,0,15,11,33
3/2/1991,13,0,10,9,32
3/3/1991,4,0,13,3,20
3/4/1991,12,0,9,3,24
3/5/1991,14,0,11,14,39
3/6/1991,9,0,9,4,22
3/7/1991,5,0,8,6,19
3/8/1991,16,0,13,2,31
3/9/1991,4,0,12,16,32
3/10/1991,10,0,11,4,25
3/11/1991,12,0,11,7,30
3/12/1991,11,0,10,13,34
3/13/1991,14,0,14,11,39
3/14/1991,13,0,8,16,37
3/15/1991,4,0,12,9,25
3/16/1991,6,0,7,0,13
3/17/1991,13,0,12,5,30
3/18/1991,16,0,12,10,38
3/19/1991,4,0,5,3,12
3/20/1991,16,0,11,11,38
3/21/1991,8,0,7,16,31
3/22/1991,15,0,4,11,30
3/23/1991,11,0,9,15,35
3/24/1991,7,0,15,4,26
3/25/1991,9,0,3,0,12
3/26/1991,9,0,14,2,25
3/27/1991,13,0,14,10,37
3/28/1991,14,0,14,2,30
3/29/1991,10,0,13,0,23
3/30/1991,9,0,9,7,25
3/31/1991,10,0,15,15,40
4/1/1991,13,0,6,12,31
4/2/1991,8,0,7,10,25
4/3/1991,11,0,12,0,23
4/4/1991,11,0,10,2,23
4/5/1991,13,0,10,3,26
4/6/1991,15,0,4,11,30
4/7/1991,15,0,12,15,42
4/8/1991,15,0,4,10,29
4/9/1991,10,0,13,5,28
4/10/1991,8,0,8,10,26
4/11/1991,13,0,15,11,39
4/12/1991,15,0,16,3,34
4/13/1991,14,0,7,13,34
4/14/1991,10,0,16,14,40
4/15/1991,4,0,3,12,19
4/16/1991,16,0,10,4,30
4/17/1991,8,0,15,2,25
4/18/1991,6,0,8,6,20
4/19/1991,11,0,8,14,33
4/20/1991,15,0,11,8,34
4/21/1991,8,0,6,16,30
4/22/1991,14,0,10,12,36
4/23/1991,5,0,2,8,15
4/24/1991,11,0,15,10,36
4/25/1991,14,0,8,11,33
4/26/1991,12,0,6,9,27
4/27/1991,15,0,2,7,24
4/28/1991,14,0,6,0,20
4/29/1991,9,0,6,6,21
4/30/1991,10,0,16,5,31
5/1/1991,7,0,7,15,29
5/2/1991,5,0,8,15,28
5/3/1991,14,0,8,1,23
5/4/1991,14,0,3,5,22
5/5/1991,15,0,10,16,41
5/6/1991,9,0,16,5,30
5/7/1991,16,0,6,0,22
5/8/1991,13,0,12,3,28
5/9/1991,13,0,15,4,32
5/10/1991,11,0,4,16,31
5/11/1991,15,0,12,11,38
5/12/1991,16,0,4,4,24
5/13/1991,11,0,15,2,28
5/14/1991,16,0,11,2,29
5/15/1991,13,0,9,6,28
5/16/1991,9,0,12,10,31
5/17/1991,14,0,6,5,25
5/18/1991,15,0,15,13,43
5/19/1991,10,0,9,10,29
5/20/1991,9,0,6,11,26
5/21/1991,8,0,10,0,18
5/22/1991,14,0,12,16,42
5/23/1991,12,0,16,14,42
5/24/1991,11,0,16,6,33
5/25/1991,9,0,15,1,25
5/26/1991,9,0,10,15,34
5/27/1991,6,0,15,0,21
5/28/1991,9,0,4,7,20
5/29/1991,16,0,10,11,37
5/30/1991,10,0,8,0,18
5/31/1991,7,0,9,2,18
6/1/1991,11,0,12,10,33
6/2/1991,10,0,11,7,28
6/3/1991,11,0,8,7,26
6/4/1991,10,0,12,4,26
6/5/1991,11,0,10,9,30
6/6/1991,6,0,16,13,35
6/7/1991,7,0,5,12,24
6/8/1991,6,0,8,11,25
6/9/1991,12,0,8,5,25
6/10/1991,16,0,12,4,32
6/11/1991,8,0,16,6,30
6/12/1991,10,0,2,8,20
6/13/1991,11,0,9,0,20
6/14/1991,7,0,5,3,15
6/15/1991,11,0,3,7,21
6/16/1991,12,0,14,4,30
6/17/1991,12,0,8,4,24
6/18/1991,12,0,3,12,27
6/19/1991,12,0,10,15,37
6/20/1991,5,0,15,2,22
6/21/1991,14,0,13,9,36
6/22/1991,13,0,16,12,41
6/23/1991,11,0,6,13,30
6/24/1991,6,0,6,14,26
6/25/1991,8,0,8,9,25
6/26/1991,12,0,8,3,23
6/27/1991,14,0,3,3,20
6/28/1991,9,0,11,0,20
6/29/1991,9,0,6,10,25
6/30/1991,10,0,5,14,29
7/1/1991,8,0,16,12,36
7/2/1991,5,0,9,10,24
7/3/1991,13,0,14,9,36
7/4/1991,11,0,11,6,28
7/5/1991,15,0,16,14,45
7/6/1991,12,0,14,0,26
7/7/1991,4,0,7,7,18
7/8/1991,12,0,10,16,38
7/9/1991,9,0,2,13,24
7/10/1991,9,0,11,10,30
7/11/1991,4,0,14,6,24
7/12/1991,4,0,11,14,29
7/13/1991,4,0,8,14,26
7/14/1991,5,0,14,5,24
7/15/1991,16,0,8,4,28
7/16/1991,16,0,11,5,32
7/17/1991,13,0,4,8,25
7/18/1991,4,0,7,8,19
7/19/1991,15,0,14,1,30
7/20/1991,11,0,15,11,37
7/21/1991,8,0,11,4,23
7/22/1991,10,0,16,11,37
7/23/1991,10,0,5,6,21
7/24/1991,15,0,10,6,31
7/25/1991,7,0,6,12,25
7/26/1991,12,0,6,7,25
7/27/1991,5,0,8,9,22
7/28/1991,9,0,6,0,15
7/29/1991,4,0,2,2,8
7/30/1991,16,0,14,10,40
7/31/1991,7,0,13,7,27
8/1/1991,9,0,6,2,17
8/2/1991,15,0,11,6,32
8/3/1991,15,0,3,8,26
8/4/1991,4,0,14,12,30
8/5/1991,6,0,3,3,12
8/6/1991,5,0,12,10,27
8/7/1991,14,0,8,2,24
8/8/1991,13,0,8,0,21
8/9/1991,7,0,7,8,22
8/10/1991,7,0,11,8,26
8/11/1991,10,0,9,2,21
8/12/1991,9,0,15,14,38
8/13/1991,16,0,9,11,36
8/14/1991,9,0,7,2,18
8/15/1991,5,0,14,0,19
8/16/1991,11,0,5,9,25
8/17/1991,13,0,2,13,28
8/18/1991,14,0,4,9,27
8/19/1991,4,0,16,12,32
8/20/1991,11,0,6,14,31
8/21/1991,11,0,8,15,34
8/22/1991,16,0,5,1,22
8/23/1991,15,0,10,1,26
8/24/1991,5,0,13,15,33
8/25/1991,10,0,6,15,31
8/26/1991,13,0,12,5,30
8/27/1991,7,0,5,9,21
8/28/1991,12,0,12,12,36
8/29/1991,15,0,2,3,20
8/30/1991,7,0,5,16,28
8/31/1991,6,0,10,8,24
9/1/1991,7,0,4,11,22
9/2/1991,14,0,15,7,36
9/3/1991,14,0,16,9,39
9/4/1991,9,0,2,12,23
9/5/1991,15,0,3,12,30
9/6/1991,12,0,11,8,31
9/7/1991,6,0,12,5,23
9/8/1991,6,0,7,9,22
9/9/1991,11,0,3,3,17
9/10/1991,5,0,15,13,33
9/11/1991,8,0,9,8,25
9/12/1991,6,0,9,6,21
9/13/1991,9,0,5,9,23
9/14/1991,10,0,3,9,22
9/15/1991,6,0,16,9,31
9/16/1991,4,0,12,5,21
9/17/1991,11,0,14,4,29
9/18/1991,7,0,6,15,28
9/19/1991,4,0,5,1,10
9/20/1991,15,0,12,12,39
9/21/1991,8,0,8,10,26
9/22/1991,16,0,4,15,35
9/23/1991,16,0,13,14,43
9/24/1991,11,0,2,0,13
9/25/1991,14,0,13,1,28
9/26/1991,15,0,9,13,37
9/27/1991,5,0,5,8,18
9/28/1991,7,0,2,0,9
9/29/1991,7,0,8,5,20
9/30/1991,16,0,11,1,28
10/1/1991,5,0,16,8,29
10/2/1991,14,0,10,16,40
10/3/1991,12,0,3,13,28
10/4/1991,8,0,8,9,25
10/5/1991,4,0,7,14,25
10/6/1991,16,0,9,5,30
10/7/1991,11,0,14,6,31
10/8/1991,8,0,2,3,13
10/9/1991,10,0,15,10,35
10/10/1991,5,0,7,1,13
10/11/1991,11,0,8,3,22
10/12/1991,12,0,13,10,35
10/13/1991,15,0,9,7,31
10/14/1991,13,0,15,1,29
10/15/1991,10,0,3,10,23
10/16/1991,16,0,11,14,41
10/17/1991,16,0,5,11,32
10/18/1991,7,0,4,16,27
10/19/1991,10,0,10,5,25
10/20/1991,13,0,15,15,43
10/21/1991,7,0,16,9,32
10/22/1991,12,0,10,15,37
10/23/1991,11,0,2,15,28
10/24/1991,15,0,13,3,31
10/25/1991,7,0,14,15,36
10/26/1991,11,0,6,15,32
10/27/1991,14,0,11,15,40
10/28/1991,4,0,14,12,30
10/29/1991,8,0,14,12,34
10/30/1991,9,0,4,1,14
10/31/1991,6,0,6,4,16
11/1/1991,14,0,16,7,37
11/2/1991,4,0,5,9,18
11/3/1991,4,0,4,5,13
11/4/1991,11,0,3,14,28
11/5/1991,5,0,16,14,35
11/6/1991,10,0,9,15,34
11/7/1991,16,0,9,10,35
11/8/1991,13,0,15,8,36
11/9/1991,7,0,9,8,24
11/10/1991,14,0,5,13,32
11/11/1991,5,0,8,7,20
11/12/1991,16,0,5,9,30
11/13/1991,4,0,6,6,16
11/14/1991,6,0,3,1,10
11/15/1991,9,0,9,3,21
11/16/1991,9,0,14,9,32
11/17/1991,11,0,5,10,26
11/18/1991,11,0,8,7,26
11/19/1991,15,0,12,12,39
11/20/1991,13,0,9,10,32
11/21/1991,7,0,2,0,9
11/22/1991,13,0,11,3,27
11/23/1991,7,0,9,4,20
11/24/1991,16,0,6,1,23
11/25/1991,10,0,6,13,29
11/26/1991,4,0,5,15,24
11/27/1991,4,0,13,11,28
11/28/1991,16,0,11,9,36
11/29/1991,13,0,14,10,37
11/30/1991,12,0,8,0,20
12/1/1991,6,0,4,4,14
12/2/1991,8,0,8,13,29
12/3/1991,15,0,8,5,28
12/4/1991,14,0,9,4,27
12/5/1991,7,0,13,3,23
12/6/1991,9,0,4,5,18
12/7/1991,15,0,14,5,34
12/8/1991,9,0,11,11,31
12/9/1991,5,0,14,12,31
12/10/1991,7,0,3,5,15
12/11/1991,5,0,7,0,12
12/12/1991,15,0,8,4,27
12/13/1991,4,0,16,16,36
12/14/1991,9,0,2,14,25
12/15/1991,8,0,10,8,26
12/16/1991,8,0,12,3,23
12/17/1991,9,0,2,0,11
12/18/1991,6,0,12,7,25
12/19/1991,8,0,4,11,23
12/20/1991,13,0,4,5,22
12/21/1991,15,0,11,10,36
12/22/1991,9,0,9,2,20
12/23/1991,16,0,3,1,20
12/24/1991,7,0,3,13,23
12/25/1991,14,0,15,14,43
12/26/1991,4,0,11,10,25
12/27/1991,13,0,2,13,28
12/28/1991,14,0,5,16,35
12/29/1991,5,0,12,0,17
12/30/1991,15,0,13,15,43
12/31/1991,10,0,16,13,39
1/1/1992,5,0,6,3,14
1/2/1992,10,0,10,16,36
1/3/1992,7,0,2,4,13
1/4/1992,7,0,4,13,24
1/5/1992,14,0,3,16,33
1/6/1992,9,0,5,1,15
1/7/1992,12,0,11,4,27
1/8/1992,14,0,15,14,43
1/9/1992,4,0,3,10,17
1/10/1992,7,0,16,12,35
1/11/1992,6,0,5,6,17
1/12/1992,4,0,13,4,21
1/13/1992,11,0,3,0,14
1/14/1992,6,0,13,3,22
1/15/1992,14,0,3,11,28
1/16/1992,4,0,5,16,25
1/17/1992,7,0,7,8,22
1/18/1992,14,0,7,14,35
1/19/1992,10,0,12,11,33
1/20/1992,5,0,12,13,30
1/21/1992,15,0,8,4,27
1/22/1992,12,0,3,1,16
1/23/1992,16,0,9,6,31
1/24/1992,11,0,10,9,30
1/25/1992,13,0,7,6,26
1/26/1992,16,0,13,13,42
1/27/1992,15,0,16,0,31
1/28/1992,8,0,11,14,33
1/29/1992,5,0,7,4,16
1/30/1992,7,0,13,2,22
1/31/1992,6,0,10,16,32
2/1/1992,12,0,5,10,27
2/2/1992,8,0,6,10,24
2/3/1992,12,0,9,9,30
2/4/1992,14,0,14,14,42
2/5/1992,5,0,8,16,29
2/6/1992,10,0,2,12,24
2/7/1992,6,0,2,11,19
2/8/1992,7,0,13,14,34
2/9/1992,9,0,6,13,28
2/10/1992,4,0,9,10,23
2/11/1992,15,0,3,7,25
2/12/1992,12,0,14,8,34
2/13/1992,12,0,6,15,33
2/14/1992,8,0,5,9,22
2/15/1992,12,0,2,5,19
2/16/1992,5,0,6,14,25
2/17/1992,11,0,2,5,18
2/18/1992,15,0,15,8,38
2/19/1992,4,0,14,10,28
2/20/1992,10,0,7,16,33
2/21/1992,10,0,7,15,32
2/22/1992,4,0,15,7,26
2/23/1992,9,0,5,2,16
2/24/1992,13,0,7,13,33
2/25/1992,7,0,10,5,22
2/26/1992,16,0,2,13,31
2/27/1992,15,0,3,9,27
2/28/1992,14,0,3,16,33
2/29/1992,16,0,10,13,39
3/1/1992,7,0,12,3,22
3/2/1992,6,0,6,4,16
3/3/1992,6,0,9,4,19
3/4/1992,16,0,10,12,38
3/5/1992,7,0,15,9,31
3/6/1992,10,0,5,6,21
3/7/1992,16,0,5,15,36
3/8/1992,15,0,5,3,23
3/9/1992,13,0,8,9,30
3/10/1992,11,0,4,7,22
3/11/1992,7,0,3,15,25
3/12/1992,11,0,6,9,26
3/13/1992,7,0,6,13,26
3/14/1992,7,0,9,0,16
3/15/1992,10,0,4,16,30
3/16/1992,9,0,4,7,20
3/17/1992,11,0,11,4,26
3/18/1992,9,0,6,15,30
3/19/1992,10,0,3,8,21
3/20/1992,6,0,8,13,27
3/21/1992,11,0,15,7,33
3/22/1992,9,0,8,12,29
3/23/1992,12,0,2,12,26
3/24/1992,13,0,9,5,27
3/25/1992,8,0,6,4,18
3/26/1992,7,0,15,2,24
3/27/1992,15,0,4,16,35
3/28/1992,15,0,11,7,33
3/29/1992,6,0,16,15,37
3/30/1992,16,0,11,13,40
3/31/1992,4,0,13,1,18
4/1/1992,15,0,15,10,40
4/2/1992,7,0,5,3,15
4/3/1992,12,0,4,3,19
4/4/1992,13,0,11,6,30
4/5/1992,9,0,9,10,28
4/6/1992,15,0,2,2,19
4/7/1992,11,0,4,7,22
4/8/1992,14,0,7,5,26
4/9/1992,8,0,15,1,24
4/10/1992,7,0,10,7,24
4/11/1992,4,0,4,0,8
4/12/1992,13,0,13,15,41
4/13/1992,11,0,13,15,39
4/14/1992,12,0,11,5,28
4/15/1992,9,0,4,10,23
4/16/1992,7,0,12,2,21
4/17/1992,7,0,7,0,14
4/18/1992,12,0,10,13,35
4/19/1992,14,0,2,8,24
4/20/1992,15,0,3,3,21
4/21/1992,6,0,10,1,17
4/22/1992,12,0,5,12,29
4/23/1992,4,0,13,8,25
4/24/1992,13,0,8,7,28
4/25/1992,10,0,3,8,21
4/26/1992,13,0,9,7,29
4/27/1992,12,0,8,9,29
4/28/1992,10,0,10,9,29
4/29/1992,10,0,6,6,22
4/30/1992,6,0,3,12,21
5/1/1992,7,0,14,1,22
5/2/1992,9,0,8,11,28
5/3/1992,12,0,2,5,19
5/4/1992,13,0,5,8,26
5/5/1992,7,0,2,13,22
5/6/1992,13,0,8,4,25
5/7/1992,7,0,10,1,18
5/8/1992,4,0,6,0,10
5/9/1992,14,0,16,12,42
5/10/1992,11,0,4,12,27
5/11/1992,16,0,9,14,39
5/12/1992,11,0,7,12,30
5/13/1992,14,0,7,14,35
5/14/1992,9,0,2,14,25
5/15/1992,13,0,9,6,28
5/16/1992,16,0,10,5,31
5/17/1992,10,0,15,16,41
5/18/1992,7,0,16,6,29
5/19/1992,9,0,3,4,16
5/20/1992,7,0,3,7,17
5/21/1992,14,0,11,6,31
5/22/1992,16,0,10,5,31
5/23/1992,8,0,4,12,24
5/24/1992,14,0,2,3,19
5/25/1992,6,0,16,14,36
5/26/1992,15,0,7,1,23
5/27/1992,4,0,7,16,27
5/28/1992,14,0,2,16,32
5/29/1992,16,0,2,15,33
5/30/1992,7,0,15,13,35
5/31/1992,14,0,15,6,35
6/1/1992,9,0,5,13,27
6/2/1992,15,0,14,4,33
6/3/1992,5,0,10,4,19
6/4/1992,8,0,2,2,12
6/5/1992,15,0,7,0,22
6/6/1992,10,0,9,14,33
6/7/1992,14,0,2,3,19
6/8/1992,11,0,15,11,37
6/9/1992,9,0,6,14,29
6/10/1992,14,0,3,0,17
6/11/1992,11,0,9,15,35
6/12/1992,16,0,15,13,44
6/13/1992,10,0,2,6,18
6/14/1992,10,0,7,4,21
6/15/1992,6,0,13,15,34
6/16/1992,14,0,15,9,38
6/17/1992,15,0,12,5,32
6/18/1992,12,0,8,8,28
6/19/1992,11,0,11,12,34
6/20/1992,8,0,15,1,24
6/21/1992,6,0,7,7,20
6/22/1992,11,0,9,1,21
6/23/1992,9,0,15,3,27
6/24/1992,10,0,15,15,40
6/25/1992,13,0,3,15,31
6/26/1992,8,0,8,13,29
6/27/1992,14,0,13,8,35
6/28/1992,15,0,10,16,41
6/29/1992,14,0,16,12,42
6/30/1992,15,0,5,7,27
7/1/1992,11,0,9,12,32
7/2/1992,10,0,2,6,18
7/3/1992,13,0,4,15,32
7/4/1992,10,0,8,6,24
7/5/1992,6,0,8,4,18
7/6/1992,14,0,14,9,37
7/7/1992,13,0,3,2,18
7/8/1992,16,0,6,9,31
7/9/1992,6,0,14,10,30
7/10/1992,10,0,4,14,28
7/11/1992,13,0,3,0,16
7/12/1992,9,0,11,9,29
7/13/1992,4,0,2,4,10
7/14/1992,5,0,5,1,11
7/15/1992,10,0,7,13,30
7/16/1992,10,0,8,3,21
7/17/1992,6,0,7,10,23
7/18/1992,12,0,7,5,24
7/19/1992,10,0,10,5,25
7/20/1992,9,0,3,10,22
7/21/1992,8,0,7,2,17
7/22/1992,16,0,8,7,31
7/23/1992,7,0,16,6,29
7/24/1992,4,0,13,2,19
7/25/1992,16,0,15,11,42
7/26/1992,8,0,12,9,29
7/27/1992,5,0,8,16,29
7/28/1992,11,0,16,0,27
7/29/1992,14,0,10,6,30
7/30/1992,16,0,10,9,35
7/31/1992,8,0,16,1,25
8/1/1992,5,0,6,4,15
8/2/1992,15,0,15,3,33
8/3/1992,4,0,11,6,21
8/4/1992,4,0,15,15,34
8/5/1992,9,0,8,13,30
8/6/1992,10,0,9,2,21
8/7/1992,12,0,2,13,27
8/8/1992,8,0,3,16,27
8/9/1992,8,0,14,0,22
8/10/1992,14,0,14,6,34
8/11/1992,6,0,10,6,22
8/12/1992,6,0,2,7,15
8/13/1992,11,0,5,0,16
8/14/1992,12,0,15,12,39
8/15/1992,10,0,5,15,30
8/16/1992,13,0,11,1,25
8/17/1992,8,0,6,13,27
8/18/1992,13,0,8,10,31
8/19/1992,9,0,15,12,36
8/20/1992,7,0,11,14,32
8/21/1992,16,0,16,13,45
8/22/1992,11,0,15,0,26
8/23/1992,8,0,3,0,11
8/24/1992,15,0,14,11,40
8/25/1992,7,0,7,2,16
8/26/1992,9,0,3,8,20
8/27/1992,7,0,10,5,22
8/28/1992,6,0,10,15,31
8/29/1992,4,0,9,5,18
8/30/1992,6,0,5,2,13
8/31/1992,9,0,3,15,27
9/1/1992,9,0,14,11,34
9/2/1992,5,0,10,16,31
9/3/1992,8,0,3,0,11
9/4/1992,10,0,14,10,34
9/5/1992,9,0,13,11,33
9/6/1992,7,0,13,12,32
9/7/1992,15,0,2,15,32
9/8/1992,11,0,4,8,23
9/9/1992,10,0,14,7,31
9/10/1992,9,0,9,2,20
9/11/1992,7,0,7,1,15
9/12/1992,7,0,13,15,35
9/13/1992,4,0,2,16,22
9/14/1992,5,0,11,9,25
9/15/1992,4,0,11,8,23
9/16/1992,4,0,5,15,24
9/17/1992,14,0,13,14,41
9/18/1992,9,0,5,4,18
9/19/1992,9,0,14,7,30
9/20/1992,6,0,13,9,28
9/21/1992,9,0,10,10,29
9/22/1992,13,0,16,11,40
9/23/1992,6,0,4,3,13
9/24/1992,13,0,10,10,33
9/25/1992,5,0,15,13,33
9/26/1992,11,0,2,5,18
9/27/1992,15,0,8,3,26
9/28/1992,8,0,4,9,21
9/29/1992,9,0,2,4,15
9/30/1992,15,0,11,0,26
10/1/1992,11,0,5,12,28
10/2/1992,13,0,7,11,31
10/3/1992,13,0,14,11,38
10/4/1992,9,0,6,0,15
10/5/1992,8,0,12,7,27
10/6/1992,16,0,14,14,44
10/7/1992,12,0,14,15,41
10/8/1992,6,0,15,11,32
10/9/1992,4,0,10,13,27
10/10/1992,7,0,4,13,24
10/11/1992,11,0,7,6,24
10/12/1992,12,0,10,8,30
10/13/1992,9,0,8,14,31
10/14/1992,6,0,6,4,16
10/15/1992,11,0,4,15,30
10/16/1992,7,0,12,9,28
10/17/1992,16,0,6,9,31
10/18/1992,13,0,16,13,42
10/19/1992,9,0,16,4,29
10/20/1992,13,0,15,10,38
10/21/1992,9,0,16,10,35
10/22/1992,8,0,2,12,22
10/23/1992,6,0,5,9,20
10/24/1992,7,0,9,0,16
10/25/1992,12,0,15,4,31
10/26/1992,10,0,5,13,28
10/27/1992,8,0,13,11,32
10/28/1992,12,0,6,10,28
10/29/1992,8,0,8,16,32
10/30/1992,8,0,16,15,39
10/31/1992,4,0,8,0,12
11/1/1992,5,0,16,11,32
11/2/1992,16,0,13,14,43
11/3/1992,16,0,16,4,36
11/4/1992,4,0,4,1,9
11/5/1992,11,0,16,3,30
11/6/1992,6,0,5,5,16
11/7/1992,12,0,11,10,33
11/8/1992,10,0,2,8,20
11/9/1992,6,0,2,4,12
11/10/1992,11,0,4,0,15
11/11/1992,6,0,8,13,27
11/12/1992,10,0,7,0,17
11/13/1992,7,0,10,2,19
11/14/1992,13,0,11,16,40
11/15/1992,7,0,5,8,20
11/16/1992,13,0,7,4,24
11/17/1992,8,0,13,14,35
11/18/1992,11,0,15,2,28
11/19/1992,7,0,4,12,23
11/20/1992,9,0,13,6,28
11/21/1992,7,0,2,11,20
11/22/1992,8,0,6,3,17
11/23/1992,6,0,3,10,19
11/24/1992,14,0,4,10,28
11/25/1992,13,0,12,16,41
11/26/1992,7,0,13,1,21
11/27/1992,8,0,16,11,35
11/28/1992,10,0,7,14,31
11/29/1992,12,0,14,0,26
11/30/1992,7,0,10,7,24
12/1/1992,6,0,5,14,25
12/2/1992,16,0,9,12,37
12/3/1992,12,0,5,15,32
12/4/1992,4,0,6,3,13
12/5/1992,12,0,8,13,33
12/6/1992,11,0,11,14,36
12/7/1992,11,0,9,4,24
12/8/1992,9,0,5,8,22
12/9/1992,6,0,13,13,32
12/10/1992,12,0,10,7,29
12/11/1992,10,0,7,9,26
12/12/1992,4,0,10,12,26
12/13/1992,4,0,13,10,27
12/14/1992,14,0,2,7,23
12/15/1992,15,0,6,12,33
12/16/1992,7,0,8,14,29
12/17/1992,11,0,11,10,32
12/18/1992,16,0,7,12,35
12/19/1992,10,0,8,11,29
12/20/1992,9,0,6,9,24
12/21/1992,7,0,5,11,23
12/22/1992,8,0,3,0,11
12/23/1992,8,0,5,14,27
12/24/1992,10,0,4,9,23
12/25/1992,8,0,11,15,34
12/26/1992,4,0,7,2,13
12/27/1992,10,0,13,5,28
12/28/1992,8,0,12,5,25
12/29/1992,9,0,10,12,31
12/30/1992,13,0,8,3,24
12/31/1992,8,0,4,7,19
1/1/1993,12,0,3,8,23
1/2/1993,9,0,11,2,22
1/3/1993,8,0,14,12,34
1/4/1993,11,0,7,5,23
1/5/1993,9,0,3,8,20
1/6/1993,5,0,13,2,20
1/7/1993,10,0,15,13,38
1/8/1993,8,0,7,6,21
1/9/1993,6,0,15,9,30
1/10/1993,11,0,16,13,40
1/11/1993,14,0,2,15,31
1/12/1993,4,0,4,6,14
1/13/1993,8,0,16,7,31
1/14/1993,13,0,4,0,17
1/15/1993,10,0,6,13,29
1/16/1993,16,0,4,14,34
1/17/1993,4,0,10,12,26
1/18/1993,5,0,8,5,18
1/19/1993,9,0,7,9,25
1/20/1993,14,0,2,14,30
1/21/1993,13,0,6,1,20
1/22/1993,15,0,9,11,35
1/23/1993,11,0,7,10,28
1/24/1993,14,0,13,7,34
1/25/1993,13,0,14,10,37
1/26/1993,14,0,9,16,39
1/27/1993,10,0,9,2,21
1/28/1993,4,0,12,12,28
1/29/1993,7,0,10,7,24
1/30/1993,14,0,4,12,30
1/31/1993,15,0,14,16,45
2/1/1993,4,0,10,15,29
2/2/1993,14,0,11,5,30
2/3/1993,14,0,10,14,38
2/4/1993,14,0,14,7,35
2/5/1993,16,0,9,15,40
2/6/1993,12,0,12,12,36
2/7/1993,11,0,3,8,22
2/8/1993,12,0,9,0,21
2/9/1993,13,0,10,4,27
2/10/1993,6,0,4,3,13
2/11/1993,14,0,10,0,24
2/12/1993,5,0,11,15,31
2/13/1993,15,0,16,14,45
2/14/1993,14,0,13,16,43
2/15/1993,6,0,13,3,22
2/16/1993,11,0,8,16,35
2/17/1993,13,0,8,2,23
2/18/1993,12,0,6,9,27
2/19/1993,16,0,16,1,33
2/20/1993,15,0,7,6,28
2/21/1993,16,0,10,13,39
2/22/1993,6,0,13,14,33
2/23/1993,6,0,12,12,30
2/24/1993,9,0,13,6,28
2/25/1993,10,0,8,7,25
2/26/1993,4,0,3,7,14
2/27/1993,16,0,4,15,35
2/28/1993,8,0,2,16,26
3/1/1993,9,0,5,1,15
3/2/1993,5,0,6,6,17
3/3/1993,10,0,7,7,24
3/4/1993,9,0,11,11,31
3/5/1993,5,0,6,1,12
3/6/1993,15,0,14,2,31
3/7/1993,10,0,12,2,24
3/8/1993,15,0,7,11,33
3/9/1993,4,0,13,9,26
3/10/1993,11,0,11,14,36
3/11/1993,13,0,4,4,21
3/12/1993,13,0,7,13,33
3/13/1993,13,0,16,4,33
3/14/1993,7,0,2,4,13
3/15/1993,14,0,11,15,40
3/16/1993,16,0,9,14,39
3/17/1993,12,0,3,15,30
3/18/1993,16,0,13,12,41
3/19/1993,4,0,3,3,10
3/20/1993,4,0,6,5,15
3/21/1993,16,0,7,4,27
3/22/1993,14,0,8,15,37
3/23/1993,14,0,14,1,29
3/24/1993,11,0,2,13,26
3/25/1993,13,0,4,8,25
3/26/1993,15,0,3,7,25
3/27/1993,8,0,8,0,16
3/28/1993,14,0,16,1,31
3/29/1993,14,0,14,4,32
3/30/1993,10,0,7,5,22
3/31/1993,15,0,5,0,20
4/1/1993,7,0,14,8,29
4/2/1993,7,0,6,2,15
4/3/1993,4,0,5,14,23
4/4/1993,8,0,13,2,23
4/5/1993,16,0,12,16,44
4/6/1993,15,0,6,16,37
4/7/1993,4,0,2,4,10
4/8/1993,8,0,11,12,31
4/9/1993,8,0,8,7,23
4/10/1993,8,0,8,3,19
4/11/1993,8,0,13,12,33
4/12/1993,10,0,7,9,26
4/13/1993,12,0,4,0,16
4/14/1993,10,0,15,4,29
4/15/1993,13,0,13,12,38
4/16/1993,8,0,9,8,25
4/17/1993,14,0,16,6,36
4/18/1993,4,0,15,9,28
4/19/1993,14,0,4,8,26
4/20/1993,16,0,7,15,38
4/21/1993,16,0,4,3,23
4/22/1993,10,0,16,12,38
4/23/1993,12,0,10,5,27
4/24/1993,13,0,4,1,18
4/25/1993,7,0,4,11,22
4/26/1993,15,0,6,11,32
4/27/1993,9,0,6,7,22
4/28/1993,10,0,9,9,28
4/29/1993,8,0,11,9,28
4/30/1993,5,0,2,1,8
5/1/1993,7,0,7,1,15
5/2/1993,7,0,12,15,34
5/3/1993,7,0,16,16,39
5/4/1993,7,0,14,13,34
5/5/1993,8,0,4,13,25
5/6/1993,10,0,2,13,25
5/7/1993,14,0,12,7,33
5/8/1993,10,0,6,15,31
5/9/1993,14,0,4,1,19
5/10/1993,8,0,3,11,22
5/11/1993,9,0,8,9,26
5/12/1993,11,0,7,2,20
5/13/1993,10,0,3,2,15
5/14/1993,4,0,13,0,17
5/15/1993,11,0,13,3,27
5/16/1993,9,0,7,3,19
5/17/1993,14,0,14,7,35
5/18/1993,9,0,5,13,27
5/19/1993,8,0,11,13,32
5/20/1993,10,0,7,13,30
5/21/1993,12,0,10,11,33
5/22/1993,9,0,4,9,22
5/23/1993,6,0,12,5,23
5/24/1993,5,0,3,15,23
5/25/1993,11,0,2,9,22
5/26/1993,11,0,3,16,30
5/27/1993,11,0,9,13,33
5/28/1993,5,0,4,8,17
5/29/1993,8,0,13,5,26
5/30/1993,11,0,10,9,30
5/31/1993,12,0,3,2,17
6/1/1993,8,0,13,6,27
6/2/1993,4,0,14,3,21
6/3/1993,8,0,3,13,24
6/4/1993,8,0,8,6,22
6/5/1993,4,0,6,7,17
6/6/1993,16,0,3,16,35
6/7/1993,8,0,12,1,21
6/8/1993,6,0,2,12,20
6/9/1993,14,0,3,16,33
6/10/1993,7,0,6,16,29
6/11/1993,12,0,14,0,26
6/12/1993,16,0,15,6,37
6/13/1993,4,0,13,14,31
6/14/1993,5,0,3,1,9
6/15/1993,7,0,7,15,29
6/16/1993,9,0,5,8,22
6/17/1993,13,0,13,4,30
6/18/1993,8,0,10,8,26
6/19/1993,12,0,12,8,32
6/20/1993,11,0,7,9,27
6/21/1993,9,0,3,6,18
6/22/1993,12,0,6,13,31
6/23/1993,10,0,10,2,22
6/24/1993,9,0,9,1,19
6/25/1993,9,0,3,9,21
6/26/1993,16,0,3,11,30
6/27/1993,12,0,7,16,35
6/28/1993,11,0,9,10,30
6/29/1993,14,0,10,14,38
6/30/1993,10,0,4,1,15
7/1/1993,11,0,7,0,18
7/2/1993,11,0,2,5,18
7/3/1993,14,0,16,12,42
7/4/1993,13,0,3,13,29
7/5/1993,8,0,13,15,36
7/6/1993,14,0,13,16,43
7/7/1993,16,0,14,3,33
7/8/1993,6,0,6,6,18
7/9/1993,13,0,11,10,34
7/10/1993,14,0,3,13,30
7/11/1993,16,0,3,12,31
7/12/1993,6,0,11,7,24
7/13/1993,6,0,14,8,28
7/14/1993,16,0,15,5,36
7/15/1993,16,0,9,13,38
7/16/1993,15,0,3,5,23
7/17/1993,12,0,16,4,32
7/18/1993,15,0,10,0,25
7/19/1993,14,0,13,3,30
7/20/1993,13,0,6,0,19
7/21/1993,6,0,4,0,10
7/22/1993,4,0,10,6,20
7/23/1993,10,0,13,14,37
7/24/1993,8,0,4,8,20
7/25/1993,12,0,12,1,25
7/26/1993,14,0,12,9,35
7/27/1993,4,0,10,15,29
7/28/1993,4,0,3,7,14
7/29/1993,4,0,6,6,16
7/30/1993,13,0,15,5,33
7/31/1993,4,0,8,14,26
8/1/1993,8,0,4,3,15
8/2/1993,6,0,12,10,28
8/3/1993,14,0,2,14,30
8/4/1993,10,0,5,4,19
8/5/1993,15,0,10,3,28
8/6/1993,4,0,13,6,23
8/7/1993,10,0,6,16,32
8/8/1993,11,0,6,15,32
8/9/1993,11,0,5,7,23
8/10/1993,5,0,9,12,26
8/11/1993,4,0,14,10,28
8/12/1993,6,0,9,12,27
8/13/1993,8,0,16,10,34
8/14/1993,10,0,6,15,31
8/15/1993,16,0,16,11,43
8/16/1993,8,0,15,13,36
8/17/1993,9,0,16,4,29
8/18/1993,6,0,8,15,29
8/19/1993,11,0,9,5,25
8/20/1993,11,0,11,4,26
8/21/1993,8,0,3,3,14
8/22/1993,10,0,13,6,29
8/23/1993,16,0,6,5,27
8/24/1993,7,0,5,11,23
8/25/1993,15,0,12,7,34
8/26/1993,9,0,11,0,20
8/27/1993,4,0,16,1,21
8/28/1993,12,0,5,8,25
8/29/1993,10,0,13,13,36
8/30/1993,12,0,14,14,40
8/31/1993,4,0,6,4,14
9/1/1993,8,0,14,16,38
9/2/1993,9,0,6,6,21
9/3/1993,5,0,16,9,30
9/4/1993,9,0,13,12,34
9/5/1993,7,0,10,0,17
9/6/1993,14,0,9,0,23
9/7/1993,13,0,6,7,26
9/8/1993,8,0,7,4,19
9/9/1993,6,0,11,0,17
9/10/1993,16,0,4,9,29
9/11/1993,12,0,12,11,35
9/12/1993,10,0,14,4,28
9/13/1993,12,0,7,3,22
9/14/1993,10,0,15,8,33
9/15/1993,6,0,13,3,22
9/16/1993,15,0,2,16,33
9/17/1993,10,0,16,4,30
9/18/1993,16,0,11,8,35
9/19/1993,13,0,7,2,22
9/20/1993,6,0,16,16,38
9/21/1993,13,0,16,4,33
9/22/1993,11,0,14,8,33
9/23/1993,15,0,13,12,40
9/24/1993,6,0,3,8,17
9/25/1993,11,0,16,4,31
9/26/1993,6,0,8,1,15
9/27/1993,5,0,11,11,27
9/28/1993,6,0,11,3,20
9/29/1993,6,0,6,3,15
9/30/1993,15,0,7,8,30
10/1/1993,16,0,3,2,21
10/2/1993,14,0,13,5,32
10/3/1993,7,0,7,3,17
10/4/1993,9,0,12,12,33
10/5/1993,14,0,12,15,41
10/6/1993,5,0,9,5,19
10/7/1993,13,0,14,3,30
10/8/1993,9,0,3,5,17
10/9/1993,12,0,10,1,23
10/10/1993,8,0,12,9,29
10/11/1993,11,0,2,14,27
10/12/1993,11,0,3,15,29
10/13/1993,15,0,4,16,35
10/14/1993,10,0,3,7,20
10/15/1993,9,0,15,2,26
10/16/1993,12,0,8,2,22
10/17/1993,14,0,13,0,27
10/18/1993,7,0,16,3,26
10/19/1993,10,0,15,11,36
10/20/1993,4,0,6,13,23
10/21/1993,6,0,2,16,24
10/22/1993,10,0,8,7,25
10/23/1993,12,0,9,16,37
10/24/1993,13,0,5,4,22
10/25/1993,14,0,6,16,36
10/26/1993,13,0,9,1,23
10/27/1993,13,0,3,0,16
10/28/1993,12,0,10,12,34
10/29/1993,14,0,14,10,38
10/30/1993,11,0,7,7,25
10/31/1993,14,0,12,0,26
11/1/1993,11,0,12,9,32
11/2/1993,12,0,8,8,28
11/3/1993,11,0,4,16,31
11/4/1993,6,0,7,15,28
11/5/1993,16,0,10,7,33
11/6/1993,4,0,16,13,33
11/7/1993,8,0,3,4,15
11/8/1993,8,0,16,12,36
11/9/1993,11,0,12,7,30
11/10/1993,6,0,3,8,17
11/11/1993,7,0,11,2,20
11/12/1993,11,0,11,3,25
11/13/1993,7,0,7,16,30
11/14/1993,13,0,14,0,27
11/15/1993,14,0,7,13,34
11/16/1993,7,0,6,15,28
11/17/1993,13,0,7,5,25
11/18/1993,16,0,16,16,48
11/19/1993,15,0,2,16,33
11/20/1993,16,0,14,3,33
11/21/1993,13,0,9,2,24
11/22/1993,10,0,8,7,25
11/23/1993,9,0,3,3,15
11/24/1993,7,0,2,13,22
11/25/1993,14,0,3,6,23
11/26/1993,12,0,14,4,30
11/27/1993,7,0,11,12,30
11/28/1993,13,0,13,3,29
11/29/1993,16,0,10,1,27
11/30/1993,16,0,12,3,31
12/1/1993,14,0,15,9,38
12/2/1993,9,0,14,7,30
12/3/1993,10,0,4,11,25
12/4/1993,5,0,16,5,26
12/5/1993,13,0,13,9,35
12/6/1993,8,0,7,16,31
12/7/1993,16,0,12,1,29
12/8/1993,9,0,7,13,29
12/9/1993,14,0,9,15,38
12/10/1993,16,0,8,7,31
12/11/1993,15,0,3,10,28
12/12/1993,10,0,3,2,15
12/13/1993,7,0,15,5,27
12/14/1993,15,0,3,10,28
12/15/1993,12,0,7,1,20
12/16/1993,8,0,4,7,19
12/17/1993,13,0,3,1,17
12/18/1993,14,0,6,0,20
12/19/1993,6,0,4,5,15
12/20/1993,11,0,5,2,18
12/21/1993,9,0,7,4,20
12/22/1993,5,0,6,10,21
12/23/1993,5,0,16,16,37
12/24/1993,13,0,14,5,32
12/25/1993,8,0,9,16,33
12/26/1993,11,0,5,11,27
12/27/1993,4,0,4,3,11
12/28/1993,11,0,12,7,30
12/29/1993,15,0,3,8,26
12/30/1993,15,0,9,11,35
12/31/1993,4,0,6,2,12
1/1/1994,10,0,6,11,27
1/2/1994,7,0,3,11,21
1/3/1994,15,0,5,10,30
1/4/1994,13,0,6,0,19
1/5/1994,15,0,9,3,27
1/6/1994,6,0,11,5,22
1/7/1994,13,0,9,7,29
1/8/1994,16,0,15,0,31
1/9/1994,5,0,16,14,35
1/10/1994,4,0,9,8,21
1/11/1994,11,0,4,6,21
1/12/1994,8,0,6,14,28
1/13/1994,6,0,14,8,28
1/14/1994,8,0,3,13,24
1/15/1994,16,0,14,1,31
1/16/1994,12,0,16,4,32
1/17/1994,13,0,8,5,26
1/18/1994,13,0,5,7,25
1/19/1994,9,0,7,4,20
1/20/1994,10,0,15,2,27
1/21/1994,4,0,13,13,30
1/22/1994,14,0,12,13,39
1/23/1994,7,0,14,15,36
1/24/1994,4,0,3,16,23
1/25/1994,12,0,15,1,28
1/26/1994,8,0,10,1,19
1/27/1994,5,0,16,10,31
1/28/1994,15,0,2,8,25
1/29/1994,13,0,14,12,39
1/30/1994,8,0,12,6,26
1/31/1994,10,0,12,9,31
2/1/1994,9,0,3,5,17
2/2/1994,13,0,4,1,18
2/3/1994,10,0,6,1,17
2/4/1994,7,0,10,15,32
2/5/1994,15,0,7,1,23
2/6/1994,9,0,12,16,37
2/7/1994,7,0,13,6,26
2/8/1994,6,0,11,6,23
2/9/1994,10,0,16,12,38
2/10/1994,14,0,16,5,35
2/11/1994,14,0,16,9,39
2/12/1994,8,0,15,3,26
2/13/1994,14,0,10,10,34
2/14/1994,15,0,12,6,33
2/15/1994,5,0,10,15,30
2/16/1994,14,0,2,12,28
2/17/1994,15,0,12,1,28
2/18/1994,11,0,12,16,39
2/19/1994,8,0,6,13,27
2/20/1994,6,0,3,12,21
2/21/1994,13,0,7,10,30
2/22/1994,16,0,5,6,27
2/23/1994,10,0,6,12,28
2/24/1994,13,0,16,14,43
2/25/1994,8,0,10,1,19
2/26/1994,12,0,7,14,33
2/27/1994,12,0,10,9,31
2/28/1994,12,0,2,0,14
3/1/1994,7,0,9,15,31
3/2/1994,13,0,16,4,33
3/3/1994,14,0,7,0,21
3/4/1994,10,0,2,15,27
3/5/1994,14,0,8,15,37
3/6/1994,7,0,6,12,25
3/7/1994,11,0,10,13,34
3/8/1994,8,0,16,4,28
3/9/1994,6,0,11,2,19
3/10/1994,11,0,5,15,31
3/11/1994,15,0,8,16,39
3/12/1994,6,0,14,4,24
3/13/1994,13,0,16,12,41
3/14/1994,10,0,8,7,25
3/15/1994,11,0,12,11,34
3/16/1994,9,0,10,7,26
3/17/1994,10,0,14,0,24
3/18/1994,7,0,10,2,19
3/19/1994,7,0,9,13,29
3/20/1994,7,0,14,11,32
3/21/1994,12,0,4,8,24
3/22/1994,9,0,16,8,33
3/23/1994,9,0,4,15,28
3/24/1994,7,0,14,2,23
3/25/1994,15,0,7,13,35
3/26/1994,15,0,9,10,34
3/27/1994,13,0,4,7,24
3/28/1994,16,0,3,15,34
3/29/1994,6,0,4,7,17
3/30/1994,7,0,2,15,24
3/31/1994,15,0,7,16,38
4/1/1994,7,0,14,16,37
4/2/1994,7,0,16,8,31
4/3/1994,6,0,8,14,28
4/4/1994,15,0,3,2,20
4/5/1994,13,0,12,0,25
4/6/1994,5,0,9,4,18
4/7/1994,9,0,7,2,18
4/8/1994,7,0,14,12,33
4/9/1994,12,0,13,12,37
4/10/1994,10,0,9,10,29
4/11/1994,16,0,5,10,31
4/12/1994,8,0,12,16,36
4/13/1994,10,0,10,7,27
4/14/1994,10,0,15,10,35
4/15/1994,8,0,8,0,16
4/16/1994,10,0,15,10,35
4/17/1994,11,0,11,7,29
4/18/1994,7,0,2,11,20
4/19/1994,4,0,14,15,33
4/20/1994,6,0,8,14,28
4/21/1994,12,0,8,4,24
4/22/1994,10,0,11,11,32
4/23/1994,6,0,16,14,36
4/24/1994,5,0,12,16,33
4/25/1994,16,0,10,7,33
4/26/1994,13,0,7,14,34
4/27/1994,16,0,14,12,42
4/28/1994,9,0,16,13,38
4/29/1994,15,0,7,5,27
4/30/1994,7,0,10,0,17
5/1/1994,10,0,8,13,31
5/2/1994,11,0,2,4,17
5/3/1994,12,0,9,11,32
5/4/1994,9,0,14,4,27
5/5/1994,4,0,10,5,19
5/6/1994,9,0,15,0,24
5/7/1994,11,0,15,7,33
5/8/1994,15,0,6,11,32
5/9/1994,4,0,15,5,24
5/10/1994,16,0,5,14,35
5/11/1994,4,0,5,16,25
5/12/1994,14,0,8,7,29
5/13/1994,9,0,4,1,14
5/14/1994,11,0,4,6,21
5/15/1994,15,0,2,8,25
5/16/1994,9,0,2,4,15
5/17/1994,8,0,8,12,28
5/18/1994,15,0,16,6,37
5/19/1994,14,0,2,11,27
5/20/1994,8,0,2,7,17
5/21/1994,5,0,4,7,16
5/22/1994,15,0,16,2,33
5/23/1994,11,0,16,16,43
5/24/1994,4,0,13,12,29
5/25/1994,8,0,12,15,35
5/26/1994,15,0,4,4,23
5/27/1994,8,0,6,14,28
5/28/1994,10,0,5,15,30
5/29/1994,15,0,16,2,33
5/30/1994,8,0,12,10,30
5/31/1994,7,0,9,6,22
6/1/1994,6,0,10,12,28
6/2/1994,9,0,4,6,19
6/3/1994,15,0,13,3,31
6/4/1994,7,0,16,14,37
6/5/1994,13,0,8,4,25
6/6/1994,15,0,14,2,31
6/7/1994,6,0,3,13,22
6/8/1994,6,0,14,4,24
6/9/1994,12,0,12,14,38
6/10/1994,15,0,11,2,28
6/11/1994,16,0,6,11,33
6/12/1994,6,0,6,16,28
6/13/1994,4,0,2,15,21
6/14/1994,13,0,2,12,27
6/15/1994,7,0,10,15,32
6/16/1994,5,0,9,10,24
6/17/1994,14,0,14,6,34
6/18/1994,4,0,13,13,30
6/19/1994,11,0,12,5,28
6/20/1994,5,0,13,1,19
6/21/1994,9,0,5,15,29
6/22/1994,13,0,6,9,28
6/23/1994,13,0,14,7,34
6/24/1994,14,0,13,16,43
6/25/1994,7,0,7,3,17
6/26/1994,9,0,12,15,36
6/27/1994,16,0,2,6,24
6/28/1994,8,0,6,16,30
6/29/1994,6,0,9,9,24
6/30/1994,13,0,12,1,26
7/1/1994,13,0,13,5,31
7/2/1994,11,0,2,12,25
7/3/1994,4,0,15,15,34
7/4/1994,15,0,8,14,37
7/5/1994,10,0,12,15,37
7/6/1994,13,0,2,11,26
7/7/1994,15,0,7,1,23
7/8/1994,10,0,7,3,20
7/9/1994,8,0,13,3,24
7/10/1994,14,0,3,8,25
7/11/1994,4,0,11,11,26
7/12/1994,15,0,4,11,30
7/13/1994,6,0,12,5,23
7/14/1994,14,0,13,2,29
7/15/1994,14,0,8,13,35
7/16/1994,11,0,9,3,23
7/17/1994,8,0,2,2,12
7/18/1994,10,0,8,3,21
7/19/1994,14,0,11,2,27
7/20/1994,9,0,5,12,26
7/21/1994,7,0,3,1,11
7/22/1994,13,0,2,10,25
7/23/1994,6,0,6,1,13
7/24/1994,11,0,11,14,36
7/25/1994,14,0,11,13,38
7/26/1994,11,0,7,4,22
7/27/1994,5,0,13,1,19
7/28/1994,14,0,9,4,27
7/29/1994,12,0,11,10,33
7/30/1994,7,0,4,8,19
7/31/1994,6,0,12,10,28
8/1/1994,4,0,15,6,25
8/2/1994,15,0,2,15,32
8/3/1994,16,0,16,16,48
8/4/1994,7,0,14,6,27
8/5/1994,14,0,12,13,39
8/6/1994,12,0,4,1,17
8/7/1994,15,0,6,10,31
8/8/1994,16,0,14,6,36
8/9/1994,14,0,2,8,24
8/10/1994,7,0,13,1,21
8/11/1994,10,0,2,7,19
8/12/1994,8,0,5,12,25
8/13/1994,7,0,14,11,32
8/14/1994,12,0,12,3,27
8/15/1994,16,0,4,10,30
8/16/1994,11,0,12,0,23
8/17/1994,5,0,7,3,15
8/18/1994,10,0,9,2,21
8/19/1994,9,0,7,6,22
8/20/1994,13,0,16,1,30
8/21/1994,11,0,10,3,24
8/22/1994,5,0,9,3,17
8/23/1994,5,0,9,7,21
8/24/1994,8,0,7,13,28
8/25/1994,15,0,12,9,36
8/26/1994,15,0,10,14,39
8/27/1994,12,0,9,2,23
8/28/1994,12,0,9,12,33
8/29/1994,8,0,7,13,28
8/30/1994,5,0,15,14,34
8/31/1994,9,0,12,5,26
9/1/1994,11,0,14,11,36
9/2/1994,14,0,4,1,19
9/3/1994,13,0,7,7,27
9/4/1994,6,0,3,16,25
9/5/1994,10,0,3,11,24
9/6/1994,6,0,4,4,14
9/7/1994,4,0,15,8,27
9/8/1994,10,0,12,10,32
9/9/1994,7,0,2,0,9
9/10/1994,12,0,3,12,27
9/11/1994,8,0,10,9,27
9/12/1994,7,0,6,8,21
9/13/1994,15,0,16,8,39
9/14/1994,10,0,10,1,21
9/15/1994,9,0,5,11,25
9/16/1994,14,0,2,11,27
9/17/1994,15,0,8,10,33
9/18/1994,5,0,6,0,11
9/19/1994,7,0,2,4,13
9/20/1994,4,0,3,5,12
9/21/1994,13,0,2,13,28
9/22/1994,11,0,5,12,28
9/23/1994,4,0,7,4,15
9/24/1994,10,0,2,13,25
9/25/1994,11,0,5,7,23
9/26/1994,15,0,9,11,35
9/27/1994,7,0,7,5,19
9/28/1994,14,0,11,7,32
9/29/1994,15,0,15,5,35
9/30/1994,4,0,3,14,21
10/1/1994,4,0,7,4,15
10/2/1994,16,0,14,1,31
10/3/1994,15,0,15,11,41
10/4/1994,10,0,4,14,28
10/5/1994,6,0,7,15,28
10/6/1994,12,0,9,5,26
10/7/1994,12,0,3,16,31
10/8/1994,4,0,10,12,26
10/9/1994,15,0,3,4,22
10/10/1994,12,0,14,6,32
10/11/1994,10,0,13,7,30
10/12/1994,10,0,3,7,20
10/13/1994,6,0,5,3,14
10/14/1994,12,0,16,0,28
10/15/1994,6,0,3,14,23
10/16/1994,9,0,15,5,29
10/17/1994,6,0,4,3,13
10/18/1994,7,0,4,15,26
10/19/1994,12,0,5,10,27
10/20/1994,7,0,2,9,18
10/21/1994,15,0,7,8,30
10/22/1994,4,0,2,6,12
10/23/1994,11,0,14,2,27
10/24/1994,8,0,10,7,25
10/25/1994,6,0,7,7,20
10/26/1994,7,0,5,0,12
10/27/1994,10,0,10,3,23
10/28/1994,5,0,8,5,18
10/29/1994,7,0,8,4,19
10/30/1994,8,0,13,7,28
10/31/1994,13,0,10,4,27
11/1/1994,4,0,14,12,30
11/2/1994,5,0,10,0,15
11/3/1994,5,0,15,15,35
11/4/1994,11,0,16,12,39
11/5/1994,9,0,14,15,38
11/6/1994,5,0,5,9,19
11/7/1994,8,0,3,14,25
11/8/1994,6,0,8,3,17
11/9/1994,4,0,4,7,15
11/10/1994,13,0,16,7,36
11/11/1994,11,0,12,7,30
11/12/1994,11,0,13,4,28
11/13/1994,10,0,7,0,17
11/14/1994,11,0,15,13,39
11/15/1994,13,0,5,8,26
11/16/1994,4,0,14,13,31
11/17/1994,8,0,10,14,32
11/18/1994,13,0,8,0,21
11/19/1994,8,0,12,8,28
11/20/1994,10,0,11,12,33
11/21/1994,14,0,16,15,45
11/22/1994,4,0,10,16,30
11/23/1994,13,0,7,12,32
11/24/1994,16,0,11,12,39
11/25/1994,12,0,13,4,29
11/26/1994,10,0,9,0,19
11/27/1994,14,0,13,6,33
11/28/1994,11,0,9,15,35
11/29/1994,15,0,16,9,40
11/30/1994,13,0,14,14,41
12/1/1994,7,0,16,2,25
12/2/1994,13,0,16,15,44
12/3/1994,5,0,11,14,30
12/4/1994,9,0,5,1,15
12/5/1994,8,0,14,3,25
12/6/1994,7,0,4,8,19
12/7/1994,13,0,7,0,20
12/8/1994,4,0,10,2,16
12/9/1994,9,0,14,15,38
12/10/1994,15,0,4,13,32
12/11/1994,9,0,15,7,31
12/12/1994,7,0,9,7,23
12/13/1994,14,0,7,14,35
12/14/1994,11,0,13,9,33
12/15/1994,15,0,9,1,25
12/16/1994,12,0,5,5,22
12/17/1994,13,0,16,15,44
12/18/1994,7,0,5,16,28
12/19/1994,14,0,11,11,36
12/20/1994,8,0,4,9,21
12/21/1994,8,0,6,2,16
12/22/1994,9,0,15,7,31
12/23/1994,13,0,4,3,20
12/24/1994,12,0,4,3,19
12/25/1994,14,0,10,1,25
12/26/1994,6,0,6,14,26
12/27/1994,15,0,5,8,28
12/28/1994,15,0,4,10,29
12/29/1994,14,0,14,12,40
12/30/1994,11,0,14,3,28
12/31/1994,13,0,13,14,40
1/1/1995,9,0,11,5,25
1/2/1995,15,0,7,2,24
1/3/1995,15,0,11,5,31
1/4/1995,10,0,5,8,23
1/5/1995,10,0,5,5,20
1/6/1995,12,0,11,7,30
1/7/1995,8,0,5,5,18
1/8/1995,12,0,15,9,36
1/9/1995,12,0,16,7,35
1/10/1995,4,0,4,3,11
1/11/1995,6,0,7,15,28
1/12/1995,16,0,4,7,27
1/13/1995,12,0,13,10,35
1/14/1995,16,0,11,7,34
1/15/1995,15,0,2,12,29
1/16/1995,16,0,10,6,32
1/17/1995,15,0,5,16,36
1/18/1995,16,0,15,6,37
1/19/1995,5,0,10,16,31
1/20/1995,7,0,4,11,22
1/21/1995,15,0,16,6,37
1/22/1995,16,0,7,7,30
1/23/1995,11,0,8,10,29
1/24/1995,13,0,7,6,26
1/25/1995,15,0,9,3,27
1/26/1995,11,0,16,16,43
1/27/1995,5,0,12,8,25
1/28/1995,15,0,9,8,32
1/29/1995,12,0,10,11,33
1/30/1995,5,0,9,3,17
1/31/1995,9,0,5,2,16
2/1/1995,11,0,14,9,34
2/2/1995,4,0,10,7,21
2/3/1995,13,0,6,14,33
2/4/1995,11,0,3,0,14
2/5/1995,4,0,9,7,20
2/6/1995,7,0,11,0,18
2/7/1995,7,0,12,2,21
2/8/1995,5,0,11,16,32
2/9/1995,4,0,16,0,20
2/10/1995,14,0,7,15,36
2/11/1995,13,0,10,0,23
2/12/1995,4,0,12,0,16
2/13/1995,4,0,7,11,22
2/14/1995,5,0,10,15,30
2/15/1995,5,0,5,13,23
2/16/1995,14,0,5,1,20
2/17/1995,8,0,13,5,26
2/18/1995,9,0,4,2,15
2/19/1995,4,0,10,14,28
2/20/1995,13,0,7,13,33
2/21/1995,16,0,8,8,32
2/22/1995,9,0,14,4,27
2/23/1995,9,0,5,16,30
2/24/1995,12,0,6,16,34
2/25/1995,4,0,13,9,26
2/26/1995,4,0,15,2,21
2/27/1995,13,0,2,1,16
2/28/1995,9,0,13,12,34
3/1/1995,10,0,9,2,21
3/2/1995,5,0,5,1,11
3/3/1995,7,0,14,9,30
3/4/1995,5,0,8,4,17
3/5/1995,14,0,11,8,33
3/6/1995,12,0,11,5,28
3/7/1995,13,0,7,5,25
3/8/1995,13,0,14,0,27
3/9/1995,15,0,6,5,26
3/10/1995,8,0,3,14,25
3/11/1995,9,0,5,11,25
3/12/1995,10,0,12,3,25
3/13/1995,15,0,5,12,32
3/14/1995,6,0,9,1,16
3/15/1995,16,0,15,2,33
3/16/1995,16,0,6,10,32
3/17/1995,12,0,7,3,22
3/18/1995,15,0,8,2,25
3/19/1995,16,0,14,4,34
3/20/1995,12,0,9,8,29
3/21/1995,10,0,3,6,19
3/22/1995,9,0,10,3,22
3/23/1995,7,0,12,15,34
3/24/1995,6,0,6,11,23
3/25/1995,8,0,4,4,16
3/26/1995,9,0,13,2,24
3/27/1995,12,0,10,16,38
3/28/1995,12,0,4,2,18
3/29/1995,7,0,4,9,20
3/30/1995,11,0,15,13,39
3/31/1995,10,0,7,5,22
4/1/1995,7,0,12,7,26
4/2/1995,7,0,8,7,22
4/3/1995,9,0,15,1,25
4/4/1995,14,0,7,3,24
4/5/1995,14,0,14,12,40
4/6/1995,10,0,9,16,35
4/7/1995,9,0,8,13,30
4/8/1995,8,0,9,14,31
4/9/1995,11,0,2,11,24
4/10/1995,15,0,5,9,29
4/11/1995,5,0,3,7,15
4/12/1995,4,0,16,9,29
4/13/1995,12,0,2,7,21
4/14/1995,13,0,8,14,35
4/15/1995,5,0,16,16,37
4/16/1995,10,0,12,11,33
4/17/1995,5,0,3,13,21
4/18/1995,15,0,16,12,43
4/19/1995,15,0,2,2,19
4/20/1995,12,0,16,4,32
4/21/1995,8,0,2,12,22
4/22/1995,15,0,4,1,20
4/23/1995,9,0,6,6,21
4/24/1995,10,0,13,11,34
4/25/1995,7,0,5,0,12
4/26/1995,8,0,3,14,25
4/27/1995,14,0,13,15,42
4/28/1995,11,0,14,2,27
4/29/1995,16,0,12,7,35
4/30/1995,8,0,6,9,23
5/1/1995,12,0,6,11,29
5/2/1995,6,0,13,2,21
5/3/1995,8,0,3,15,26
5/4/1995,8,0,4,9,21
5/5/1995,5,0,15,4,24
5/6/1995,13,0,5,9,27
5/7/1995,4,0,3,10,17
5/8/1995,10,0,15,12,37
5/9/1995,8,0,11,16,35
5/10/1995,4,0,10,16,30
5/11/1995,14,0,7,10,31
5/12/1995,8,0,7,2,17
5/13/1995,15,0,14,14,43
5/14/1995,6,0,15,10,31
5/15/1995,5,0,9,6,20
5/16/1995,9,0,2,6,17
5/17/1995,15,0,11,14,40
5/18/1995,10,0,7,1,18
5/19/1995,11,0,2,15,28
5/20/1995,14,0,3,13,30
5/21/1995,10,0,3,5,18
5/22/1995,4,0,14,4,22
5/23/1995,13,0,8,16,37
5/24/1995,4,0,12,12,28
5/25/1995,12,0,9,2,23
5/26/1995,11,0,4,6,21
5/27/1995,10,0,5,16,31
5/28/1995,11,0,15,11,37
5/29/1995,12,0,11,3,26
5/30/1995,12,0,4,9,25
5/31/1995,11,0,8,11,30
6/1/1995,16,0,8,5,29
6/2/1995,14,0,15,15,44
6/3/1995,12,0,16,4,32
6/4/1995,15,0,16,3,34
6/5/1995,7,0,16,16,39
6/6/1995,8,0,10,4,22
6/7/1995,8,0,3,12,23
6/8/1995,5,0,7,11,23
6/9/1995,8,0,7,10,25
6/10/1995,7,0,12,0,19
6/11/1995,4,0,10,2,16
6/12/1995,9,0,4,16,29
6/13/1995,11,0,6,8,25
6/14/1995,4,0,3,4,11
6/15/1995,16,0,10,0,26
6/16/1995,10,0,5,16,31
6/17/1995,9,0,6,2,17
6/18/1995,4,0,2,15,21
6/19/1995,5,0,16,11,32
6/20/1995,5,0,15,9,29
6/21/1995,8,0,10,14,32
6/22/1995,8,0,3,4,15
6/23/1995,11,0,16,14,41
6/24/1995,6,0,8,8,22
6/25/1995,16,0,7,16,39
6/26/1995,8,0,7,7,22
6/27/1995,16,0,10,2,28
6/28/1995,15,0,12,5,32
6/29/1995,5,0,15,8,28
6/30/1995,11,0,11,4,26
7/1/1995,6,0,16,10,32
7/2/1995,7,0,9,13,29
7/3/1995,8,0,16,5,29
7/4/1995,6,0,6,15,27
7/5/1995,6,0,9,7,22
7/6/1995,15,0,2,10,27
7/7/1995,12,0,5,14,31
7/8/1995,6,0,6,9,21
7/9/1995,7,0,7,16,30
7/10/1995,14,0,13,13,40
7/11/1995,15,0,6,15,36
7/12/1995,15,0,13,12,40
7/13/1995,12,0,5,0,17
7/14/1995,6,0,12,11,29
7/15/1995,8,0,11,2,21
7/16/1995,16,0,16,0,32
7/17/1995,12,0,15,7,34
7/18/1995,9,0,9,8,26
7/19/1995,6,0,13,4,23
7/20/1995,15,0,14,4,33
7/21/1995,6,0,2,3,11
7/22/1995,12,0,7,11,30
7/23/1995,13,0,16,3,32
7/24/1995,4,0,16,8,28
7/25/1995,11,0,8,13,32
7/26/1995,8,0,13,8,29
7/27/1995,16,0,14,5,35
7/28/1995,14,0,3,16,33
7/29/1995,12,0,4,13,29
7/30/1995,8,0,2,0,10
7/31/1995,7,0,7,1,15
8/1/1995,13,0,11,4,28
8/2/1995,8,0,13,2,23
8/3/1995,8,0,3,3,14
8/4/1995,5,0,16,5,26
8/5/1995,16,0,12,1,29
8/6/1995,15,0,15,5,35
8/7/1995,7,0,11,15,33
8/8/1995,11,0,2,7,20
8/9/1995,9,0,4,2,15
8/10/1995,7,0,16,3,26
8/11/1995,5,0,6,11,22
8/12/1995,14,0,7,4,25
8/13/1995,15,0,15,3,33
8/14/1995,10,0,4,5,19
8/15/1995,5,0,4,2,11
8/16/1995,8,0,14,12,34
8/17/1995,8,0,12,15,35
8/18/1995,14,0,7,5,26
8/19/1995,9,0,2,10,21
8/20/1995,10,0,2,0,12
8/21/1995,12,0,13,15,40
8/22/1995,16,0,12,1,29
8/23/1995,14,0,14,8,36
8/24/1995,8,0,2,15,25
8/25/1995,11,0,14,9,34
8/26/1995,16,0,12,0,28
8/27/1995,12,0,16,3,31
8/28/1995,14,0,10,8,32
8/29/1995,16,0,9,15,40
8/30/1995,8,0,3,1,12
8/31/1995,8,0,3,11,22
9/1/1995,8,0,3,11,22
9/2/1995,5,0,9,15,29
9/3/1995,15,0,10,7,32
9/4/1995,10,0,4,15,29
9/5/1995,11,0,2,3,16
9/6/1995,15,0,10,9,34
9/7/1995,16,0,12,2,30
9/8/1995,7,0,9,0,16
9/9/1995,10,0,14,1,25
9/10/1995,13,0,10,11,34
9/11/1995,5,0,5,13,23
9/12/1995,4,0,10,15,29
9/13/1995,6,0,12,11,29
9/14/1995,13,0,9,2,24
9/15/1995,14,0,14,3,31
9/16/1995,9,0,3,6,18
9/17/1995,5,0,8,10,23
9/18/1995,8,0,6,4,18
9/19/1995,15,0,8,13,36
9/20/1995,12,0,11,8,31
9/21/1995,16,0,11,7,34
9/22/1995,13,0,16,0,29
9/23/1995,8,0,2,10,20
9/24/1995,5,0,4,13,22
9/25/1995,14,0,8,10,32
9/26/1995,7,0,16,16,39
9/27/1995,4,0,7,3,14
9/28/1995,8,0,6,8,22
9/29/1995,7,0,5,16,28
9/30/1995,5,0,11,8,24
10/1/1995,8,0,11,13,32
10/2/1995,12,0,16,7,35
10/3/1995,16,0,11,10,37
10/4/1995,11,0,7,12,30
10/5/1995,8,0,11,14,33
10/6/1995,10,0,10,1,21
10/7/1995,8,0,15,6,29
10/8/1995,8,0,16,9,33
10/9/1995,9,0,9,1,19
10/10/1995,13,0,6,7,26
10/11/1995,10,0,12,2,24
10/12/1995,7,0,10,2,19
10/13/1995,14,0,16,1,31
10/14/1995,5,0,6,8,19
10/15/1995,9,0,13,5,27
10/16/1995,8,0,6,13,27
10/17/1995,13,0,14,7,34
10/18/1995,11,0,5,6,22
10/19/1995,8,0,3,1,12
10/20/1995,8,0,15,9,32
10/21/1995,14,0,2,6,22
10/22/1995,4,0,15,8,27
10/23/1995,16,0,12,12,40
10/24/1995,16,0,11,10,37
10/25/1995,15,0,4,0,19
10/26/1995,13,0,8,2,23
10/27/1995,13,0,14,11,38
10/28/1995,8,0,15,16,39
10/29/1995,7,0,11,16,34
10/30/1995,11,0,7,11,29
10/31/1995,14,0,11,8,33
11/1/1995,15,0,7,4,26
11/2/1995,13,0,3,9,25
11/3/1995,5,0,11,13,29
11/4/1995,5,0,16,15,36
11/5/1995,7,0,16,1,24
11/6/1995,10,0,4,6,20
11/7/1995,14,0,2,10,26
11/8/1995,8,0,15,12,35
11/9/1995,16,0,10,12,38
11/10/1995,16,0,9,14,39
11/11/1995,13,0,5,16,34
11/12/1995,13,0,7,6,26
11/13/1995,15,0,16,2,33
11/14/1995,13,0,11,3,27
11/15/1995,15,0,2,0,17
11/16/1995,11,0,5,0,16
11/17/1995,9,0,8,4,21
11/18/1995,14,0,9,8,31
11/19/1995,11,0,12,11,34
11/20/1995,8,0,4,10,22
11/21/1995,16,0,8,14,38
11/22/1995,15,0,11,4,30
11/23/1995,6,0,2,6,14
11/24/1995,4,0,11,7,22
11/25/1995,4,0,13,3,20
11/26/1995,9,0,6,14,29
11/27/1995,10,0,14,13,37
11/28/1995,6,0,2,10,18
11/29/1995,15,0,4,5,24
11/30/1995,7,0,3,6,16
12/1/1995,10,0,10,12,32
12/2/1995,12,0,14,4,30
12/3/1995,12,0,16,14,42
12/4/1995,6,0,9,3,18
12/5/1995,9,0,10,16,35
12/6/1995,11,0,13,7,31
12/7/1995,9,0,14,11,34
12/8/1995,8,0,3,10,21
12/9/1995,10,0,14,14,38
12/10/1995,5,0,16,15,36
12/11/1995,8,0,8,1,17
12/12/1995,4,0,14,3,21
12/13/1995,9,0,5,9,23
12/14/1995,8,0,15,0,23
12/15/1995,14,0,13,7,34
12/16/1995,6,0,4,14,24
12/17/1995,14,0,14,0,28
12/18/1995,11,0,2,15,28
12/19/1995,8,0,5,11,24
12/20/1995,5,0,8,5,18
12/21/1995,6,0,4,2,12
12/22/1995,6,0,16,8,30
12/23/1995,5,0,15,1,21
12/24/1995,4,0,8,13,25
12/25/1995,5,0,10,5,20
12/26/1995,10,0,6,2,18
12/27/1995,15,0,7,6,28
12/28/1995,8,0,7,16,31
12/29/1995,16,0,6,3,25
12/30/1995,8,0,4,13,25
12/31/1995,16,0,8,7,31
1/1/1996,16,0,3,2,21
1/2/1996,4,0,4,16,24
1/3/1996,8,0,8,7,23
1/4/1996,9,0,2,9,20
1/5/1996,4,0,9,8,21
1/6/1996,12,0,15,16,43
1/7/1996,11,0,16,8,35
1/8/1996,11,0,16,8,35
1/9/1996,11,0,9,11,31
1/10/1996,8,0,2,13,23
1/11/1996,9,0,14,5,28
1/12/1996,15,0,12,2,29
1/13/1996,5,0,2,1,8
1/14/1996,8,0,16,4,28
1/15/1996,9,0,8,13,30
1/16/1996,6,0,7,0,13
1/17/1996,11,0,15,2,28
1/18/1996,8,0,9,9,26
1/19/1996,6,0,2,5,13
1/20/1996,7,0,14,14,35
1/21/1996,14,0,9,2,25
1/22/1996,5,0,6,10,21
1/23/1996,13,0,16,5,34
1/24/1996,15,0,4,10,29
1/25/1996,10,0,16,0,26
1/26/1996,5,0,13,8,26
1/27/1996,9,0,13,16,38
1/28/1996,11,0,8,5,24
1/29/1996,13,0,2,1,16
1/30/1996,11,0,7,10,28
1/31/1996,12,0,2,12,26
2/1/1996,14,0,14,1,29
2/2/1996,13,0,4,12,29
2/3/1996,4,0,2,13,19
2/4/1996,16,0,8,3,27
2/5/1996,4,0,2,16,22
2/6/1996,4,0,9,4,17
2/7/1996,4,0,4,9,17
2/8/1996,10,0,13,12,35
2/9/1996,8,0,3,0,11
2/10/1996,6,0,2,13,21
2/11/1996,12,0,7,0,19
2/12/1996,4,0,14,7,25
2/13/1996,8,0,11,6,25
2/14/1996,4,0,7,15,26
2/15/1996,9,0,6,3,18
2/16/1996,11,0,5,0,16
2/17/1996,11,0,8,11,30
2/18/1996,16,0,9,2,27
2/19/1996,15,0,4,0,19
2/20/1996,4,0,15,12,31
2/21/1996,5,0,6,9,20
2/22/1996,11,0,9,6,26
2/23/1996,9,0,11,12,32
2/24/1996,12,0,5,14,31
2/25/1996,13,0,15,4,32
2/26/1996,15,0,15,9,39
2/27/1996,7,0,12,3,22
2/28/1996,13,0,6,10,29
2/29/1996,11,0,3,6,20
3/1/1996,12,0,14,8,34
3/2/1996,7,0,10,8,25
3/3/1996,8,0,15,4,27
3/4/1996,11,0,13,6,30
3/5/1996,6,0,12,2,20
3/6/1996,8,0,9,7,24
3/7/1996,14,0,13,3,30
3/8/1996,8,0,14,14,36
3/9/1996,6,0,5,8,19
3/10/1996,10,0,4,10,24
3/11/1996,11,0,7,15,33
3/12/1996,12,0,4,15,31
3/13/1996,14,0,6,10,30
3/14/1996,12,0,10,6,28
3/15/1996,5,0,10,10,25
3/16/1996,10,0,11,14,35
3/17/1996,8,0,9,12,29
3/18/1996,8,0,10,0,18
3/19/1996,13,0,2,16,31
3/20/1996,5,0,7,12,24
3/21/1996,12,0,12,10,34
3/22/1996,6,0,3,11,20
3/23/1996,14,0,2,1,17
3/24/1996,14,0,9,4,27
3/25/1996,8,0,11,10,29
3/26/1996,9,0,11,7,27
3/27/1996,8,0,11,7,26
3/28/1996,11,0,16,8,35
3/29/1996,15,0,14,3,32
3/30/1996,15,0,12,14,41
3/31/1996,13,0,7,10,30
4/1/1996,6,0,6,1,13
4/2/1996,8,0,11,6,25
4/3/1996,16,0,4,9,29
4/4/1996,12,0,7,5,24
4/5/1996,12,0,10,8,30
4/6/1996,15,0,14,11,40
4/7/1996,11,0,13,9,33
4/8/1996,14,0,16,13,43
4/9/1996,13,0,11,15,39
4/10/1996,4,0,5,13,22
4/11/1996,9,0,3,4,16
4/12/1996,7,0,13,4,24
4/13/1996,13,0,11,4,28
4/14/1996,11,0,5,9,25
4/15/1996,8,0,3,16,27
4/16/1996,4,0,16,11,31
4/17/1996,13,0,15,7,35
4/18/1996,11,0,9,16,36
4/19/1996,5,0,11,13,29
4/20/1996,7,0,16,11,34
4/21/1996,16,0,3,14,33
4/22/1996,9,0,4,5,18
4/23/1996,10,0,12,1,23
4/24/1996,12,0,10,12,34
4/25/1996,11,0,9,14,34
4/26/1996,13,0,10,0,23
4/27/1996,14,0,6,9,29
4/28/1996,11,0,13,2,26
4/29/1996,8,0,3,2,13
4/30/1996,8,0,12,0,20
5/1/1996,11,0,4,4,19
5/2/1996,11,0,7,7,25
5/3/1996,13,0,12,8,33
5/4/1996,6,0,4,10,20
5/5/1996,10,0,11,3,24
5/6/1996,11,0,16,1,28
5/7/1996,5,0,3,6,14
5/8/1996,9,0,6,13,28
5/9/1996,11,0,9,14,34
5/10/1996,7,0,8,12,27
5/11/1996,15,0,11,9,35
5/12/1996,15,0,4,14,33
5/13/1996,10,0,9,12,31
5/14/1996,6,0,13,10,29
5/15/1996,7,0,11,10,28
5/16/1996,7,0,7,0,14
5/17/1996,8,0,6,0,14
5/18/1996,15,0,15,13,43
5/19/1996,7,0,2,7,16
5/20/1996,9,0,3,15,27
5/21/1996,15,0,6,3,24
5/22/1996,16,0,16,0,32
5/23/1996,16,0,8,10,34
5/24/1996,4,0,10,5,19
5/25/1996,13,0,4,3,20
5/26/1996,5,0,8,6,19
5/27/1996,15,0,11,13,39
5/28/1996,15,0,8,1,24
5/29/1996,6,0,10,3,19
5/30/1996,10,0,12,4,26
5/31/1996,9,0,16,13,38
6/1/1996,16,0,16,13,45
6/2/1996,14,0,6,1,21
6/3/1996,7,0,13,3,23
6/4/1996,14,0,15,4,33
6/5/1996,11,0,15,3,29
6/6/1996,11,0,13,1,25
6/7/1996,13,0,2,3,18
6/8/1996,10,0,13,10,33
6/9/1996,16,0,4,8,28
6/10/1996,14,0,14,6,34
6/11/1996,11,0,13,9,33
6/12/1996,14,0,9,12,35
6/13/1996,16,0,4,13,33
6/14/1996,5,0,13,4,22
6/15/1996,10,0,13,16,39
6/16/1996,11,0,12,5,28
6/17/1996,10,0,15,10,35
6/18/1996,4,0,4,16,24
6/19/1996,9,0,14,15,38
6/20/1996,7,0,14,4,25
6/21/1996,5,0,14,15,34
6/22/1996,9,0,14,3,26
6/23/1996,16,0,16,7,39
6/24/1996,8,0,11,3,22
6/25/1996,10,0,3,11,24
6/26/1996,4,0,5,6,15
6/27/1996,12,0,13,9,34
6/28/1996,5,0,8,4,17
6/29/1996,11,0,11,0,22
6/30/1996,9,0,5,13,27
7/1/1996,6,0,9,1,16
7/2/1996,6,0,5,8,19
7/3/1996,6,0,11,16,33
7/4/1996,14,0,13,15,42
7/5/1996,8,0,10,14,32
7/6/1996,13,0,11,5,29
7/7/1996,13,0,3,10,26
7/8/1996,16,0,6,8,30
7/9/1996,15,0,10,4,29
7/10/1996,11,0,3,12,26
7/11/1996,5,0,2,11,18
7/12/1996,10,0,10,14,34
7/13/1996,4,0,16,8,28
7/14/1996,5,0,16,1,22
7/15/1996,14,0,12,6,32
7/16/1996,10,0,7,1,18
7/17/1996,8,0,3,1,12
7/18/1996,4,0,6,2,12
7/19/1996,12,0,7,2,21
7/20/1996,7,0,11,11,29
7/21/1996,4,0,3,9,16
7/22/1996,14,0,15,7,36
7/23/1996,11,0,3,16,30
7/24/1996,10,0,5,3,18
7/25/1996,8,0,9,7,24
7/26/1996,8,0,5,3,16
7/27/1996,12,0,12,7,31
7/28/1996,16,0,8,7,31
7/29/1996,6,0,8,0,14
7/30/1996,11,0,4,5,20
7/31/1996,5,0,2,7,14
8/1/1996,12,0,4,7,23
8/2/1996,7,0,12,15,34
8/3/1996,7,0,12,0,19
8/4/1996,4,0,15,10,29
8/5/1996,13,0,15,6,34
8/6/1996,8,0,12,1,21
8/7/1996,9,0,4,7,20
8/8/1996,16,0,12,14,42
8/9/1996,9,0,4,10,23
8/10/1996,10,0,9,0,19
8/11/1996,11,0,8,16,35
8/12/1996,12,0,10,6,28
8/13/1996,8,0,6,12,26
8/14/1996,13,0,13,6,32
8/15/1996,9,0,16,11,36
8/16/1996,15,0,11,15,41
8/17/1996,8,0,3,8,19
8/18/1996,14,0,10,13,37
8/19/1996,15,0,12,3,30
8/20/1996,5,0,9,2,16
8/21/1996,9,0,8,5,22
8/22/1996,12,0,2,15,29
8/23/1996,16,0,11,14,41
8/24/1996,7,0,5,6,18
8/25/1996,10,0,4,15,29
8/26/1996,5,0,10,3,18
8/27/1996,11,0,9,3,23
8/28/1996,11,0,8,7,26
8/29/1996,13,0,16,8,37
8/30/1996,4,0,15,4,23
8/31/1996,12,0,8,10,30
9/1/1996,13,0,5,13,31
9/2/1996,13,0,16,11,40
9/3/1996,14,0,15,6,35
9/4/1996,13,0,3,8,24
9/5/1996,4,0,2,5,11
9/6/1996,6,0,2,3,11
9/7/1996,8,0,11,15,34
9/8/1996,8,0,4,5,17
9/9/1996,7,0,10,1,18
9/10/1996,15,0,6,3,24
9/11/1996,9,0,9,13,31
9/12/1996,6,0,11,5,22
9/13/1996,10,0,7,5,22
9/14/1996,13,0,9,3,25
9/15/1996,5,0,11,9,25
9/16/1996,5,0,11,15,31
9/17/1996,13,0,7,7,27
9/18/1996,4,0,10,5,19
9/19/1996,5,0,4,12,21
9/20/1996,13,0,14,13,40
9/21/1996,14,0,9,6,29
9/22/1996,5,0,10,6,21
9/23/1996,4,0,8,6,18
9/24/1996,15,0,15,11,41
9/25/1996,8,0,2,12,22
9/26/1996,5,0,2,8,15
9/27/1996,16,0,13,4,33
9/28/1996,9,0,4,12,25
9/29/1996,16,0,14,1,31
9/30/1996,7,0,13,0,20
10/1/1996,11,0,4,11,26
10/2/1996,16,0,13,15,44
10/3/1996,11,0,3,15,29
10/4/1996,14,0,9,11,34
10/5/1996,13,0,16,10,39
10/6/1996,16,0,12,0,28
10/7/1996,6,0,9,3,18
10/8/1996,5,0,12,4,21
10/9/1996,4,0,16,11,31
10/10/1996,8,0,15,16,39
10/11/1996,12,0,8,0,20
10/12/1996,15,0,7,0,22
10/13/1996,6,0,12,2,20
10/14/1996,13,0,12,4,29
10/15/1996,10,0,5,11,26
10/16/1996,6,0,12,6,24
10/17/1996,9,0,5,15,29
10/18/1996,15,0,12,9,36
10/19/1996,16,0,12,7,35
10/20/1996,5,0,13,6,24
10/21/1996,10,0,8,6,24
10/22/1996,16,0,15,2,33
10/23/1996,11,0,12,0,23
10/24/1996,15,0,9,6,30
10/25/1996,16,0,12,2,30
10/26/1996,16,0,4,0,20
10/27/1996,7,0,2,5,14
10/28/1996,10,0,12,12,34
10/29/1996,11,0,9,7,27
10/30/1996,13,0,13,5,31
10/31/1996,10,0,12,13,35
11/1/1996,9,0,4,5,18
11/2/1996,4,0,14,1,19
11/3/1996,10,0,2,0,12
11/4/1996,7,0,4,14,25
11/5/1996,12,0,10,15,37
11/6/1996,15,0,9,8,32
11/7/1996,7,0,12,13,32
11/8/1996,4,0,14,2,20
11/9/1996,8,0,16,0,24
11/10/1996,5,0,11,2,18
11/11/1996,15,0,5,2,22
11/12/1996,16,0,4,6,26
11/13/1996,11,0,5,5,21
11/14/1996,11,0,12,11,34
11/15/1996,4,0,16,14,34
11/16/1996,13,0,14,15,42
11/17/1996,6,0,2,6,14
11/18/1996,6,0,14,4,24
11/19/1996,13,0,14,14,41
11/20/1996,12,0,6,5,23
11/21/1996,11,0,9,1,21
11/22/1996,10,0,16,5,31
11/23/1996,12,0,11,16,39
11/24/1996,16,0,13,4,33
11/25/1996,8,0,4,14,26
11/26/1996,5,0,11,9,25
11/27/1996,7,0,13,7,27
11/28/1996,9,0,16,1,26
11/29/1996,6,0,9,12,27
11/30/1996,14,0,4,1,19
12/1/1996,7,0,14,2,23
12/2/1996,6,0,15,7,28
12/3/1996,9,0,9,0,18
12/4/1996,4,0,2,1,7
12/5/1996,8,0,3,11,22
12/6/1996,4,0,6,7,17
12/7/1996,7,0,15,4,26
12/8/1996,14,0,4,7,25
12/9/1996,14,0,12,15,41
12/10/1996,10,0,10,15,35
12/11/1996,9,0,9,13,31
12/12/1996,4,0,8,10,22
12/13/1996,6,0,12,3,21
12/14/1996,10,0,4,16,30
12/15/1996,9,0,4,9,22
12/16/1996,12,0,7,12,31
12/17/1996,11,0,3,13,27
12/18/1996,7,0,3,16,26
12/19/1996,14,0,11,11,36
12/20/1996,15,0,4,5,24
12/21/1996,15,0,7,13,35
12/22/1996,13,0,15,8,36
12/23/1996,6,0,9,11,26
12/24/1996,8,0,10,12,30
12/25/1996,6,0,3,15,24
12/26/1996,16,0,8,15,39
12/27/1996,7,0,7,3,17
12/28/1996,8,0,2,0,10
12/29/1996,12,0,6,5,23
12/30/1996,15,0,4,9,28
12/31/1996,12,0,12,15,39
1/1/1997,4,0,11,6,21
1/2/1997,12,0,9,12,33
1/3/1997,6,0,10,1,17
1/4/1997,12,0,14,13,39
1/5/1997,7,0,7,5,19
1/6/1997,11,0,8,10,29
1/7/1997,8,0,16,7,31
1/8/1997,11,0,14,12,37
1/9/1997,10,0,11,7,28
1/10/1997,12,0,15,0,27
1/11/1997,16,0,9,1,26
1/12/1997,14,0,2,9,25
1/13/1997,12,0,12,6,30
1/14/1997,11,0,13,15,39
1/15/1997,13,0,4,2,19
1/16/1997,15,0,3,3,21
1/17/1997,13,0,9,5,27
1/18/1997,4,0,5,3,12
1/19/1997,16,0,15,2,33
1/20/1997,11,0,5,4,20
1/21/1997,16,0,15,10,41
1/22/1997,16,0,10,0,26
1/23/1997,14,0,9,15,38
1/24/1997,4,0,15,1,20
1/25/1997,14,0,6,16,36
1/26/1997,10,0,10,10,30
1/27/1997,10,0,2,0,12
1/28/1997,8,0,9,12,29
1/29/1997,6,0,10,13,29
1/30/1997,6,0,4,4,14
1/31/1997,8,0,5,3,16
2/1/1997,5,0,6,12,23
2/2/1997,13,0,4,16,33
2/3/1997,14,0,3,12,29
2/4/1997,13,0,10,8,31
2/5/1997,13,0,2,8,23
2/6/1997,5,0,12,5,22
2/7/1997,4,0,2,3,9
2/8/1997,11,0,4,14,29
2/9/1997,7,0,9,15,31
2/10/1997,15,0,6,16,37
2/11/1997,11,0,11,11,33
2/12/1997,5,0,4,5,14
2/13/1997,6,0,6,13,25
2/14/1997,4,0,14,16,34
2/15/1997,11,0,4,4,19
2/16/1997,16,0,3,16,35
2/17/1997,5,0,7,12,24
2/18/1997,15,0,16,7,38
2/19/1997,10,0,3,15,28
2/20/1997,14,0,15,15,44
2/21/1997,15,0,3,5,23
2/22/1997,12,0,9,0,21
2/23/1997,9,0,9,10,28
2/24/1997,9,0,11,10,30
2/25/1997,12,0,11,11,34
2/26/1997,15,0,3,6,24
2/27/1997,12,0,14,6,32
2/28/1997,6,0,5,2,13
3/1/1997,10,0,10,9,29
3/2/1997,14,0,5,10,29
3/3/1997,12,0,11,6,29
3/4/1997,16,0,7,0,23
3/5/1997,4,0,10,4,18
3/6/1997,6,0,6,1,13
3/7/1997,10,0,16,16,42
3/8/1997,10,0,14,4,28
3/9/1997,15,0,6,2,23
3/10/1997,6,0,11,15,32
3/11/1997,6,0,11,3,20
3/12/1997,6,0,9,6,21
3/13/1997,9,0,12,11,32
3/14/1997,6,0,7,5,18
3/15/1997,7,0,10,7,24
3/16/1997,6,0,7,3,16
3/17/1997,12,0,11,3,26
3/18/1997,14,0,2,9,25
3/19/1997,11,0,6,13,30
3/20/1997,9,0,16,0,25
3/21/1997,10,0,11,0,21
3/22/1997,7,0,16,0,23
3/23/1997,8,0,16,5,29
3/24/1997,8,0,16,6,30
3/25/1997,13,0,5,12,30
3/26/1997,14,0,14,5,33
3/27/1997,8,0,9,7,24
3/28/1997,14,0,5,9,28
3/29/1997,8,0,5,6,19
3/30/1997,12,0,5,1,18
3/31/1997,11,0,9,13,33
4/1/1997,8,0,6,4,18
4/2/1997,7,0,10,8,25
4/3/1997,12,0,4,15,31
4/4/1997,14,0,2,8,24
4/5/1997,8,0,14,13,35
4/6/1997,6,0,6,16,28
4/7/1997,9,0,11,15,35
4/8/1997,12,0,2,16,30
4/9/1997,11,0,15,1,27
4/10/1997,14,0,12,0,26
4/11/1997,11,0,6,4,21
4/12/1997,13,0,7,10,30
4/13/1997,9,0,5,2,16
4/14/1997,13,0,15,2,30
4/15/1997,12,0,13,0,25
4/16/1997,7,0,7,4,18
4/17/1997,15,0,10,5,30
4/18/1997,8,0,5,1,14
4/19/1997,10,0,5,1,16
4/20/1997,8,0,16,12,36
4/21/1997,13,0,15,12,40
4/22/1997,9,0,10,9,28
4/23/1997,15,0,10,4,29
4/24/1997,15,0,2,13,30
4/25/1997,12,0,10,15,37
4/26/1997,5,0,16,1,22
4/27/1997,10,0,5,1,16
4/28/1997,5,0,16,1,22
4/29/1997,14,0,8,7,29
4/30/1997,5,0,7,12,24
5/1/1997,4,0,10,5,19
5/2/1997,12,0,4,4,20
5/3/1997,16,0,10,15,41
5/4/1997,11,0,8,10,29
5/5/1997,15,0,13,14,42
5/6/1997,16,0,4,4,24
5/7/1997,8,0,15,5,28
5/8/1997,6,0,6,9,21
5/9/1997,15,0,4,2,21
5/10/1997,7,0,3,0,10
5/11/1997,9,0,16,2,27
5/12/1997,14,0,11,10,35
5/13/1997,16,0,14,6,36
5/14/1997,12,0,12,14,38
5/15/1997,10,0,7,6,23
5/16/1997,15,0,9,2,26
5/17/1997,14,0,8,12,34
5/18/1997,7,0,6,16,29
5/19/1997,11,0,12,8,31
5/20/1997,14,0,6,3,23
5/21/1997,13,0,13,11,37
5/22/1997,6,0,14,9,29
5/23/1997,4,0,15,4,23
5/24/1997,6,0,11,3,20
5/25/1997,7,0,13,5,25
5/26/1997,6,0,12,8,26
5/27/1997,11,0,4,8,23
5/28/1997,11,0,11,16,38
5/29/1997,8,0,2,2,12
5/30/1997,8,0,16,5,29
5/31/1997,12,0,12,4,28
6/1/1997,9,0,15,16,40
6/2/1997,5,0,8,10,23
6/3/1997,14,0,5,6,25
6/4/1997,11,0,11,4,26
6/5/1997,8,0,13,14,35
6/6/1997,6,0,6,9,21
6/7/1997,16,0,15,12,43
6/8/1997,13,0,11,10,34
6/9/1997,16,0,4,16,36
6/10/1997,12,0,8,10,30
6/11/1997,11,0,15,3,29
6/12/1997,8,0,2,6,16
6/13/1997,12,0,10,3,25
6/14/1997,6,0,4,10,20
6/15/1997,14,0,10,14,38
6/16/1997,4,0,6,8,18
6/17/1997,6,0,8,9,23
6/18/1997,9,0,4,13,26
6/19/1997,6,0,12,16,34
6/20/1997,12,0,4,3,19
6/21/1997,9,0,11,12,32
6/22/1997,10,0,14,13,37
6/23/1997,7,0,16,16,39
6/24/1997,14,0,11,11,36
6/25/1997,11,0,13,11,35
6/26/1997,8,0,7,0,15
6/27/1997,9,0,12,10,31
6/28/1997,6,0,8,5,19
6/29/1997,12,0,7,14,33
6/30/1997,15,0,4,16,35
7/1/1997,6,0,10,11,27
7/2/1997,5,0,14,1,20
7/3/1997,16,0,16,8,40
7/4/1997,10,0,5,3,18
7/5/1997,4,0,4,5,13
7/6/1997,7,0,14,4,25
7/7/1997,6,0,3,2,11
7/8/1997,9,0,10,4,23
7/9/1997,6,0,3,10,19
7/10/1997,15,0,2,5,22
7/11/1997,11,0,2,1,14
7/12/1997,11,0,16,0,27
7/13/1997,8,0,7,2,17
7/14/1997,13,0,6,13,32
7/15/1997,15,0,8,0,23
7/16/1997,10,0,16,10,36
7/17/1997,16,0,3,3,22
7/18/1997,7,0,16,14,37
7/19/1997,10,0,11,11,32
7/20/1997,5,0,9,5,19
7/21/1997,4,0,11,12,27
7/22/1997,7,0,11,11,29
7/23/1997,11,0,13,9,33
7/24/1997,15,0,5,15,35
7/25/1997,6,0,14,2,22
7/26/1997,13,0,14,12,39
7/27/1997,9,0,16,0,25
7/28/1997,8,0,9,1,18
7/29/1997,12,0,10,1,23
7/30/1997,7,0,4,1,12
7/31/1997,15,0,13,0,28
8/1/1997,4,0,6,11,21
8/2/1997,8,0,15,7,30
8/3/1997,4,0,2,0,6
8/4/1997,15,0,2,4,21
8/5/1997,5,0,6,11,22
8/6/1997,15,0,16,9,40
8/7/1997,14,0,12,0,26
8/8/1997,15,0,15,15,45
8/9/1997,10,0,10,4,24
8/10/1997,16,0,14,5,35
8/11/1997,14,0,16,0,30
8/12/1997,10,0,3,11,24
8/13/1997,15,0,11,7,33
8/14/1997,11,0,15,15,41
8/15/1997,14,0,4,7,25
8/16/1997,5,0,5,4,14
8/17/1997,6,0,7,14,27
8/18/1997,16,0,14,13,43
8/19/1997,8,0,3,7,18
8/20/1997,7,0,3,0,10
8/21/1997,10,0,10,5,25
8/22/1997,6,0,5,0,11
8/23/1997,10,0,3,0,13
8/24/1997,5,0,13,12,30
8/25/1997,15,0,10,3,28
8/26/1997,12,0,4,13,29
8/27/1997,4,0,6,1,11
8/28/1997,4,0,2,11,17
8/29/1997,7,0,4,8,19
8/30/1997,12,0,10,14,36
8/31/1997,12,0,11,9,32
9/1/1997,5,0,13,2,20
9/2/1997,5,0,10,0,15
9/3/1997,11,0,16,3,30
9/4/1997,15,0,16,6,37
9/5/1997,15,0,15,2,32
9/6/1997,5,0,16,2,23
9/7/1997,15,0,14,12,41
9/8/1997,9,0,9,12,30
9/9/1997,5,0,6,5,16
9/10/1997,10,0,13,7,30
9/11/1997,7,0,3,5,15
9/12/1997,16,0,9,13,38
9/13/1997,9,0,5,10,24
9/14/1997,13,0,14,0,27
9/15/1997,15,0,3,16,34
9/16/1997,12,0,5,8,25
9/17/1997,7,0,12,13,32
9/18/1997,8,0,15,11,34
9/19/1997,11,0,7,2,20
9/20/1997,8,0,8,13,29
9/21/1997,10,0,2,7,19
9/22/1997,11,0,16,14,41
9/23/1997,11,0,3,16,30
9/24/1997,16,0,2,12,30
9/25/1997,7,0,12,11,30
9/26/1997,11,0,14,9,34
9/27/1997,9,0,12,0,21
9/28/1997,11,0,11,15,37
9/29/1997,4,0,13,11,28
9/30/1997,13,0,14,12,39
10/1/1997,4,0,10,13,27
10/2/1997,8,0,9,9,26
10/3/1997,15,0,15,0,30
10/4/1997,14,0,5,14,33
10/5/1997,8,0,11,6,25
10/6/1997,6,0,14,10,30
10/7/1997,13,0,12,14,39
10/8/1997,13,0,13,14,40
10/9/1997,9,0,15,6,30
10/10/1997,13,0,6,11,30
10/11/1997,9,0,11,7,27
10/12/1997,12,0,2,2,16
10/13/1997,14,0,9,12,35
10/14/1997,8,0,11,0,19
10/15/1997,7,0,9,0,16
10/16/1997,11,0,16,10,37
10/17/1997,8,0,7,9,24
10/18/1997,16,0,13,6,35
10/19/1997,15,0,15,2,32
10/20/1997,4,0,12,13,29
10/21/1997,14,0,14,7,35
10/22/1997,4,0,11,16,31
10/23/1997,7,0,6,10,23
10/24/1997,16,0,16,3,35
10/25/1997,15,0,3,12,30
10/26/1997,10,0,12,12,34
10/27/1997,6,0,16,1,23
10/28/1997,14,0,4,12,30
10/29/1997,15,0,3,9,27
10/30/1997,8,0,4,9,21
10/31/1997,6,0,2,2,10
11/1/1997,11,0,3,16,30
11/2/1997,11,0,14,1,26
11/3/1997,4,0,8,12,24
11/4/1997,14,0,5,8,27
11/5/1997,5,0,7,16,28
11/6/1997,4,0,11,9,24
11/7/1997,6,0,15,8,29
11/8/1997,12,0,4,11,27
11/9/1997,4,0,4,8,16
11/10/1997,14,0,8,5,27
11/11/1997,10,0,7,14,31
11/12/1997,6,0,13,15,34
11/13/1997,13,0,9,10,32
11/14/1997,12,0,12,4,28
11/15/1997,7,0,2,1,10
11/16/1997,4,0,11,5,20
11/17/1997,9,0,8,12,29
11/18/1997,9,0,6,0,15
11/19/1997,5,0,14,9,28
11/20/1997,5,0,15,1,21
11/21/1997,15,0,12,3,30
11/22/1997,8,0,13,11,32
11/23/1997,10,0,12,2,24
11/24/1997,5,0,5,14,24
11/25/1997,10,0,2,10,22
11/26/1997,7,0,6,0,13
11/27/1997,15,0,4,14,33
11/28/1997,8,0,9,7,24
11/29/1997,14,0,9,10,33
11/30/1997,14,0,10,10,34
12/1/1997,16,0,8,3,27
12/2/1997,10,0,10,16,36
12/3/1997,7,0,7,16,30
12/4/1997,15,0,5,10,30
12/5/1997,6,0,6,10,22
12/6/1997,8,0,10,2,20
12/7/1997,4,0,12,16,32
12/8/1997,4,0,2,7,13
12/9/1997,4,0,10,10,24
12/10/1997,13,0,2,5,20
12/11/1997,5,0,6,13,24
12/12/1997,6,0,12,8,26
12/13/1997,16,0,10,5,31
12/14/1997,14,0,16,5,35
12/15/1997,14,0,5,3,22
12/16/1997,14,0,14,16,44
12/17/1997,12,0,7,9,28
12/18/1997,13,0,11,16,40
12/19/1997,12,0,12,4,28
12/20/1997,13,0,5,8,26
12/21/1997,11,0,11,11,33
12/22/1997,4,0,15,6,25
12/23/1997,6,0,15,3,24
12/24/1997,5,0,12,9,26
12/25/1997,15,0,12,9,36
12/26/1997,16,0,10,13,39
12/27/1997,9,0,9,7,25
12/28/1997,14,0,7,7,28
12/29/1997,9,0,9,8,26
12/30/1997,8,0,12,3,23
12/31/1997,11,0,4,14,29
1/1/1998,16,0,9,7,32
1/2/1998,11,0,15,2,28
1/3/1998,16,0,13,13,42
1/4/1998,9,0,16,13,38
1/5/1998,16,0,11,12,39
1/6/1998,5,0,14,12,31
1/7/1998,12,0,7,14,33
1/8/1998,4,0,10,3,17
1/9/1998,7,0,4,8,19
1/10/1998,10,0,8,5,23
1/11/1998,5,0,14,9,28
1/12/1998,9,0,2,14,25
1/13/1998,11,0,15,14,40
1/14/1998,12,0,8,4,24
1/15/1998,13,0,4,6,23
1/16/1998,11,0,4,6,21
1/17/1998,7,0,9,12,28
1/18/1998,5,0,16,7,28
1/19/1998,9,0,2,15,26
1/20/1998,13,0,14,16,43
1/21/1998,7,0,14,5,26
1/22/1998,4,0,2,6,12
1/23/1998,7,0,16,5,28
1/24/1998,6,0,13,4,23
1/25/1998,9,0,6,5,20
1/26/1998,16,0,7,7,30
1/27/1998,12,0,3,6,21
1/28/1998,8,0,4,10,22
1/29/1998,5,0,10,6,21
1/30/1998,12,0,4,11,27
1/31/1998,8,0,4,9,21
2/1/1998,4,0,13,15,32
2/2/1998,5,0,9,10,24
2/3/1998,12,0,12,13,37
2/4/1998,8,0,8,3,19
2/5/1998,15,0,16,10,41
2/6/1998,6,0,3,1,10
2/7/1998,11,0,12,4,27
2/8/1998,9,0,11,4,24
2/9/1998,5,0,5,1,11
2/10/1998,12,0,9,9,30
2/11/1998,14,0,13,14,41
2/12/1998,14,0,11,13,38
2/13/1998,11,0,13,12,36
2/14/1998,4,0,13,2,19
2/15/1998,6,0,3,9,18
2/16/1998,6,0,4,7,17
2/17/1998,12,0,14,15,41
2/18/1998,8,0,16,16,40
2/19/1998,16,0,10,4,30
2/20/1998,7,0,15,11,33
2/21/1998,4,0,10,7,21
2/22/1998,16,0,7,8,31
2/23/1998,15,0,11,2,28
2/24/1998,6,0,7,3,16
2/25/1998,11,0,6,0,17
2/26/1998,16,0,15,7,38
2/27/1998,14,0,16,13,43
2/28/1998,15,0,14,7,36
3/1/1998,13,0,12,0,25
3/2/1998,7,0,5,5,17
3/3/1998,10,0,2,15,27
3/4/1998,9,0,5,8,22
3/5/1998,12,0,6,15,33
3/6/1998,4,0,8,2,14
3/7/1998,5,0,16,14,35
3/8/1998,8,0,7,3,18
3/9/1998,7,0,7,11,25
3/10/1998,4,0,8,9,21
3/11/1998,4,0,5,9,18
3/12/1998,10,0,5,14,29
3/13/1998,8,0,11,3,22
3/14/1998,7,0,6,3,16
3/15/1998,5,0,16,5,26
3/16/1998,8,0,15,13,36
3/17/1998,14,0,12,8,34
3/18/1998,12,0,2,6,20
3/19/1998,11,0,4,3,18
3/20/1998,15,0,15,13,43
3/21/1998,13,0,9,6,28
3/22/1998,7,0,5,5,17
3/23/1998,5,0,12,8,25
3/24/1998,14,0,6,13,33
3/25/1998,8,0,11,8,27
3/26/1998,14,0,3,4,21
3/27/1998,13,0,12,9,34
3/28/1998,7,0,15,11,33
3/29/1998,10,0,14,11,35
3/30/1998,15,0,2,13,30
3/31/1998,16,0,2,10,28
4/1/1998,13,0,3,9,25
4/2/1998,15,0,2,12,29
4/3/1998,9,0,6,2,17
4/4/1998,4,0,4,9,17
4/5/1998,6,0,2,11,19
4/6/1998,8,0,15,14,37
4/7/1998,5,0,9,5,19
4/8/1998,4,0,9,11,24
4/9/1998,15,0,7,16,38
4/10/1998,16,0,15,4,35
4/11/1998,9,0,2,12,23
4/12/1998,14,0,6,2,22
4/13/1998,11,0,16,3,30
4/14/1998,15,0,3,4,22
4/15/1998,15,0,12,6,33
4/16/1998,10,0,11,0,21
4/17/1998,5,0,5,13,23
4/18/1998,5,0,3,8,16
4/19/1998,7,0,15,13,35
4/20/1998,8,0,5,14,27
4/21/1998,8,0,9,13,30
4/22/1998,11,0,12,16,39
4/23/1998,16,0,16,5,37
4/24/1998,10,0,9,4,23
4/25/1998,15,0,3,11,29
4/26/1998,7,0,2,11,20
4/27/1998,8,0,5,3,16
4/28/1998,15,0,8,15,38
4/29/1998,11,0,6,0,17
4/30/1998,6,0,16,4,26
5/1/1998,9,0,3,8,20
5/2/1998,13,0,10,6,29
5/3/1998,16,0,7,7,30
5/4/1998,15,0,13,5,33
5/5/1998,6,0,11,1,18
5/6/1998,15,0,11,2,28
5/7/1998,8,0,15,14,37
5/8/1998,15,0,4,13,32
5/9/1998,10,0,12,10,32
5/10/1998,15,0,2,9,26
5/11/1998,6,0,13,5,24
5/12/1998,14,0,14,12,40
5/13/1998,13,0,5,11,29
5/14/1998,14,0,13,8,35
5/15/1998,14,0,15,12,41
5/16/1998,16,0,16,14,46
5/17/1998,15,0,10,4,29
5/18/1998,15,0,13,16,44
5/19/1998,11,0,12,3,26
5/20/1998,12,0,12,10,34
5/21/1998,5,0,6,6,17
5/22/1998,15,0,2,5,22
5/23/1998,14,0,11,9,34
5/24/1998,5,0,14,11,30
5/25/1998,8,0,4,8,20
5/26/1998,12,0,9,7,28
5/27/1998,8,0,12,2,22
5/28/1998,12,0,9,5,26
5/29/1998,8,0,12,2,22
5/30/1998,11,0,14,12,37
5/31/1998,15,0,6,5,26
6/1/1998,11,0,14,1,26
6/2/1998,13,0,10,12,35
6/3/1998,6,0,12,9,27
6/4/1998,13,0,6,1,20
6/5/1998,7,0,8,15,30
6/6/1998,15,0,4,2,21
6/7/1998,7,0,9,15,31
6/8/1998,16,0,3,16,35
6/9/1998,13,0,14,13,40
6/10/1998,4,0,4,0,8
6/11/1998,8,0,4,6,18
6/12/1998,11,0,14,16,41
6/13/1998,16,0,5,4,25
6/14/1998,15,0,3,4,22
6/15/1998,9,0,2,13,24
6/16/1998,6,0,4,11,21
6/17/1998,16,0,12,9,37
6/18/1998,11,0,5,4,20
6/19/1998,14,0,15,2,31
6/20/1998,4,0,15,16,35
6/21/1998,10,0,6,8,24
6/22/1998,4,0,2,0,6
6/23/1998,6,0,6,10,22
6/24/1998,10,0,5,4,19
6/25/1998,14,0,13,14,41
6/26/1998,13,0,9,13,35
6/27/1998,13,0,5,11,29
6/28/1998,10,0,10,0,20
6/29/1998,15,0,9,14,38
6/30/1998,5,0,10,5,20
7/1/1998,9,0,4,0,13
7/2/1998,9,0,4,12,25
7/3/1998,16,0,15,16,47
7/4/1998,6,0,4,2,12
7/5/1998,14,0,11,9,34
7/6/1998,15,0,9,11,35
7/7/1998,13,0,11,10,34
7/8/1998,7,0,16,6,29
7/9/1998,15,0,5,8,28
7/10/1998,14,0,15,14,43
7/11/1998,8,0,2,11,21
7/12/1998,16,0,4,8,28
7/13/1998,5,0,14,16,35
7/14/1998,6,0,6,3,15
7/15/1998,13,0,4,2,19
7/16/1998,6,0,9,5,20
7/17/1998,4,0,14,11,29
7/18/1998,10,0,5,14,29
7/19/1998,5,0,15,14,34
7/20/1998,13,0,3,7,23
7/21/1998,9,0,11,10,30
7/22/1998,9,0,3,8,20
7/23/1998,11,0,15,1,27
7/24/1998,8,0,15,15,38
7/25/1998,11,0,5,12,28
7/26/1998,7,0,2,14,23
7/27/1998,11,0,3,5,19
7/28/1998,13,0,2,7,22
7/29/1998,8,0,5,4,17
7/30/1998,14,0,6,10,30
7/31/1998,16,0,7,9,32
8/1/1998,5,0,4,16,25
8/2/1998,16,0,11,0,27
8/3/1998,4,0,11,14,29
8/4/1998,5,0,11,11,27
8/5/1998,15,0,15,7,37
8/6/1998,15,0,5,5,25
8/7/1998,9,0,5,5,19
8/8/1998,13,0,13,3,29
8/9/1998,7,0,16,4,27
8/10/1998,5,0,7,10,22
8/11/1998,7,0,5,10,22
8/12/1998,16,0,4,16,36
8/13/1998,9,0,16,6,31
8/14/1998,8,0,6,10,24
8/15/1998,7,0,10,12,29
8/16/1998,4,0,9,11,24
8/17/1998,8,0,5,1,14
8/18/1998,5,0,7,5,17
8/19/1998,6,0,3,7,16
8/20/1998,10,0,14,15,39
8/21/1998,16,0,14,8,38
8/22/1998,6,0,5,8,19
8/23/1998,12,0,15,8,35
8/24/1998,11,0,6,10,27
8/25/1998,8,0,15,1,24
8/26/1998,9,0,7,15,31
8/27/1998,10,0,10,12,32
8/28/1998,11,0,2,9,22
8/29/1998,12,0,13,14,39
8/30/1998,6,0,5,3,14
8/31/1998,10,0,12,15,37
9/1/1998,9,0,14,4,27
9/2/1998,8,0,13,6,27
9/3/1998,16,0,12,7,35
9/4/1998,5,0,4,15,24
9/5/1998,7,0,9,0,16
9/6/1998,12,0,5,11,28
9/7/1998,10,0,11,16,37
9/8/1998,4,0,3,11,18
9/9/1998,12,0,7,8,27
9/10/1998,6,0,2,6,14
9/11/1998,12,0,8,14,34
9/12/1998,13,0,15,5,33
9/13/1998,16,0,5,8,29
9/14/1998,4,0,11,13,28
9/15/1998,10,0,3,4,17
9/16/1998,7,0,4,3,14
9/17/1998,16,0,4,0,20
9/18/1998,15,0,3,14,32
9/19/1998,13,0,12,5,30
9/20/1998,7,0,5,4,16
9/21/1998,16,0,7,12,35
9/22/1998,16,0,12,13,41
9/23/1998,9,0,9,4,22
9/24/1998,4,0,6,1,11
9/25/1998,4,0,4,13,21
9/26/1998,14,0,5,7,26
9/27/1998,10,0,9,16,35
9/28/1998,10,0,9,14,33
9/29/1998,8,0,15,13,36
9/30/1998,15,0,7,13,35
10/1/1998,16,0,6,6,28
10/2/1998,11,0,9,3,23
10/3/1998,16,0,10,14,40
10/4/1998,7,0,9,2,18
10/5/1998,7,0,6,1,14
10/6/1998,9,0,3,10,22
10/7/1998,12,0,9,0,21
10/8/1998,16,0,11,7,34
10/9/1998,12,0,11,8,31
10/10/1998,10,0,4,16,30
10/11/1998,16,0,7,2,25
10/12/1998,5,0,15,4,24
10/13/1998,8,0,11,7,26
10/14/1998,8,0,10,7,25
10/15/1998,11,0,11,0,22
10/16/1998,5,0,4,11,20
10/17/1998,16,0,11,12,39
10/18/1998,11,0,8,13,32
10/19/1998,5,0,6,4,15
10/20/1998,8,0,8,10,26
10/21/1998,7,0,13,14,34
10/22/1998,14,0,6,4,24
10/23/1998,12,0,15,3,30
10/24/1998,5,0,6,10,21
10/25/1998,10,0,2,3,15
10/26/1998,15,0,7,5,27
10/27/1998,6,0,6,1,13
10/28/1998,15,0,5,15,35
10/29/1998,16,0,10,13,39
10/30/1998,12,0,4,16,32
10/31/1998,10,0,13,14,37
11/1/1998,5,0,15,12,32
11/2/1998,6,0,4,15,25
11/3/1998,12,0,12,3,27
11/4/1998,6,0,5,6,17
11/5/1998,16,0,15,4,35
11/6/1998,7,0,13,5,25
11/7/1998,12,0,12,10,34
11/8/1998,16,0,11,1,28
11/9/1998,9,0,10,11,30
11/10/1998,15,0,8,2,25
11/11/1998,15,0,15,5,35
11/12/1998,10,0,7,11,28
11/13/1998,13,0,16,13,42
11/14/1998,13,0,2,8,23
11/15/1998,5,0,2,1,8
11/16/1998,14,0,11,15,40
11/17/1998,5,0,3,5,13
11/18/1998,9,0,11,12,32
11/19/1998,16,0,4,8,28
11/20/1998,16,0,12,16,44
11/21/1998,9,0,4,13,26
11/22/1998,14,0,3,16,33
11/23/1998,11,0,4,6,21
11/24/1998,5,0,3,11,19
11/25/1998,13,0,15,5,33
11/26/1998,16,0,12,13,41
11/27/1998,8,0,7,5,20
11/28/1998,14,0,6,1,21
11/29/1998,10,0,12,4,26
11/30/1998,5,0,10,16,31
12/1/1998,7,0,6,0,13
12/2/1998,8,0,6,13,27
12/3/1998,15,0,8,11,34
12/4/1998,14,0,6,3,23
12/5/1998,15,0,7,12,34
12/6/1998,14,0,13,4,31
12/7/1998,7,0,2,4,13
12/8/1998,4,0,4,1,9
12/9/1998,11,0,2,3,16
12/10/1998,6,0,6,9,21
12/11/1998,6,0,8,6,20
12/12/1998,9,0,16,13,38
12/13/1998,8,0,5,6,19
12/14/1998,10,0,5,12,27
12/15/1998,10,0,2,6,18
12/16/1998,14,0,14,0,28
12/17/1998,9,0,15,4,28
12/18/1998,10,0,6,8,24
12/19/1998,7,0,8,4,19
12/20/1998,10,0,2,11,23
12/21/1998,14,0,5,6,25
12/22/1998,10,0,16,12,38
12/23/1998,7,0,7,10,24
12/24/1998,7,0,8,15,30
12/25/1998,15,0,4,15,34
12/26/1998,11,0,5,13,29
12/27/1998,16,0,10,13,39
12/28/1998,13,0,14,10,37
12/29/1998,5,0,3,16,24
12/30/1998,13,0,11,10,34
12/31/1998,5,0,14,12,31
1/1/1999,10,0,5,14,29
1/2/1999,7,0,9,15,31
1/3/1999,12,0,14,12,38
1/4/1999,4,0,9,15,28
1/5/1999,12,0,11,1,24
1/6/1999,8,0,11,14,33
1/7/1999,14,0,10,0,24
1/8/1999,16,0,2,13,31
1/9/1999,16,0,2,11,29
1/10/1999,13,0,8,12,33
1/11/1999,8,0,6,11,25
1/12/1999,15,0,7,1,23
1/13/1999,4,0,5,16,25
1/14/1999,6,0,13,13,32
1/15/1999,16,0,6,15,37
1/16/1999,5,0,6,4,15
1/17/1999,15,0,13,0,28
1/18/1999,12,0,13,10,35
1/19/1999,7,0,3,1,11
1/20/1999,16,0,5,3,24
1/21/1999,7,0,7,1,15
1/22/1999,5,0,7,0,12
1/23/1999,8,0,8,16,32
1/24/1999,16,0,7,4,27
1/25/1999,14,0,2,10,26
1/26/1999,6,0,6,1,13
1/27/1999,10,0,10,16,36
1/28/1999,12,0,14,7,33
1/29/1999,15,0,10,1,26
1/30/1999,15,0,10,13,38
1/31/1999,9,0,2,5,16
2/1/1999,9,0,8,0,17
2/2/1999,14,0,11,15,40
2/3/1999,8,0,7,0,15
2/4/1999,7,0,15,10,32
2/5/1999,6,0,11,15,32
2/6/1999,11,0,4,0,15
2/7/1999,6,0,13,10,29
2/8/1999,12,0,14,4,30
2/9/1999,13,0,15,8,36
2/10/1999,8,0,13,14,35
2/11/1999,6,0,16,14,36
2/12/1999,9,0,7,3,19
2/13/1999,16,0,5,14,35
2/14/1999,14,0,2,7,23
2/15/1999,7,0,2,13,22
2/16/1999,12,0,14,7,33
2/17/1999,7,0,14,7,28
2/18/1999,12,0,5,2,19
2/19/1999,9,0,8,6,23
2/20/1999,7,0,12,9,28
2/21/1999,9,0,5,3,17
2/22/1999,16,0,14,4,34
2/23/1999,13,0,10,4,27
2/24/1999,10,0,3,13,26
2/25/1999,11,0,16,1,28
2/26/1999,13,0,3,1,17
2/27/1999,7,0,16,9,32
2/28/1999,9,0,12,15,36
3/1/1999,14,0,12,13,39
3/2/1999,11,0,14,4,29
3/3/1999,15,0,11,16,42
3/4/1999,14,0,6,16,36
3/5/1999,8,0,15,15,38
3/6/1999,4,0,10,9,23
3/7/1999,15,0,4,5,24
3/8/1999,10,0,15,15,40
3/9/1999,10,0,5,15,30
3/10/1999,8,0,4,2,14
3/11/1999,7,0,11,14,32
3/12/1999,4,0,13,10,27
3/13/1999,7,0,15,9,31
3/14/1999,12,0,10,12,34
3/15/1999,4,0,16,1,21
3/16/1999,14,0,9,5,28
3/17/1999,8,0,16,14,38
3/18/1999,13,0,3,4,20
3/19/1999,10,0,10,5,25
3/20/1999,12,0,2,10,24
3/21/1999,9,0,16,1,26
3/22/1999,12,0,2,2,16
3/23/1999,6,0,6,9,21
3/24/1999,10,0,13,15,38
3/25/1999,15,0,15,4,34
3/26/1999,13,0,11,3,27
3/27/1999,13,0,10,8,31
3/28/1999,16,0,12,14,42
3/29/1999,12,0,8,11,31
3/30/1999,10,0,11,5,26
3/31/1999,5,0,2,6,13
4/1/1999,9,0,2,5,16
4/2/1999,15,0,15,1,31
4/3/1999,9,0,10,5,24
4/4/1999,6,0,6,15,27
4/5/1999,9,0,10,11,30
4/6/1999,14,0,15,4,33
4/7/1999,10,0,16,2,28
4/8/1999,15,0,4,4,23
4/9/1999,12,0,2,2,16
4/10/1999,4,0,15,15,34
4/11/1999,14,0,7,14,35
4/12/1999,7,0,2,15,24
4/13/1999,14,0,6,6,26
4/14/1999,8,0,12,15,35
4/15/1999,13,0,14,3,30
4/16/1999,15,0,7,16,38
4/17/1999,5,0,15,0,20
4/18/1999,13,0,9,12,34
4/19/1999,9,0,7,15,31
4/20/1999,11,0,3,3,17
4/21/1999,16,0,2,4,22
4/22/1999,14,0,13,4,31
4/23/1999,4,0,9,16,29
4/24/1999,14,0,2,5,21
4/25/1999,13,0,15,13,41
4/26/1999,10,0,4,7,21
4/27/1999,13,0,13,7,33
4/28/1999,6,0,6,15,27
4/29/1999,12,0,8,12,32
4/30/1999,4,0,3,11,18
5/1/1999,7,0,16,1,24
5/2/1999,7,0,15,5,27
5/3/1999,7,0,13,6,26
5/4/1999,11,0,13,16,40
5/5/1999,11,0,5,5,21
5/6/1999,14,0,7,8,29
5/7/1999,14,0,16,7,37
5/8/1999,16,0,13,11,40
5/9/1999,16,0,15,11,42
5/10/1999,7,0,8,9,24
5/11/1999,7,0,10,3,20
5/12/1999,4,0,16,12,32
5/13/1999,9,0,7,0,16
5/14/1999,8,0,3,0,11
5/15/1999,7,0,14,3,24
5/16/1999,16,0,10,0,26
5/17/1999,10,0,2,10,22
5/18/1999,16,0,8,10,34
5/19/1999,13,0,10,15,38
5/20/1999,6,0,5,15,26
5/21/1999,5,0,4,5,14
5/22/1999,9,0,2,11,22
5/23/1999,9,0,4,0,13
5/24/1999,15,0,15,10,40
5/25/1999,12,0,7,10,29
5/26/1999,9,0,10,10,29
5/27/1999,15,0,3,6,24
5/28/1999,7,0,15,7,29
5/29/1999,8,0,16,9,33
5/30/1999,5,0,4,3,12
5/31/1999,16,0,7,0,23
6/1/1999,8,0,10,9,27
6/2/1999,4,0,12,4,20
6/3/1999,8,0,12,3,23
6/4/1999,15,0,5,6,26
6/5/1999,6,0,4,6,16
6/6/1999,5,0,4,14,23
6/7/1999,14,0,11,9,34
6/8/1999,9,0,15,16,40
6/9/1999,15,0,12,14,41
6/10/1999,4,0,3,12,19
6/11/1999,7,0,4,6,17
6/12/1999,12,0,15,9,36
6/13/1999,15,0,9,7,31
6/14/1999,12,0,4,11,27
6/15/1999,16,0,5,16,37
6/16/1999,4,0,12,3,19
6/17/1999,14,0,2,11,27
6/18/1999,9,0,6,3,18
6/19/1999,13,0,3,6,22
6/20/1999,6,0,13,10,29
6/21/1999,5,0,9,15,29
6/22/1999,7,0,12,2,21
6/23/1999,4,0,4,4,12
6/24/1999,7,0,7,0,14
6/25/1999,14,0,8,9,31
6/26/1999,12,0,2,0,14
6/27/1999,5,0,3,12,20
6/28/1999,7,0,15,14,36
6/29/1999,14,0,14,13,41
6/30/1999,16,0,5,4,25
7/1/1999,9,0,11,10,30
7/2/1999,16,0,11,3,30
7/3/1999,11,0,8,8,27
7/4/1999,16,0,13,5,34
7/5/1999,13,0,15,8,36
7/6/1999,10,0,5,4,19
7/7/1999,14,0,4,9,27
7/8/1999,5,0,10,11,26
7/9/1999,11,0,6,13,30
7/10/1999,5,0,8,1,14
7/11/1999,12,0,8,15,35
7/12/1999,9,0,15,4,28
7/13/1999,16,0,7,13,36
7/14/1999,14,0,7,12,33
7/15/1999,16,0,14,6,36
7/16/1999,16,0,5,13,34
7/17/1999,14,0,10,0,24
7/18/1999,13,0,11,15,39
7/19/1999,13,0,13,9,35
7/20/1999,4,0,6,0,10
7/21/1999,6,0,12,7,25
7/22/1999,6,0,14,16,36
7/23/1999,9,0,15,0,24
7/24/1999,5,0,3,13,21
7/25/1999,14,0,11,7,32
7/26/1999,4,0,4,4,12
7/27/1999,7,0,12,10,29
7/28/1999,15,0,4,13,32
7/29/1999,12,0,11,3,26
7/30/1999,4,0,10,10,24
7/31/1999,6,0,6,11,23
8/1/1999,7,0,16,16,39
8/2/1999,8,0,2,16,26
8/3/1999,7,0,10,9,26
8/4/1999,9,0,9,5,23
8/5/1999,4,0,11,11,26
8/6/1999,5,0,13,9,27
8/7/1999,10,0,15,1,26
8/8/1999,8,0,13,13,34
8/9/1999,8,0,6,9,23
8/10/1999,16,0,6,6,28
8/11/1999,13,0,2,6,21
8/12/1999,8,0,3,15,26
8/13/1999,14,0,8,15,37
8/14/1999,8,0,9,12,29
8/15/1999,6,0,7,16,29
8/16/1999,6,0,15,6,27
8/17/1999,11,0,9,5,25
8/18/1999,13,0,6,9,28
8/19/1999,15,0,16,4,35
8/20/1999,4,0,10,1,15
8/21/1999,10,0,15,1,26
8/22/1999,10,0,2,12,24
8/23/1999,6,0,3,12,21
8/24/1999,15,0,15,3,33
8/25/1999,14,0,15,13,42
8/26/1999,16,0,4,2,22
8/27/1999,14,0,12,0,26
8/28/1999,14,0,5,2,21
8/29/1999,9,0,4,2,15
8/30/1999,9,0,7,4,20
8/31/1999,7,0,16,11,34
9/1/1999,15,0,4,15,34
9/2/1999,8,0,5,11,24
9/3/1999,10,0,14,7,31
9/4/1999,9,0,6,2,17
9/5/1999,7,0,4,2,13
9/6/1999,6,0,13,6,25
9/7/1999,7,0,14,7,28
9/8/1999,15,0,6,10,31
9/9/1999,4,0,10,3,17
9/10/1999,12,0,2,9,23
9/11/1999,14,0,10,5,29
9/12/1999,11,0,3,16,30
9/13/1999,14,0,10,16,40
9/14/1999,6,0,4,9,19
9/15/1999,8,0,8,14,30
9/16/1999,9,0,4,12,25
9/17/1999,10,0,4,15,29
9/18/1999,11,0,13,8,32
9/19/1999,7,0,14,7,28
9/20/1999,4,0,3,0,7
9/21/1999,16,0,8,13,37
9/22/1999,12,0,13,10,35
9/23/1999,12,0,10,8,30
9/24/1999,15,0,15,8,38
9/25/1999,16,0,2,9,27
9/26/1999,13,0,16,3,32
9/27/1999,13,0,10,12,35
9/28/1999,9,0,7,16,32
9/29/1999,5,0,6,6,17
9/30/1999,11,0,12,9,32
10/1/1999,15,0,12,5,32
10/2/1999,14,0,6,4,24
10/3/1999,10,0,5,0,15
10/4/1999,11,0,2,1,14
10/5/1999,5,0,5,16,26
10/6/1999,15,0,5,8,28
10/7/1999,15,0,9,1,25
10/8/1999,16,0,10,9,35
10/9/1999,15,0,11,1,27
10/10/1999,16,0,2,12,30
10/11/1999,16,0,6,0,22
10/12/1999,13,0,4,14,31
10/13/1999,15,0,2,9,26
10/14/1999,8,0,5,3,16
10/15/1999,6,0,8,7,21
10/16/1999,8,0,5,11,24
10/17/1999,12,0,3,1,16
10/18/1999,8,0,16,6,30
10/19/1999,7,0,5,7,19
10/20/1999,11,0,7,3,21
10/21/1999,15,0,2,6,23
10/22/1999,16,0,14,3,33
10/23/1999,16,0,10,3,29
10/24/1999,6,0,16,10,32
10/25/1999,14,0,12,1,27
10/26/1999,9,0,6,16,31
10/27/1999,8,0,7,4,19
10/28/1999,11,0,7,11,29
10/29/1999,13,0,14,1,28
10/30/1999,11,0,4,0,15
10/31/1999,8,0,5,13,26
11/1/1999,7,0,16,15,38
11/2/1999,14,0,6,11,31
11/3/1999,16,0,5,9,30
11/4/1999,5,0,6,4,15
11/5/1999,15,0,13,10,38
11/6/1999,15,0,15,1,31
11/7/1999,5,0,11,7,23
11/8/1999,5,0,10,9,24
11/9/1999,13,0,14,16,43
11/10/1999,11,0,14,2,27
11/11/1999,9,0,6,0,15
11/12/1999,8,0,11,7,26
11/13/1999,15,0,5,7,27
11/14/1999,8,0,7,8,23
11/15/1999,11,0,12,9,32
11/16/1999,16,0,6,14,36
11/17/1999,16,0,6,0,22
11/18/1999,9,0,10,8,27
11/19/1999,10,0,7,12,29
11/20/1999,12,0,10,4,26
11/21/1999,13,0,3,2,18
11/22/1999,8,0,7,6,21
11/23/1999,15,0,16,4,35
11/24/1999,15,0,3,11,29
11/25/1999,8,0,8,6,22
11/26/1999,8,0,5,7,20
11/27/1999,7,0,6,13,26
11/28/1999,10,0,11,11,32
11/29/1999,9,0,3,9,21
11/30/1999,7,0,9,1,17
12/1/1999,6,0,8,10,24
12/2/1999,4,0,2,4,10
12/3/1999,11,0,8,10,29
12/4/1999,10,0,14,6,30
12/5/1999,6,0,13,6,25
12/6/1999,16,0,3,2,21
12/7/1999,8,0,11,6,25
12/8/1999,10,0,9,5,24
12/9/1999,10,0,14,11,35
12/10/1999,10,0,6,4,20
12/11/1999,16,0,5,10,31
12/12/1999,11,0,12,1,24
12/13/1999,16,0,15,4,35
12/14/1999,10,0,2,6,18
12/15/1999,8,0,6,12,26
12/16/1999,4,0,16,1,21
12/17/1999,10,0,8,2,20
12/18/1999,15,0,12,12,39
12/19/1999,15,0,10,8,33
12/20/1999,10,0,12,14,36
12/21/1999,6,0,8,7,21
12/22/1999,11,0,10,8,29
12/23/1999,5,0,12,3,20
12/24/1999,13,0,2,15,30
12/25/1999,7,0,9,11,27
12/26/1999,6,0,3,4,13
12/27/1999,16,0,15,5,36
12/28/1999,9,0,5,16,30
12/29/1999,6,0,7,7,20
12/30/1999,15,0,13,6,34
12/31/1999,8,0,14,5,27
1/1/2000,15,0,9,6,30
1/2/2000,12,0,15,16,43
1/3/2000,15,0,14,0,29
1/4/2000,9,0,14,7,30
1/5/2000,4,0,9,16,29
1/6/2000,4,0,12,15,31
1/7/2000,6,0,2,11,19
1/8/2000,12,0,4,15,31
1/9/2000,7,0,10,15,32
1/10/2000,10,0,3,4,17
1/11/2000,15,0,15,3,33
1/12/2000,16,0,3,13,32
1/13/2000,12,0,8,2,22
1/14/2000,11,0,16,13,40
1/15/2000,9,0,6,7,22
1/16/2000,16,0,15,1,32
1/17/2000,5,0,6,5,16
1/18/2000,16,0,10,10,36
1/19/2000,6,0,6,9,21
1/20/2000,7,0,12,9,28
1/21/2000,4,0,3,13,20
1/22/2000,5,0,3,9,17
1/23/2000,13,0,15,1,29
1/24/2000,10,0,10,10,30
1/25/2000,10,0,9,15,34
1/26/2000,14,0,5,11,30
1/27/2000,10,0,6,14,30
1/28/2000,16,0,4,14,34
1/29/2000,13,0,11,10,34
1/30/2000,10,0,10,14,34
1/31/2000,9,0,3,14,26
2/1/2000,15,0,14,1,30
2/2/2000,11,0,16,8,35
2/3/2000,10,0,2,3,15
2/4/2000,4,0,5,7,16
2/5/2000,11,0,9,3,23
2/6/2000,8,0,5,0,13
2/7/2000,14,0,3,15,32
2/8/2000,6,0,12,3,21
2/9/2000,9,0,8,0,17
2/10/2000,8,0,13,7,28
2/11/2000,14,0,13,15,42
2/12/2000,15,0,9,3,27
2/13/2000,10,0,16,7,33
2/14/2000,8,0,6,0,14
2/15/2000,5,0,7,8,20
2/16/2000,13,0,11,2,26
2/17/2000,5,0,15,11,31
2/18/2000,7,0,14,7,28
2/19/2000,11,0,15,9,35
2/20/2000,8,0,5,15,28
2/21/2000,13,0,4,9,26
2/22/2000,16,0,6,16,38
2/23/2000,7,0,11,10,28
2/24/2000,13,0,12,10,35
2/25/2000,16,0,12,10,38
2/26/2000,14,0,11,10,35
2/27/2000,15,0,12,9,36
2/28/2000,10,0,4,4,18
2/29/2000,8,0,6,5,19
3/1/2000,13,0,7,2,22
3/2/2000,10,0,14,6,30
3/3/2000,15,0,8,3,26
3/4/2000,4,0,10,13,27
3/5/2000,4,0,13,13,30
3/6/2000,5,0,3,15,23
3/7/2000,13,0,11,12,36
3/8/2000,12,0,16,0,28
3/9/2000,14,0,8,15,37
3/10/2000,8,0,3,8,19
3/11/2000,4,0,13,11,28
3/12/2000,9,0,14,4,27
3/13/2000,6,0,6,4,16
3/14/2000,9,0,15,1,25
3/15/2000,12,0,5,6,23
3/16/2000,7,0,12,13,32
3/17/2000,9,0,15,14,38
3/18/2000,8,0,10,8,26
3/19/2000,4,0,3,12,19
3/20/2000,6,0,4,6,16
3/21/2000,15,0,8,5,28
3/22/2000,14,0,8,7,29
3/23/2000,15,0,15,16,46
3/24/2000,13,0,16,13,42
3/25/2000,9,0,5,15,29
3/26/2000,5,0,9,15,29
3/27/2000,16,0,3,14,33
3/28/2000,14,0,13,12,39
3/29/2000,16,0,2,3,21
3/30/2000,14,0,2,9,25
3/31/2000,12,0,16,4,32
4/1/2000,6,0,13,13,32
4/2/2000,6,0,3,6,15
4/3/2000,14,0,13,4,31
4/4/2000,8,0,5,0,13
4/5/2000,11,0,11,15,37
4/6/2000,14,0,11,11,36
4/7/2000,13,0,6,3,22
4/8/2000,14,0,4,1,19
4/9/2000,6,0,5,12,23
4/10/2000,16,0,15,12,43
4/11/2000,4,0,12,12,28
4/12/2000,16,0,4,5,25
4/13/2000,7,0,6,14,27
4/14/2000,5,0,8,8,21
4/15/2000,6,0,14,2,22
4/16/2000,12,0,15,12,39
4/17/2000,15,0,9,15,39
4/18/2000,12,0,4,13,29
4/19/2000,6,0,7,15,28
4/20/2000,13,0,4,5,22
4/21/2000,16,0,10,10,36
4/22/2000,11,0,9,3,23
4/23/2000,9,0,14,7,30
4/24/2000,16,0,15,8,39
4/25/2000,10,0,16,7,33
4/26/2000,12,0,2,15,29
4/27/2000,12,0,2,8,22
4/28/2000,10,0,5,7,22
4/29/2000,7,0,3,0,10
4/30/2000,5,0,10,5,20
5/1/2000,6,0,16,1,23
5/2/2000,7,0,13,2,22
5/3/2000,9,0,6,11,26
5/4/2000,10,0,9,9,28
5/5/2000,8,0,7,0,15
5/6/2000,5,0,11,1,17
5/7/2000,8,0,7,16,31
5/8/2000,15,0,3,11,29
5/9/2000,7,0,8,5,20
5/10/2000,13,0,2,0,15
5/11/2000,7,0,5,5,17
5/12/2000,10,0,5,3,18
5/13/2000,11,0,6,16,33
5/14/2000,6,0,8,6,20
5/15/2000,4,0,2,14,20
5/16/2000,15,0,15,3,33
5/17/2000,12,0,2,16,30
5/18/2000,5,0,10,1,16
5/19/2000,10,0,3,3,16
5/20/2000,10,0,15,8,33
5/21/2000,6,0,12,11,29
5/22/2000,7,0,2,12,21
5/23/2000,9,0,11,3,23
5/24/2000,16,0,10,6,32
5/25/2000,8,0,10,14,32
5/26/2000,12,0,5,6,23
5/27/2000,9,0,16,5,30
5/28/2000,11,0,5,7,23
5/29/2000,8,0,10,3,21
5/30/2000,4,0,8,15,27
5/31/2000,11,0,4,8,23
6/1/2000,12,0,16,16,44
6/2/2000,6,0,14,9,29
6/3/2000,12,0,8,6,26
6/4/2000,5,0,10,5,20
6/5/2000,10,0,5,7,22
6/6/2000,8,0,2,3,13
6/7/2000,11,0,16,2,29
6/8/2000,4,0,15,7,26
6/9/2000,8,0,2,16,26
6/10/2000,8,0,14,3,25
6/11/2000,9,0,11,12,32
6/12/2000,12,0,15,6,33
6/13/2000,10,0,2,8,20
6/14/2000,10,0,15,13,38
6/15/2000,8,0,7,9,24
6/16/2000,13,0,14,8,35
6/17/2000,4,0,4,13,21
6/18/2000,13,0,14,0,27
6/19/2000,14,0,4,4,22
6/20/2000,13,0,6,2,21
6/21/2000,16,0,12,4,32
6/22/2000,8,0,10,2,20
6/23/2000,15,0,5,14,34
6/24/2000,11,0,14,8,33
6/25/2000,5,0,11,6,22
6/26/2000,9,0,14,1,24
6/27/2000,8,0,12,1,21
6/28/2000,11,0,5,15,31
6/29/2000,4,0,14,1,19
6/30/2000,12,0,8,8,28
7/1/2000,9,0,9,12,30
7/2/2000,15,0,10,6,31
7/3/2000,6,0,14,14,34
7/4/2000,5,0,14,2,21
7/5/2000,15,0,15,11,41
7/6/2000,11,0,3,8,22
7/7/2000,10,0,3,1,14
7/8/2000,5,0,14,2,21
7/9/2000,14,0,6,13,33
7/10/2000,16,0,9,0,25
7/11/2000,16,0,10,12,38
7/12/2000,5,0,6,0,11
7/13/2000,10,0,4,5,19
7/14/2000,15,0,4,8,27
7/15/2000,11,0,6,5,22
7/16/2000,16,0,14,12,42
7/17/2000,12,0,11,13,36
7/18/2000,12,0,12,3,27
7/19/2000,16,0,11,12,39
7/20/2000,8,0,11,10,29
7/21/2000,5,0,16,9,30
7/22/2000,4,0,7,12,23
7/23/2000,10,0,6,15,31
7/24/2000,14,0,14,12,40
7/25/2000,9,0,8,16,33
7/26/2000,15,0,5,6,26
7/27/2000,16,0,11,6,33
7/28/2000,5,0,5,3,13
7/29/2000,14,0,16,14,44
7/30/2000,13,0,10,5,28
7/31/2000,7,0,10,6,23
8/1/2000,13,0,15,0,28
8/2/2000,4,0,4,2,10
8/3/2000,16,0,10,14,40
8/4/2000,15,0,11,16,42
8/5/2000,7,0,2,12,21
8/6/2000,14,0,5,3,22
8/7/2000,15,0,11,14,40
8/8/2000,15,0,11,4,30
8/9/2000,15,0,5,8,28
8/10/2000,9,0,11,13,33
8/11/2000,8,0,2,16,26
8/12/2000,5,0,16,10,31
8/13/2000,8,0,6,10,24
8/14/2000,7,0,11,12,30
8/15/2000,14,0,2,0,16
8/16/2000,9,0,7,6,22
8/17/2000,15,0,4,14,33
8/18/2000,16,0,14,10,40
8/19/2000,4,0,14,4,22
8/20/2000,16,0,6,14,36
8/21/2000,8,0,16,9,33
8/22/2000,14,0,5,11,30
8/23/2000,6,0,12,3,21
8/24/2000,5,0,12,12,29
8/25/2000,12,0,2,1,15
8/26/2000,13,0,7,16,36
8/27/2000,4,0,8,2,14
8/28/2000,12,0,16,13,41
8/29/2000,15,0,7,7,29
8/30/2000,9,0,6,5,20
8/31/2000,11,0,7,5,23
9/1/2000,10,0,14,15,39
9/2/2000,16,0,7,9,32
9/3/2000,15,0,3,1,19
9/4/2000,14,0,8,0,22
9/5/2000,11,0,10,11,32
9/6/2000,16,0,10,6,32
9/7/2000,5,0,11,5,21
9/8/2000,9,0,16,7,32
9/9/2000,5,0,7,5,17
9/10/2000,11,0,6,8,25
9/11/2000,4,0,6,16,26
9/12/2000,7,0,11,2,20
9/13/2000,14,0,8,4,26
9/14/2000,9,0,15,13,37
9/15/2000,12,0,3,4,19
9/16/2000,12,0,9,9,30
9/17/2000,11,0,7,15,33
9/18/2000,14,0,11,1,26
9/19/2000,5,0,10,13,28
9/20/2000,10,0,14,1,25
9/21/2000,5,0,3,6,14
9/22/2000,8,0,3,10,21
9/23/2000,5,0,7,7,19
9/24/2000,6,0,8,5,19
9/25/2000,6,0,6,2,14
9/26/2000,11,0,14,11,36
9/27/2000,9,0,11,2,22
9/28/2000,4,0,11,9,24
9/29/2000,9,0,12,3,24
9/30/2000,13,0,10,1,24
10/1/2000,5,0,2,9,16
10/2/2000,13,0,8,15,36
10/3/2000,8,0,12,3,23
10/4/2000,13,0,11,1,25
10/5/2000,14,0,6,1,21
10/6/2000,8,0,5,13,26
10/7/2000,7,0,3,2,12
10/8/2000,5,0,14,4,23
10/9/2000,14,0,8,15,37
10/10/2000,16,0,10,7,33
10/11/2000,13,0,3,4,20
10/12/2000,12,0,11,0,23
10/13/2000,9,0,9,13,31
10/14/2000,6,0,10,14,30
10/15/2000,16,0,3,16,35
10/16/2000,12,0,4,9,25
10/17/2000,12,0,3,8,23
10/18/2000,9,0,15,4,28
10/19/2000,5,0,9,11,25
10/20/2000,9,0,3,9,21
10/21/2000,11,0,11,11,33
10/22/2000,8,0,15,0,23
10/23/2000,11,0,4,10,25
10/24/2000,10,0,4,0,14
10/25/2000,8,0,5,15,28
10/26/2000,10,0,16,2,28
10/27/2000,4,0,15,2,21
10/28/2000,16,0,16,7,39
10/29/2000,11,0,12,9,32
10/30/2000,16,0,16,4,36
10/31/2000,6,0,4,5,15
11/1/2000,6,0,2,11,19
11/2/2000,14,0,11,1,26
11/3/2000,4,0,5,10,19
11/4/2000,8,0,9,9,26
11/5/2000,6,0,5,11,22
11/6/2000,4,0,13,5,22
11/7/2000,12,0,14,12,38
11/8/2000,8,0,11,13,32
11/9/2000,5,0,8,11,24
11/10/2000,4,0,14,5,23
11/11/2000,16,0,10,9,35
11/12/2000,11,0,16,8,35
11/13/2000,5,0,11,14,30
11/14/2000,6,0,7,1,14
11/15/2000,15,0,10,0,25
11/16/2000,8,0,3,15,26
11/17/2000,11,0,5,2,18
11/18/2000,9,0,6,0,15
11/19/2000,5,0,2,1,8
11/20/2000,15,0,10,12,37
11/21/2000,11,0,6,6,23
11/22/2000,13,0,7,13,33
11/23/2000,8,0,7,8,23
11/24/2000,11,0,7,9,27
11/25/2000,14,0,11,4,29
11/26/2000,9,0,6,7,22
11/27/2000,10,0,8,9,27
11/28/2000,5,0,8,0,13
11/29/2000,9,0,5,8,22
11/30/2000,7,0,7,2,16
12/1/2000,10,0,4,4,18
12/2/2000,5,0,16,15,36
12/3/2000,5,0,13,16,34
12/4/2000,10,0,15,2,27
12/5/2000,12,0,12,8,32
12/6/2000,8,0,5,11,24
12/7/2000,13,0,15,11,39
12/8/2000,4,0,16,0,20
12/9/2000,13,0,14,10,37
12/10/2000,11,0,14,9,34
12/11/2000,7,0,4,16,27
12/12/2000,15,0,4,1,20
12/13/2000,7,0,16,8,31
12/14/2000,14,0,16,4,34
12/15/2000,4,0,4,14,22
12/16/2000,6,0,13,12,31
12/17/2000,5,0,8,5,18
12/18/2000,9,0,15,6,30
12/19/2000,13,0,14,0,27
12/20/2000,9,0,12,13,34
12/21/2000,14,0,12,10,36
12/22/2000,11,0,9,3,23
12/23/2000,9,0,12,12,33
12/24/2000,9,0,6,11,26
12/25/2000,4,0,5,2,11
12/26/2000,16,0,6,16,38
12/27/2000,14,0,9,12,35
12/28/2000,9,0,8,9,26
12/29/2000,5,0,15,8,28
12/30/2000,5,0,15,0,20
12/31/2000,9,0,11,16,36
1/1/2001,13,0,10,10,33
1/2/2001,15,0,5,9,29
1/3/2001,12,0,12,16,40
1/4/2001,6,0,16,1,23
1/5/2001,16,0,15,5,36
1/6/2001,5,0,15,9,29
1/7/2001,14,0,6,0,20
1/8/2001,9,0,11,11,31
1/9/2001,5,0,12,10,27
1/10/2001,13,0,4,0,17
1/11/2001,14,0,4,14,32
1/12/2001,8,0,9,16,33
1/13/2001,15,0,8,7,30
1/14/2001,14,0,13,7,34
1/15/2001,5,0,8,9,22
1/16/2001,15,0,16,1,32
1/17/2001,4,0,16,1,21
1/18/2001,5,0,8,4,17
1/19/2001,4,0,12,16,32
1/20/2001,10,0,16,4,30
1/21/2001,8,0,13,4,25
1/22/2001,9,0,3,13,25
1/23/2001,16,0,3,8,27
1/24/2001,15,0,14,8,37
1/25/2001,8,0,6,16,30
1/26/2001,8,0,11,1,20
1/27/2001,4,0,14,13,31
1/28/2001,9,0,6,12,27
1/29/2001,10,0,6,15,31
1/30/2001,14,0,3,14,31
1/31/2001,16,0,7,10,33
2/1/2001,16,0,12,6,34
2/2/2001,9,0,5,16,30
2/3/2001,7,0,11,15,33
2/4/2001,13,0,11,12,36
2/5/2001,15,0,7,3,25
2/6/2001,15,0,3,4,22
2/7/2001,8,0,16,11,35
2/8/2001,14,0,3,13,30
2/9/2001,6,0,14,6,26
2/10/2001,6,0,11,12,29
2/11/2001,8,0,10,12,30
2/12/2001,10,0,5,10,25
2/13/2001,7,0,2,13,22
2/14/2001,5,0,2,7,14
2/15/2001,12,0,5,12,29
2/16/2001,7,0,6,16,29
2/17/2001,7,0,11,9,27
2/18/2001,13,0,8,5,26
2/19/2001,9,0,10,7,26
2/20/2001,6,0,11,15,32
2/21/2001,12,0,9,8,29
2/22/2001,13,0,8,12,33
2/23/2001,4,0,10,3,17
2/24/2001,10,0,6,3,19
2/25/2001,11,0,8,16,35
2/26/2001,9,0,8,7,24
2/27/2001,13,0,2,11,26
2/28/2001,4,0,9,11,24
3/1/2001,10,0,7,4,21
3/2/2001,6,0,14,7,27
3/3/2001,14,0,5,0,19
3/4/2001,6,0,7,7,20
3/5/2001,10,0,16,0,26
3/6/2001,13,0,12,4,29
3/7/2001,8,0,14,13,35
3/8/2001,6,0,7,0,13
3/9/2001,8,0,16,1,25
3/10/2001,16,0,3,0,19
3/11/2001,6,0,4,1,11
3/12/2001,11,0,11,16,38
3/13/2001,13,0,7,14,34
3/14/2001,14,0,2,8,24
3/15/2001,7,0,11,1,19
3/16/2001,6,0,16,7,29
3/17/2001,4,0,6,5,15
3/18/2001,16,0,7,1,24
3/19/2001,11,0,4,6,21
3/20/2001,5,0,3,2,10
3/21/2001,7,0,15,0,22
3/22/2001,13,0,9,9,31
3/23/2001,8,0,12,16,36
3/24/2001,11,0,15,8,34
3/25/2001,14,0,6,6,26
3/26/2001,10,0,2,7,19
3/27/2001,14,0,12,13,39
3/28/2001,10,0,11,14,35
3/29/2001,5,0,12,9,26
3/30/2001,6,0,14,15,35
3/31/2001,7,0,12,0,19
4/1/2001,11,0,9,10,30
4/2/2001,16,0,12,5,33
4/3/2001,7,0,7,8,22
4/4/2001,4,0,11,4,19
4/5/2001,10,0,7,10,27
4/6/2001,12,0,4,13,29
4/7/2001,9,0,6,8,23
4/8/2001,10,0,7,9,26
4/9/2001,5,0,15,2,22
4/10/2001,4,0,10,1,15
4/11/2001,13,0,6,13,32
4/12/2001,12,0,2,8,22
4/13/2001,13,0,5,4,22
4/14/2001,13,0,5,16,34
4/15/2001,16,0,15,16,47
4/16/2001,10,0,8,5,23
4/17/2001,4,0,3,11,18
4/18/2001,9,0,6,15,30
4/19/2001,16,0,7,16,39
4/20/2001,6,0,12,7,25
4/21/2001,7,0,8,1,16
4/22/2001,9,0,11,12,32
4/23/2001,9,0,7,14,30
4/24/2001,4,0,16,1,21
4/25/2001,9,0,8,15,32
4/26/2001,8,0,11,2,21
4/27/2001,14,0,11,5,30
4/28/2001,7,0,13,2,22
4/29/2001,16,0,13,5,34
4/30/2001,8,0,7,13,28
5/1/2001,11,0,11,1,23
5/2/2001,5,0,4,11,20
5/3/2001,12,0,10,3,25
5/4/2001,12,0,5,14,31
5/5/2001,8,0,13,12,33
5/6/2001,10,0,4,7,21
5/7/2001,15,0,9,12,36
5/8/2001,5,0,9,7,21
5/9/2001,8,0,3,0,11
5/10/2001,8,0,5,14,27
5/11/2001,12,0,10,0,22
5/12/2001,10,0,11,12,33
5/13/2001,6,0,14,4,24
5/14/2001,5,0,11,10,26
5/15/2001,8,0,12,10,30
5/16/2001,12,0,4,10,26
5/17/2001,6,0,3,13,22
5/18/2001,6,0,9,0,15
5/19/2001,12,0,4,2,18
5/20/2001,8,0,6,16,30
5/21/2001,11,0,14,9,34
5/22/2001,5,0,13,8,26
5/23/2001,8,0,16,13,37
5/24/2001,10,0,13,14,37
5/25/2001,6,0,5,1,12
5/26/2001,16,0,6,14,36
5/27/2001,5,0,11,11,27
5/28/2001,12,0,6,10,28
5/29/2001,8,0,16,3,27
5/30/2001,16,0,7,12,35
5/31/2001,12,0,8,16,36
6/1/2001,13,0,13,8,34
6/2/2001,13,0,16,5,34
6/3/2001,12,0,16,7,35
6/4/2001,13,0,11,3,27
6/5/2001,9,0,10,9,28
6/6/2001,5,0,12,14,31
6/7/2001,12,0,4,0,16
6/8/2001,5,0,10,0,15
6/9/2001,5,0,12,0,17
6/10/2001,9,0,3,3,15
6/11/2001,5,0,4,16,25
6/12/2001,10,0,11,6,27
6/13/2001,12,0,14,8,34
6/14/2001,8,0,6,11,25
6/15/2001,6,0,9,0,15
6/16/2001,15,0,16,9,40
6/17/2001,4,0,10,7,21
6/18/2001,6,0,6,3,15
6/19/2001,10,0,9,12,31
6/20/2001,7,0,13,7,27
6/21/2001,15,0,11,1,27
6/22/2001,4,0,10,0,14
6/23/2001,13,0,15,8,36
6/24/2001,16,0,12,12,40
6/25/2001,12,0,11,16,39
6/26/2001,16,0,15,8,39
6/27/2001,4,0,13,6,23
6/28/2001,15,0,10,1,26
6/29/2001,10,0,11,10,31
6/30/2001,14,0,16,2,32
7/1/2001,9,0,11,7,27
7/2/2001,16,0,7,16,39
7/3/2001,14,0,12,2,28
7/4/2001,8,0,6,14,28
7/5/2001,9,0,10,11,30
7/6/2001,9,0,9,3,21
7/7/2001,5,0,13,1,19
7/8/2001,8,0,8,6,22
7/9/2001,11,0,15,10,36
7/10/2001,6,0,9,10,25
7/11/2001,14,0,3,9,26
7/12/2001,4,0,14,1,19
7/13/2001,16,0,12,0,28
7/14/2001,14,0,13,6,33
7/15/2001,11,0,14,14,39
7/16/2001,14,0,7,14,35
7/17/2001,4,0,11,8,23
7/18/2001,12,0,8,8,28
7/19/2001,10,0,9,7,26
7/20/2001,6,0,12,1,19
7/21/2001,16,0,3,13,32
7/22/2001,16,0,7,6,29
7/23/2001,8,0,14,12,34
7/24/2001,9,0,11,4,24
7/25/2001,7,0,2,16,25
7/26/2001,8,0,10,13,31
7/27/2001,12,0,2,9,23
7/28/2001,12,0,15,3,30
7/29/2001,13,0,3,5,21
7/30/2001,6,0,16,5,27
7/31/2001,10,0,7,6,23
8/1/2001,13,0,9,2,24
8/2/2001,5,0,16,12,33
8/3/2001,15,0,14,13,42
8/4/2001,16,0,6,12,34
8/5/2001,13,0,2,0,15
8/6/2001,16,0,10,6,32
8/7/2001,7,0,2,16,25
8/8/2001,11,0,5,8,24
8/9/2001,6,0,9,1,16
8/10/2001,9,0,2,2,13
8/11/2001,8,0,15,12,35
8/12/2001,6,0,15,4,25
8/13/2001,12,0,5,11,28
8/14/2001,16,0,10,8,34
8/15/2001,8,0,13,0,21
8/16/2001,4,0,12,7,23
8/17/2001,16,0,5,2,23
8/18/2001,5,0,8,4,17
8/19/2001,15,0,13,8,36
8/20/2001,13,0,15,9,37
8/21/2001,11,0,14,6,31
8/22/2001,5,0,8,0,13
8/23/2001,14,0,7,15,36
8/24/2001,10,0,7,10,27
8/25/2001,5,0,4,8,17
8/26/2001,15,0,11,9,35
8/27/2001,6,0,12,1,19
8/28/2001,13,0,9,11,33
8/29/2001,11,0,7,16,34
8/30/2001,16,0,11,1,28
8/31/2001,4,0,10,4,18
9/1/2001,16,0,16,4,36
9/2/2001,4,0,15,4,23
9/3/2001,5,0,8,15,28
9/4/2001,11,0,15,11,37
9/5/2001,6,0,11,13,30
9/6/2001,14,0,4,1,19
9/7/2001,13,0,16,2,31
9/8/2001,16,0,7,8,31
9/9/2001,4,0,7,10,21
9/10/2001,15,0,16,13,44
9/11/2001,13,0,10,10,33
9/12/2001,9,0,16,15,40
9/13/2001,6,0,5,16,27
9/14/2001,10,0,16,6,32
9/15/2001,5,0,13,7,25
9/16/2001,13,0,5,6,24
9/17/2001,13,0,3,10,26
9/18/2001,14,0,10,0,24
9/19/2001,5,0,15,13,33
9/20/2001,12,0,10,9,31
9/21/2001,9,0,8,3,20
9/22/2001,10,0,15,10,35
9/23/2001,8,0,6,5,19
9/24/2001,4,0,3,9,16
9/25/2001,7,0,4,15,26
9/26/2001,10,0,10,7,27
9/27/2001,15,0,11,13,39
9/28/2001,4,0,3,12,19
9/29/2001,4,0,12,2,18
9/30/2001,11,0,16,11,38
10/1/2001,10,0,10,1,21
10/2/2001,7,0,3,11,21
10/3/2001,6,0,13,11,30
10/4/2001,8,0,8,12,28
10/5/2001,12,0,15,1,28
10/6/2001,5,0,7,6,18
10/7/2001,14,0,4,7,25
10/8/2001,5,0,7,9,21
10/9/2001,11,0,5,7,23
10/10/2001,11,0,13,16,40
10/11/2001,16,0,9,4,29
10/12/2001,11,0,15,3,29
10/13/2001,14,0,9,1,24
10/14/2001,13,0,6,14,33
10/15/2001,15,0,11,7,33
10/16/2001,9,0,6,7,22
10/17/2001,5,0,3,3,11
10/18/2001,7,0,13,0,20
10/19/2001,13,0,11,11,35
10/20/2001,16,0,5,0,21
10/21/2001,10,0,7,7,24
10/22/2001,6,0,8,8,22
10/23/2001,15,0,8,0,23
10/24/2001,12,0,12,14,38
10/25/2001,15,0,9,14,38
10/26/2001,16,0,14,11,41
10/27/2001,9,0,13,9,31
10/28/2001,12,0,15,14,41
10/29/2001,7,0,16,12,35
10/30/2001,11,0,4,8,23
10/31/2001,9,0,15,16,40
11/1/2001,14,0,15,9,38
11/2/2001,15,0,16,5,36
11/3/2001,6,0,8,16,30
11/4/2001,7,0,14,14,35
11/5/2001,16,0,16,13,45
11/6/2001,6,0,2,5,13
11/7/2001,13,0,4,13,30
11/8/2001,11,0,4,12,27
11/9/2001,8,0,13,16,37
11/10/2001,12,0,5,16,33
11/11/2001,13,0,6,3,22
11/12/2001,10,0,7,3,20
11/13/2001,6,0,11,14,31
11/14/2001,5,0,3,3,11
11/15/2001,9,0,9,0,18
11/16/2001,14,0,4,15,33
11/17/2001,8,0,16,1,25
11/18/2001,12,0,4,12,28
11/19/2001,13,0,7,11,31
11/20/2001,10,0,14,13,37
11/21/2001,5,0,3,15,23
11/22/2001,13,0,4,0,17
11/23/2001,15,0,10,13,38
11/24/2001,11,0,14,16,41
11/25/2001,13,0,15,5,33
11/26/2001,9,0,7,14,30
11/27/2001,16,0,7,13,36
11/28/2001,14,0,3,7,24
11/29/2001,4,0,7,5,16
11/30/2001,5,0,14,11,30
12/1/2001,15,0,14,15,44
12/2/2001,16,0,3,0,19
12/3/2001,16,0,14,13,43
12/4/2001,14,0,13,7,34
12/5/2001,13,0,2,14,29
12/6/2001,4,0,6,16,26
12/7/2001,11,0,15,14,40
12/8/2001,4,0,5,1,10
12/9/2001,5,0,3,5,13
12/10/2001,12,0,5,5,22
12/11/2001,7,0,4,9,20
12/12/2001,7,0,12,16,35
12/13/2001,16,0,7,8,31
12/14/2001,4,0,8,10,22
12/15/2001,15,0,16,12,43
12/16/2001,8,0,2,11,21
12/17/2001,11,0,13,7,31
12/18/2001,8,0,7,10,25
12/19/2001,5,0,12,15,32
12/20/2001,8,0,8,16,32
12/21/2001,4,0,16,8,28
12/22/2001,11,0,2,9,22
12/23/2001,9,0,10,13,32
12/24/2001,12,0,10,11,33
12/25/2001,15,0,2,4,21
12/26/2001,15,0,14,5,34
12/27/2001,8,0,10,11,29
12/28/2001,11,0,9,15,35
12/29/2001,14,0,14,16,44
12/30/2001,9,0,3,4,16
12/31/2001,10,0,8,6,24
1/1/2002,7,0,14,14,35
1/2/2002,8,0,14,8,30
1/3/2002,11,0,11,16,38
1/4/2002,11,0,3,15,29
1/5/2002,13,0,3,10,26
1/6/2002,5,0,14,2,21
1/7/2002,4,0,9,0,13
1/8/2002,6,0,7,6,19
1/9/2002,13,0,4,13,30
1/10/2002,5,0,6,14,25
1/11/2002,6,0,10,6,22
1/12/2002,15,0,13,10,38
1/13/2002,15,0,12,0,27
1/14/2002,10,0,4,14,28
1/15/2002,6,0,2,9,17
1/16/2002,8,0,12,14,34
1/17/2002,4,0,3,6,13
1/18/2002,5,0,15,12,32
1/19/2002,14,0,6,7,27
1/20/2002,11,0,3,13,27
1/21/2002,8,0,3,2,13
1/22/2002,6,0,8,11,25
1/23/2002,12,0,4,7,23
1/24/2002,6,0,5,15,26
1/25/2002,8,0,7,12,27
1/26/2002,9,0,13,1,23
1/27/2002,5,0,7,5,17
1/28/2002,13,0,10,14,37
1/29/2002,14,0,10,15,39
1/30/2002,5,0,15,6,26
1/31/2002,15,0,16,14,45
2/1/2002,5,0,5,3,13
2/2/2002,14,0,4,6,24
2/3/2002,8,0,13,7,28
2/4/2002,15,0,4,15,34
2/5/2002,5,0,6,0,11
2/6/2002,14,0,12,4,30
2/7/2002,13,0,16,12,41
2/8/2002,11,0,12,0,23
2/9/2002,14,0,10,10,34
2/10/2002,6,0,14,5,25
2/11/2002,8,0,14,6,28
2/12/2002,9,0,10,3,22
2/13/2002,12,0,15,4,31
2/14/2002,12,0,2,11,25
2/15/2002,8,0,5,15,28
2/16/2002,4,0,10,2,16
2/17/2002,4,0,14,5,23
2/18/2002,9,0,4,12,25
2/19/2002,5,0,2,5,12
2/20/2002,4,0,12,14,30
2/21/2002,10,0,9,14,33
2/22/2002,14,0,4,3,21
2/23/2002,5,0,9,5,19
2/24/2002,5,0,7,15,27
2/25/2002,10,0,10,12,32
2/26/2002,15,0,15,10,40
2/27/2002,4,0,7,12,23
2/28/2002,5,0,2,2,9
3/1/2002,10,0,3,12,25
3/2/2002,14,0,13,6,33
3/3/2002,6,0,10,4,20
3/4/2002,16,0,14,3,33
3/5/2002,10,0,6,15,31
3/6/2002,9,0,8,8,25
3/7/2002,9,0,9,15,33
3/8/2002,12,0,5,3,20
3/9/2002,8,0,5,16,29
3/10/2002,5,0,7,11,23
3/11/2002,8,0,3,11,22
3/12/2002,6,0,9,3,18
3/13/2002,4,0,10,9,23
3/14/2002,6,0,9,11,26
3/15/2002,12,0,8,4,24
3/16/2002,7,0,9,1,17
3/17/2002,13,0,7,3,23
3/18/2002,11,0,8,6,25
3/19/2002,7,0,10,15,32
3/20/2002,8,0,13,9,30
3/21/2002,8,0,8,14,30
3/22/2002,16,0,7,2,25
3/23/2002,14,0,3,6,23
3/24/2002,16,0,8,8,32
3/25/2002,14,0,6,9,29
3/26/2002,9,0,2,10,21
3/27/2002,8,0,10,11,29
3/28/2002,7,0,7,2,16
3/29/2002,6,0,2,15,23
3/30/2002,5,0,10,14,29
3/31/2002,10,0,13,10,33
4/1/2002,16,0,13,5,34
4/2/2002,10,0,13,14,37
4/3/2002,7,0,8,3,18
4/4/2002,10,0,7,10,27
4/5/2002,16,0,13,8,37
4/6/2002,15,0,12,5,32
4/7/2002,13,0,2,9,24
4/8/2002,12,0,7,7,26
4/9/2002,14,0,11,8,33
4/10/2002,15,0,13,15,43
4/11/2002,16,0,12,12,40
4/12/2002,15,0,4,6,25
4/13/2002,8,0,5,11,24
4/14/2002,14,0,5,3,22
4/15/2002,8,0,6,1,15
4/16/2002,7,0,4,7,18
4/17/2002,11,0,11,9,31
4/18/2002,11,0,11,0,22
4/19/2002,13,0,14,13,40
4/20/2002,11,0,12,6,29
4/21/2002,15,0,13,8,36
4/22/2002,15,0,6,15,36
4/23/2002,6,0,3,12,21
4/24/2002,13,0,7,0,20
4/25/2002,11,0,9,15,35
4/26/2002,4,0,3,1,8
4/27/2002,16,0,15,4,35
4/28/2002,10,0,9,12,31
4/29/2002,12,0,8,1,21
4/30/2002,5,0,13,13,31
5/1/2002,4,0,9,11,24
5/2/2002,16,0,4,10,30
5/3/2002,13,0,16,12,41
5/4/2002,11,0,3,12,26
5/5/2002,8,0,12,4,24
5/6/2002,10,0,15,8,33
5/7/2002,7,0,15,7,29
5/8/2002,5,0,15,4,24
5/9/2002,11,0,11,4,26
5/10/2002,5,0,7,15,27
5/11/2002,5,0,12,1,18
5/12/2002,7,0,2,0,9
5/13/2002,16,0,16,5,37
5/14/2002,9,0,16,11,36
5/15/2002,6,0,3,3,12
5/16/2002,4,0,8,5,17
5/17/2002,6,0,14,13,33
5/18/2002,10,0,2,14,26
5/19/2002,5,0,11,15,31
5/20/2002,12,0,8,0,20
5/21/2002,6,0,6,10,22
5/22/2002,11,0,13,8,32
5/23/2002,11,0,2,2,15
5/24/2002,6,0,4,10,20
5/25/2002,6,0,8,1,15
5/26/2002,7,0,15,14,36
5/27/2002,15,0,13,0,28
5/28/2002,12,0,15,8,35
5/29/2002,14,0,15,12,41
5/30/2002,10,0,8,12,30
5/31/2002,11,0,9,11,31
6/1/2002,12,0,11,12,35
6/2/2002,15,0,15,2,32
6/3/2002,9,0,9,3,21
6/4/2002,15,0,2,0,17
6/5/2002,15,0,5,0,20
6/6/2002,10,0,14,2,26
6/7/2002,11,0,4,0,15
6/8/2002,5,0,11,16,32
6/9/2002,4,0,6,7,17
6/10/2002,16,0,10,6,32
6/11/2002,12,0,16,1,29
6/12/2002,8,0,3,13,24
6/13/2002,11,0,7,4,22
6/14/2002,14,0,9,7,30
6/15/2002,4,0,15,8,27
6/16/2002,6,0,8,10,24
6/17/2002,5,0,11,6,22
6/18/2002,14,0,5,16,35
6/19/2002,8,0,14,3,25
6/20/2002,4,0,2,13,19
6/21/2002,13,0,15,1,29
6/22/2002,6,0,5,8,19
6/23/2002,4,0,2,3,9
6/24/2002,6,0,9,9,24
6/25/2002,12,0,4,10,26
6/26/2002,10,0,10,4,24
6/27/2002,10,0,12,10,32
6/28/2002,15,0,13,7,35
6/29/2002,6,0,12,12,30
6/30/2002,14,0,16,5,35
7/1/2002,5,0,10,9,24
7/2/2002,5,0,13,2,20
7/3/2002,15,0,8,5,28
7/4/2002,9,0,4,5,18
7/5/2002,10,0,16,3,29
7/6/2002,8,0,7,9,24
7/7/2002,10,0,15,1,26
7/8/2002,6,0,13,12,31
7/9/2002,11,0,6,11,28
7/10/2002,11,0,16,0,27
7/11/2002,11,0,2,5,18
7/12/2002,12,0,3,7,22
7/13/2002,7,0,9,5,21
7/14/2002,12,0,16,14,42
7/15/2002,16,0,14,3,33
7/16/2002,8,0,7,2,17
7/17/2002,11,0,6,7,24
7/18/2002,16,0,7,11,34
7/19/2002,12,0,6,1,19
7/20/2002,14,0,10,14,38
7/21/2002,14,0,14,5,33
7/22/2002,14,0,2,11,27
7/23/2002,4,0,9,10,23
7/24/2002,14,0,7,5,26
7/25/2002,12,0,12,15,39
7/26/2002,9,0,2,5,16
7/27/2002,9,0,4,5,18
7/28/2002,15,0,3,15,33
7/29/2002,13,0,4,9,26
7/30/2002,10,0,12,3,25
7/31/2002,15,0,8,13,36
8/1/2002,15,0,7,4,26
8/2/2002,13,0,13,0,26
8/3/2002,5,0,16,3,24
8/4/2002,5,0,8,15,28
8/5/2002,15,0,2,3,20
8/6/2002,15,0,5,3,23
8/7/2002,12,0,3,13,28
8/8/2002,16,0,2,3,21
8/9/2002,4,0,14,5,23
8/10/2002,9,0,7,1,17
8/11/2002,8,0,8,1,17
8/12/2002,10,0,14,9,33
8/13/2002,7,0,12,0,19
8/14/2002,14,0,8,6,28
8/15/2002,6,0,3,4,13
8/16/2002,8,0,14,14,36
8/17/2002,8,0,15,3,26
8/18/2002,8,0,9,2,19
8/19/2002,13,0,13,11,37
8/20/2002,7,0,6,2,15
8/21/2002,14,0,2,11,27
8/22/2002,7,0,16,3,26
8/23/2002,14,0,2,2,18
8/24/2002,12,0,16,9,37
8/25/2002,7,0,2,9,18
8/26/2002,12,0,14,9,35
8/27/2002,6,0,7,16,29
8/28/2002,8,0,6,10,24
8/29/2002,16,0,9,8,33
8/30/2002,5,0,15,3,23
8/31/2002,6,0,10,16,32
9/1/2002,4,0,14,14,32
9/2/2002,5,0,10,11,26
9/3/2002,15,0,2,12,29
9/4/2002,9,0,11,7,27
9/5/2002,14,0,6,12,32
9/6/2002,13,0,9,12,34
9/7/2002,9,0,13,8,30
9/8/2002,10,0,11,12,33
9/9/2002,10,0,13,9,32
9/10/2002,9,0,8,3,20
9/11/2002,4,0,3,3,10
9/12/2002,4,0,9,2,15
9/13/2002,14,0,6,3,23
9/14/2002,5,0,7,11,23
9/15/2002,14,0,6,2,22
9/16/2002,5,0,6,5,16
9/17/2002,14,0,14,2,30
9/18/2002,5,0,12,0,17
9/19/2002,8,0,10,15,33
9/20/2002,13,0,14,14,41
9/21/2002,11,0,10,8,29
9/22/2002,7,0,14,0,21
9/23/2002,9,0,11,1,21
9/24/2002,12,0,3,9,24
9/25/2002,11,0,7,2,20
9/26/2002,10,0,15,0,25
9/27/2002,11,0,15,7,33
9/28/2002,9,0,6,10,25
9/29/2002,7,0,15,13,35
9/30/2002,14,0,4,0,18
10/1/2002,10,0,10,16,36
10/2/2002,16,0,7,13,36
10/3/2002,8,0,11,6,25
10/4/2002,4,0,2,0,6
10/5/2002,15,0,16,7,38
10/6/2002,13,0,4,0,17
10/7/2002,9,0,3,1,13
10/8/2002,5,0,6,9,20
10/9/2002,15,0,11,0,26
10/10/2002,7,0,3,5,15
10/11/2002,13,0,11,5,29
10/12/2002,16,0,8,15,39
10/13/2002,6,0,4,15,25
10/14/2002,16,0,3,13,32
10/15/2002,9,0,9,12,30
10/16/2002,7,0,2,1,10
10/17/2002,15,0,7,4,26
10/18/2002,5,0,14,12,31
10/19/2002,9,0,8,5,22
10/20/2002,11,0,4,11,26
10/21/2002,16,0,4,13,33
10/22/2002,16,0,12,10,38
10/23/2002,9,0,7,4,20
10/24/2002,5,0,8,16,29
10/25/2002,7,0,2,6,15
10/26/2002,7,0,4,0,11
10/27/2002,16,0,2,7,25
10/28/2002,16,0,4,2,22
10/29/2002,6,0,4,4,14
10/30/2002,8,0,14,14,36
10/31/2002,12,0,13,15,40
11/1/2002,14,0,2,8,24
11/2/2002,7,0,7,9,23
11/3/2002,14,0,10,0,24
11/4/2002,14,0,11,7,32
11/5/2002,13,0,10,3,26
11/6/2002,12,0,9,0,21
11/7/2002,7,0,14,3,24
11/8/2002,13,0,5,10,28
11/9/2002,6,0,6,10,22
11/10/2002,13,0,6,2,21
11/11/2002,15,0,5,3,23
11/12/2002,10,0,14,4,28
11/13/2002,14,0,4,16,34
11/14/2002,16,0,3,3,22
11/15/2002,16,0,9,3,28
11/16/2002,15,0,8,1,24
11/17/2002,8,0,4,16,28
11/18/2002,6,0,9,13,28
11/19/2002,9,0,7,5,21
11/20/2002,14,0,14,15,43
11/21/2002,5,0,7,6,18
11/22/2002,11,0,12,2,25
11/23/2002,13,0,3,12,28
11/24/2002,14,0,12,10,36
11/25/2002,8,0,13,11,32
11/26/2002,6,0,3,9,18
11/27/2002,8,0,4,14,26
11/28/2002,14,0,7,5,26
11/29/2002,9,0,9,14,32
11/30/2002,9,0,8,9,26
12/1/2002,10,0,5,1,16
12/2/2002,6,0,4,7,17
12/3/2002,8,0,4,1,13
12/4/2002,10,0,15,2,27
12/5/2002,5,0,15,15,35
12/6/2002,16,0,9,12,37
12/7/2002,16,0,16,0,32
12/8/2002,8,0,14,15,37
12/9/2002,12,0,7,13,32
12/10/2002,15,0,13,15,43
12/11/2002,11,0,2,15,28
12/12/2002,4,0,14,9,27
12/13/2002,6,0,8,6,20
12/14/2002,16,0,7,9,32
12/15/2002,9,0,2,13,24
12/16/2002,13,0,12,5,30
12/17/2002,12,0,8,10,30
12/18/2002,10,0,2,11,23
12/19/2002,5,0,3,7,15
12/20/2002,15,0,9,10,34
12/21/2002,11,0,5,0,16
12/22/2002,15,0,16,12,43
12/23/2002,13,0,4,13,30
12/24/2002,9,0,4,4,17
12/25/2002,5,0,14,4,23
12/26/2002,13,0,16,2,31
12/27/2002,15,0,9,13,37
12/28/2002,9,0,15,6,30
12/29/2002,5,0,12,5,22
12/30/2002,14,0,6,8,28
12/31/2002,14,0,2,11,27
1/1/2003,4,0,15,15,34
1/2/2003,16,0,11,13,40
1/3/2003,11,0,6,6,23
1/4/2003,16,0,16,10,42
1/5/2003,10,0,2,9,21
1/6/2003,11,0,6,11,28
1/7/2003,10,0,11,0,21
1/8/2003,13,0,9,13,35
1/9/2003,14,0,10,9,33
1/10/2003,4,0,8,0,12
1/11/2003,6,0,8,3,17
1/12/2003,12,0,11,13,36
1/13/2003,5,0,9,15,29
1/14/2003,9,0,5,3,17
1/15/2003,13,0,11,12,36
1/16/2003,13,0,11,8,32
1/17/2003,12,0,6,14,32
1/18/2003,9,0,11,2,22
1/19/2003,10,0,8,12,30
1/20/2003,7,0,8,16,31
1/21/2003,12,0,3,10,25
1/22/2003,7,0,15,14,36
1/23/2003,15,0,10,8,33
1/24/2003,10,0,7,1,18
1/25/2003,12,0,8,2,22
1/26/2003,7,0,9,13,29
1/27/2003,10,0,4,0,14
1/28/2003,6,0,12,9,27
1/29/2003,6,0,7,6,19
1/30/2003,15,0,8,6,29
1/31/2003,4,0,4,4,12
2/1/2003,4,0,10,2,16
2/2/2003,13,0,16,8,37
2/3/2003,13,0,5,5,23
2/4/2003,9,0,9,11,29
2/5/2003,7,0,6,11,24
2/6/2003,9,0,16,6,31
2/7/2003,12,0,3,4,19
2/8/2003,12,0,8,15,35
2/9/2003,9,0,2,10,21
2/10/2003,15,0,11,9,35
2/11/2003,12,0,15,3,30
2/12/2003,5,0,3,13,21
2/13/2003,6,0,14,3,23
2/14/2003,11,0,9,3,23
2/15/2003,13,0,8,15,36
2/16/2003,14,0,2,3,19
2/17/2003,10,0,14,14,38
2/18/2003,12,0,9,10,31
2/19/2003,16,0,10,15,41
2/20/2003,12,0,3,11,26
2/21/2003,15,0,8,14,37
2/22/2003,9,0,14,7,30
2/23/2003,9,0,15,2,26
2/24/2003,5,0,3,16,24
2/25/2003,8,0,7,6,21
2/26/2003,7,0,13,14,34
2/27/2003,13,0,4,9,26
2/28/2003,14,0,15,3,32
3/1/2003,4,0,4,6,14
3/2/2003,6,0,6,7,19
3/3/2003,9,0,10,10,29
3/4/2003,8,0,2,13,23
3/5/2003,10,0,10,6,26
3/6/2003,8,0,4,4,16
3/7/2003,4,0,16,1,21
3/8/2003,15,0,3,14,32
3/9/2003,16,0,9,13,38
3/10/2003,12,0,5,0,17
3/11/2003,11,0,2,0,13
3/12/2003,14,0,7,9,30
3/13/2003,10,0,9,1,20
3/14/2003,12,0,2,9,23
3/15/2003,4,0,6,16,26
3/16/2003,10,0,16,2,28
3/17/2003,12,0,9,9,30
3/18/2003,13,0,13,15,41
3/19/2003,7,0,10,5,22
3/20/2003,5,0,9,13,27
3/21/2003,13,0,10,1,24
3/22/2003,16,0,6,5,27
3/23/2003,12,0,9,2,23
3/24/2003,16,0,10,15,41
3/25/2003,15,0,9,10,34
3/26/2003,11,0,6,12,29
3/27/2003,5,0,4,14,23
3/28/2003,8,0,7,2,17
3/29/2003,16,0,2,7,25
3/30/2003,4,0,8,3,15
3/31/2003,5,0,6,2,13
4/1/2003,9,0,16,2,27
4/2/2003,15,0,3,14,32
4/3/2003,8,0,14,0,22
4/4/2003,10,0,16,6,32
4/5/2003,4,0,15,2,21
4/6/2003,7,0,14,1,22
4/7/2003,4,0,11,13,28
4/8/2003,13,0,14,2,29
4/9/2003,6,0,3,1,10
4/10/2003,8,0,12,16,36
4/11/2003,14,0,7,15,36
4/12/2003,5,0,9,2,16
4/13/2003,15,0,13,5,33
4/14/2003,13,0,5,14,32
4/15/2003,16,0,15,0,31
4/16/2003,12,0,8,2,22
4/17/2003,12,0,15,7,34
4/18/2003,5,0,10,5,20
4/19/2003,16,0,7,12,35
4/20/2003,8,0,4,14,26
4/21/2003,15,0,10,1,26
4/22/2003,6,0,6,3,15
4/23/2003,6,0,9,2,17
4/24/2003,7,0,6,10,23
4/25/2003,8,0,4,5,17
4/26/2003,7,0,8,3,18
4/27/2003,13,0,7,2,22
4/28/2003,16,0,13,14,43
4/29/2003,5,0,14,13,32
4/30/2003,4,0,2,1,7
5/1/2003,16,0,5,5,26
5/2/2003,15,0,10,15,40
5/3/2003,15,0,15,2,32
5/4/2003,16,0,11,15,42
5/5/2003,4,0,11,5,20
5/6/2003,16,0,15,13,44
5/7/2003,4,0,10,8,22
5/8/2003,16,0,15,13,44
5/9/2003,8,0,6,1,15
5/10/2003,8,0,8,13,29
5/11/2003,11,0,12,1,24
5/12/2003,4,0,14,3,21
5/13/2003,14,0,7,10,31
5/14/2003,7,0,13,9,29
5/15/2003,11,0,6,12,29
5/16/2003,10,0,9,16,35
5/17/2003,12,0,7,16,35
5/18/2003,16,0,11,5,32
5/19/2003,4,0,11,4,19
5/20/2003,10,0,6,5,21
5/21/2003,9,0,13,14,36
5/22/2003,7,0,13,8,28
5/23/2003,4,0,16,0,20
5/24/2003,16,0,16,15,47
5/25/2003,6,0,5,13,24
5/26/2003,15,0,4,11,30
5/27/2003,10,0,4,4,18
5/28/2003,13,0,15,7,35
5/29/2003,16,0,9,2,27
5/30/2003,6,0,3,16,25
5/31/2003,10,0,16,13,39
6/1/2003,13,0,6,16,35
6/2/2003,6,0,4,2,12
6/3/2003,9,0,9,3,21
6/4/2003,13,0,8,11,32
6/5/2003,10,0,6,11,27
6/6/2003,5,0,14,1,20
6/7/2003,16,0,14,2,32
6/8/2003,16,0,11,15,42
6/9/2003,7,0,15,12,34
6/10/2003,13,0,5,4,22
6/11/2003,5,0,11,16,32
6/12/2003,11,0,3,14,28
6/13/2003,8,0,12,14,34
6/14/2003,12,0,14,12,38
6/15/2003,16,0,16,8,40
6/16/2003,14,0,9,1,24
6/17/2003,13,0,4,5,22
6/18/2003,7,0,5,11,23
6/19/2003,12,0,5,3,20
6/20/2003,15,0,12,8,35
6/21/2003,6,0,10,5,21
6/22/2003,10,0,14,13,37
6/23/2003,13,0,6,5,24
6/24/2003,6,0,10,6,22
6/25/2003,14,0,7,6,27
6/26/2003,7,0,13,3,23
6/27/2003,8,0,11,12,31
6/28/2003,9,0,11,10,30
6/29/2003,13,0,2,4,19
6/30/2003,11,0,6,6,23
7/1/2003,15,0,11,10,36
7/2/2003,8,0,9,2,19
7/3/2003,12,0,3,7,22
7/4/2003,13,0,8,11,32
7/5/2003,15,0,15,6,36
7/6/2003,7,0,2,16,25
7/7/2003,13,0,16,5,34
7/8/2003,6,0,16,3,25
7/9/2003,5,0,3,9,17
7/10/2003,9,0,4,16,29
7/11/2003,13,0,4,0,17
7/12/2003,15,0,3,7,25
7/13/2003,6,0,16,10,32
7/14/2003,9,0,16,14,39
7/15/2003,14,0,11,12,37
7/16/2003,7,0,10,13,30
7/17/2003,7,0,10,0,17
7/18/2003,10,0,8,15,33
7/19/2003,13,0,16,3,32
7/20/2003,13,0,10,12,35
7/21/2003,14,0,14,16,44
7/22/2003,12,0,5,0,17
7/23/2003,7,0,3,11,21
7/24/2003,7,0,6,8,21
7/25/2003,8,0,11,11,30
7/26/2003,10,0,9,14,33
7/27/2003,16,0,8,12,36
7/28/2003,9,0,6,16,31
7/29/2003,7,0,5,16,28
7/30/2003,9,0,15,4,28
7/31/2003,15,0,12,6,33
8/1/2003,12,0,4,16,32
8/2/2003,15,0,10,6,31
8/3/2003,13,0,7,13,33
8/4/2003,14,0,15,13,42
8/5/2003,13,0,15,3,31
8/6/2003,15,0,4,11,30
8/7/2003,8,0,6,6,20
8/8/2003,11,0,15,5,31
8/9/2003,7,0,5,8,20
8/10/2003,14,0,10,5,29
8/11/2003,15,0,3,5,23
8/12/2003,8,0,3,6,17
8/13/2003,5,0,12,12,29
8/14/2003,13,0,9,10,32
8/15/2003,4,0,14,2,20
8/16/2003,9,0,5,13,27
8/17/2003,6,0,7,1,14
8/18/2003,5,0,10,7,22
8/19/2003,5,0,8,14,27
8/20/2003,13,0,13,1,27
8/21/2003,12,0,12,7,31
8/22/2003,4,0,16,3,23
8/23/2003,14,0,3,11,28
8/24/2003,4,0,6,5,15
8/25/2003,7,0,9,12,28
8/26/2003,13,0,8,4,25
8/27/2003,16,0,11,2,29
8/28/2003,9,0,14,6,29
8/29/2003,15,0,8,9,32
8/30/2003,9,0,16,14,39
8/31/2003,10,0,8,16,34
9/1/2003,8,0,6,4,18
9/2/2003,16,0,2,1,19
9/3/2003,8,0,13,6,27
9/4/2003,15,0,3,12,30
9/5/2003,10,0,10,0,20
9/6/2003,15,0,3,10,28
9/7/2003,12,0,2,4,18
9/8/2003,5,0,2,14,21
9/9/2003,16,0,2,7,25
9/10/2003,11,0,2,9,22
9/11/2003,11,0,4,4,19
9/12/2003,9,0,13,1,23
9/13/2003,5,0,7,16,28
9/14/2003,9,0,12,2,23
9/15/2003,16,0,9,2,27
9/16/2003,10,0,9,13,32
9/17/2003,4,0,16,0,20
9/18/2003,8,0,9,7,24
9/19/2003,8,0,3,2,13
9/20/2003,13,0,5,3,21
9/21/2003,6,0,12,13,31
9/22/2003,9,0,2,2,13
9/23/2003,6,0,15,5,26
9/24/2003,16,0,3,13,32
9/25/2003,6,0,16,10,32
9/26/2003,8,0,7,6,21
9/27/2003,7,0,15,4,26
9/28/2003,13,0,2,7,22
9/29/2003,16,0,7,13,36
9/30/2003,13,0,16,10,39
10/1/2003,15,0,10,11,36
10/2/2003,6,0,16,0,22
10/3/2003,15,0,14,4,33
10/4/2003,5,0,12,14,31
10/5/2003,14,0,10,2,26
10/6/2003,14,0,8,2,24
10/7/2003,14,0,3,14,31
10/8/2003,11,0,3,3,17
10/9/2003,12,0,7,3,22
10/10/2003,14,0,2,13,29
10/11/2003,12,0,14,13,39
10/12/2003,7,0,16,13,36
10/13/2003,9,0,11,6,26
10/14/2003,4,0,2,4,10
10/15/2003,6,0,16,9,31
10/16/2003,5,0,16,2,23
10/17/2003,16,0,6,1,23
10/18/2003,6,0,5,8,19
10/19/2003,6,0,15,3,24
10/20/2003,10,0,10,16,36
10/21/2003,6,0,13,14,33
10/22/2003,4,0,14,0,18
10/23/2003,6,0,14,11,31
10/24/2003,10,0,10,6,26
10/25/2003,16,0,2,1,19
10/26/2003,9,0,8,15,32
10/27/2003,10,0,10,14,34
10/28/2003,16,0,14,5,35
10/29/2003,8,0,8,3,19
10/30/2003,11,0,4,6,21
10/31/2003,7,0,10,15,32
11/1/2003,7,0,14,4,25
11/2/2003,6,0,15,6,27
11/3/2003,4,0,5,15,24
11/4/2003,13,0,7,2,22
11/5/2003,9,0,10,2,21
11/6/2003,4,0,5,0,9
11/7/2003,6,0,10,6,22
11/8/2003,6,0,8,6,20
11/9/2003,15,0,16,2,33
11/10/2003,14,0,4,15,33
11/11/2003,10,0,2,3,15
11/12/2003,8,0,7,7,22
11/13/2003,14,0,2,1,17
11/14/2003,10,0,3,0,13
11/15/2003,10,0,3,9,22
11/16/2003,13,0,8,12,33
11/17/2003,8,0,9,1,18
11/18/2003,5,0,2,16,23
11/19/2003,5,0,6,3,14
11/20/2003,5,0,14,9,28
11/21/2003,11,0,3,13,27
11/22/2003,12,0,12,10,34
11/23/2003,16,0,4,14,34
11/24/2003,16,0,16,6,38
11/25/2003,5,0,12,14,31
11/26/2003,13,0,9,7,29
11/27/2003,11,0,5,11,27
11/28/2003,15,0,8,10,33
11/29/2003,12,0,8,10,30
11/30/2003,8,0,10,7,25
12/1/2003,5,0,8,12,25
12/2/2003,5,0,14,7,26
12/3/2003,7,0,12,0,19
12/4/2003,5,0,9,13,27
12/5/2003,5,0,15,4,24
12/6/2003,12,0,15,9,36
12/7/2003,10,0,2,3,15
12/8/2003,9,0,10,1,20
12/9/2003,9,0,9,15,33
12/10/2003,9,0,4,12,25
12/11/2003,13,0,16,11,40
12/12/2003,12,0,4,3,19
12/13/2003,7,0,7,14,28
12/14/2003,14,0,8,6,28
12/15/2003,4,0,14,0,18
12/16/2003,14,0,6,12,32
12/17/2003,8,0,5,9,22
12/18/2003,12,0,10,0,22
12/19/2003,4,0,16,0,20
12/20/2003,8,0,2,6,16
12/21/2003,8,0,14,10,32
12/22/2003,8,0,6,9,23
12/23/2003,9,0,12,0,21
12/24/2003,11,0,4,4,19
12/25/2003,16,0,16,16,48
12/26/2003,8,0,8,6,22
12/27/2003,10,0,3,15,28
12/28/2003,10,0,3,8,21
12/29/2003,5,0,8,15,28
12/30/2003,13,0,13,4,30
12/31/2003,12,0,7,5,24
1/1/2004,7,0,9,11,27
1/2/2004,13,0,16,7,36
1/3/2004,12,0,14,8,34
1/4/2004,9,0,14,2,25
1/5/2004,6,0,3,14,23
1/6/2004,13,0,5,7,25
1/7/2004,16,0,9,3,28
1/8/2004,12,0,4,9,25
1/9/2004,14,0,7,8,29
1/10/2004,10,0,8,5,23
1/11/2004,16,0,13,14,43
1/12/2004,12,0,7,6,25
1/13/2004,15,0,16,14,45
1/14/2004,5,0,16,14,35
1/15/2004,15,0,7,15,37
1/16/2004,9,0,15,4,28
1/17/2004,15,0,8,7,30
1/18/2004,9,0,2,4,15
1/19/2004,4,0,3,16,23
1/20/2004,11,0,12,16,39
1/21/2004,11,0,14,13,38
1/22/2004,16,0,5,3,24
1/23/2004,11,0,11,4,26
1/24/2004,15,0,13,4,32
1/25/2004,5,0,12,10,27
1/26/2004,13,0,3,4,20
1/27/2004,5,0,4,8,17
1/28/2004,4,0,14,7,25
1/29/2004,4,0,12,9,25
1/30/2004,9,0,6,7,22
1/31/2004,4,0,5,15,24
2/1/2004,7,0,16,5,28
2/2/2004,12,0,14,8,34
2/3/2004,8,0,9,1,18
2/4/2004,8,0,7,2,17
2/5/2004,10,0,14,9,33
2/6/2004,6,0,7,16,29
2/7/2004,10,0,14,12,36
2/8/2004,7,0,2,11,20
2/9/2004,6,0,9,1,16
2/10/2004,6,0,12,12,30
2/11/2004,4,0,13,14,31
2/12/2004,7,0,12,4,23
2/13/2004,14,0,11,13,38
2/14/2004,14,0,11,15,40
2/15/2004,15,0,11,8,34
2/16/2004,14,0,11,11,36
2/17/2004,5,0,14,0,19
2/18/2004,14,0,14,4,32
2/19/2004,6,0,2,4,12
2/20/2004,6,0,3,15,24
2/21/2004,6,0,10,10,26
2/22/2004,13,0,2,10,25
2/23/2004,11,0,16,6,33
2/24/2004,11,0,15,6,32
2/25/2004,13,0,13,7,33
2/26/2004,10,0,10,10,30
2/27/2004,12,0,10,9,31
2/28/2004,10,0,5,5,20
2/29/2004,13,0,3,10,26
3/1/2004,6,0,16,2,24
3/2/2004,13,0,12,16,41
3/3/2004,4,0,12,10,26
3/4/2004,6,0,5,2,13
3/5/2004,14,0,13,8,35
3/6/2004,7,0,5,1,13
3/7/2004,16,0,3,15,34
3/8/2004,9,0,7,11,27
3/9/2004,8,0,12,14,34
3/10/2004,11,0,12,14,37
3/11/2004,13,0,9,3,25
3/12/2004,15,0,13,14,42
3/13/2004,8,0,4,0,12
3/14/2004,13,0,3,10,26
3/15/2004,10,0,13,14,37
3/16/2004,15,0,7,1,23
3/17/2004,6,0,12,13,31
3/18/2004,12,0,14,12,38
3/19/2004,12,0,7,5,24
3/20/2004,8,0,5,3,16
3/21/2004,13,0,15,10,38
3/22/2004,6,0,13,1,20
3/23/2004,5,0,6,11,22
3/24/2004,14,0,4,8,26
3/25/2004,15,0,7,7,29
3/26/2004,12,0,3,10,25
3/27/2004,16,0,12,12,40
3/28/2004,10,0,12,13,35
3/29/2004,8,0,5,13,26
3/30/2004,14,0,9,5,28
3/31/2004,5,0,2,0,7
4/1/2004,9,0,4,5,18
4/2/2004,16,0,4,16,36
4/3/2004,8,0,10,1,19
4/4/2004,13,0,10,10,33
4/5/2004,5,0,11,7,23
4/6/2004,16,0,15,1,32
4/7/2004,12,0,15,11,38
4/8/2004,15,0,13,9,37
4/9/2004,5,0,13,9,27
4/10/2004,16,0,3,4,23
4/11/2004,9,0,13,12,34
4/12/2004,13,0,9,16,38
4/13/2004,9,0,6,12,27
4/14/2004,6,0,8,13,27
4/15/2004,16,0,8,9,33
4/16/2004,12,0,16,12,40
4/17/2004,5,0,12,14,31
4/18/2004,15,0,16,8,39
4/19/2004,6,0,11,8,25
4/20/2004,8,0,8,1,17
4/21/2004,14,0,8,9,31
4/22/2004,15,0,2,9,26
4/23/2004,7,0,2,4,13
4/24/2004,12,0,14,12,38
4/25/2004,10,0,15,2,27
4/26/2004,6,0,9,4,19
4/27/2004,6,0,7,1,14
4/28/2004,15,0,7,12,34
4/29/2004,12,0,4,6,22
4/30/2004,15,0,4,7,26
5/1/2004,13,0,8,13,34
5/2/2004,15,0,13,9,37
5/3/2004,6,0,6,0,12
5/4/2004,5,0,10,16,31
5/5/2004,15,0,11,14,40
5/6/2004,15,0,14,7,36
5/7/2004,9,0,4,10,23
5/8/2004,16,0,16,8,40
5/9/2004,12,0,7,5,24
5/10/2004,15,0,8,5,28
5/11/2004,11,0,2,6,19
5/12/2004,6,0,3,2,11
5/13/2004,11,0,7,7,25
5/14/2004,4,0,15,14,33
5/15/2004,10,0,2,8,20
5/16/2004,15,0,3,1,19
5/17/2004,14,0,11,5,30
5/18/2004,9,0,2,13,24
5/19/2004,9,0,14,11,34
5/20/2004,14,0,9,12,35
5/21/2004,15,0,10,14,39
5/22/2004,10,0,3,7,20
5/23/2004,10,0,12,3,25
5/24/2004,4,0,3,10,17
5/25/2004,13,0,6,10,29
5/26/2004,10,0,16,6,32
5/27/2004,12,0,7,15,34
5/28/2004,9,0,4,15,28
5/29/2004,14,0,7,11,32
5/30/2004,10,0,11,7,28
5/31/2004,7,0,8,13,28
6/1/2004,10,0,13,8,31
6/2/2004,6,0,5,11,22
6/3/2004,14,0,11,3,28
6/4/2004,8,0,16,15,39
6/5/2004,15,0,3,10,28
6/6/2004,12,0,2,6,20
6/7/2004,8,0,8,4,20
6/8/2004,13,0,13,14,40
6/9/2004,8,0,4,15,27
6/10/2004,8,0,3,4,15
6/11/2004,11,0,11,6,28
6/12/2004,13,0,11,1,25
6/13/2004,13,0,12,13,38
6/14/2004,5,0,9,15,29
6/15/2004,4,0,11,7,22
6/16/2004,4,0,15,8,27
6/17/2004,12,0,13,14,39
6/18/2004,6,0,8,11,25
6/19/2004,13,0,3,5,21
6/20/2004,7,0,3,8,18
6/21/2004,7,0,2,0,9
6/22/2004,16,0,10,7,33
6/23/2004,14,0,3,1,18
6/24/2004,11,0,13,6,30
6/25/2004,10,0,3,8,21
6/26/2004,4,0,3,2,9
6/27/2004,12,0,2,15,29
6/28/2004,9,0,4,3,16
6/29/2004,10,0,15,1,26
6/30/2004,15,0,4,16,35
7/1/2004,15,0,8,4,27
7/2/2004,4,0,14,13,31
7/3/2004,15,0,12,0,27
7/4/2004,8,0,15,11,34
7/5/2004,7,0,13,12,32
7/6/2004,7,0,7,11,25
7/7/2004,12,0,13,8,33
7/8/2004,14,0,13,5,32
7/9/2004,12,0,14,2,28
7/10/2004,12,0,14,10,36
7/11/2004,11,0,3,5,19
7/12/2004,9,0,4,2,15
7/13/2004,9,0,7,1,17
7/14/2004,7,0,15,7,29
7/15/2004,6,0,10,14,30
7/16/2004,9,0,15,12,36
7/17/2004,11,0,16,6,33
7/18/2004,11,0,16,5,32
7/19/2004,8,0,3,14,25
7/20/2004,11,0,9,2,22
7/21/2004,7,0,12,15,34
7/22/2004,13,0,8,5,26
7/23/2004,8,0,13,3,24
7/24/2004,9,0,12,7,28
7/25/2004,4,0,8,9,21
7/26/2004,7,0,4,14,25
7/27/2004,14,0,11,1,26
7/28/2004,10,0,12,2,24
7/29/2004,7,0,2,5,14
7/30/2004,12,0,10,0,22
7/31/2004,9,0,7,8,24
8/1/2004,13,0,10,16,39
8/2/2004,5,0,7,8,20
8/3/2004,16,0,3,4,23
8/4/2004,6,0,12,5,23
8/5/2004,13,0,2,2,17
8/6/2004,6,0,6,9,21
8/7/2004,4,0,12,2,18
8/8/2004,9,0,10,0,19
8/9/2004,13,0,13,14,40
8/10/2004,6,0,10,13,29
8/11/2004,12,0,16,8,36
8/12/2004,11,0,8,2,21
8/13/2004,14,0,10,10,34
8/14/2004,13,0,14,5,32
8/15/2004,5,0,12,4,21
8/16/2004,16,0,10,16,42
8/17/2004,16,0,5,3,24
8/18/2004,15,0,16,4,35
8/19/2004,5,0,8,1,14
8/20/2004,12,0,10,8,30
8/21/2004,15,0,6,11,32
8/22/2004,9,0,11,16,36
8/23/2004,16,0,14,10,40
8/24/2004,9,0,14,15,38
8/25/2004,16,0,8,16,40
8/26/2004,6,0,14,7,27
8/27/2004,12,0,14,16,42
8/28/2004,12,0,13,7,32
8/29/2004,10,0,9,13,32
8/30/2004,12,0,9,2,23
8/31/2004,4,0,5,9,18
9/1/2004,7,0,6,14,27
9/2/2004,14,0,6,6,26
9/3/2004,11,0,16,1,28
9/4/2004,14,0,4,15,33
9/5/2004,10,0,5,0,15
9/6/2004,8,0,2,2,12
9/7/2004,15,0,10,16,41
9/8/2004,6,0,2,6,14
9/9/2004,6,0,4,14,24
9/10/2004,4,0,3,13,20
9/11/2004,13,0,16,8,37
9/12/2004,12,0,12,16,40
9/13/2004,4,0,3,3,10
9/14/2004,6,0,14,15,35
9/15/2004,8,0,12,11,31
9/16/2004,7,0,4,6,17
9/17/2004,16,0,10,6,32
9/18/2004,6,0,11,13,30
9/19/2004,4,0,4,0,8
9/20/2004,8,0,12,7,27
9/21/2004,14,0,4,16,34
9/22/2004,4,0,2,6,12
9/23/2004,16,0,11,2,29
9/24/2004,9,0,10,11,30
9/25/2004,13,0,9,12,34
9/26/2004,9,0,10,10,29
9/27/2004,9,0,2,2,13
9/28/2004,15,0,11,12,38
9/29/2004,13,0,16,15,44
9/30/2004,4,0,6,13,23
10/1/2004,15,0,15,12,42
10/2/2004,8,0,9,12,29
10/3/2004,5,0,14,14,33
10/4/2004,5,0,14,11,30
10/5/2004,9,0,16,8,33
10/6/2004,5,0,13,0,18
10/7/2004,4,0,3,7,14
10/8/2004,14,0,15,7,36
10/9/2004,7,0,2,10,19
10/10/2004,16,0,3,13,32
10/11/2004,14,0,12,7,33
10/12/2004,10,0,6,9,25
10/13/2004,15,0,7,3,25
10/14/2004,11,0,11,7,29
10/15/2004,16,0,7,5,28
10/16/2004,10,0,13,4,27
10/17/2004,6,0,7,1,14
10/18/2004,5,0,10,10,25
10/19/2004,7,0,6,3,16
10/20/2004,8,0,3,9,20
10/21/2004,7,0,6,15,28
10/22/2004,5,0,9,6,20
10/23/2004,5,0,4,9,18
10/24/2004,6,0,11,2,19
10/25/2004,10,0,7,9,26
10/26/2004,15,0,7,9,31
10/27/2004,16,0,10,12,38
10/28/2004,10,0,15,8,33
10/29/2004,15,0,3,0,18
10/30/2004,13,0,13,5,31
10/31/2004,6,0,3,2,11
11/1/2004,15,0,13,0,28
11/2/2004,10,0,16,13,39
11/3/2004,15,0,10,15,40
11/4/2004,11,0,14,14,39
11/5/2004,9,0,9,6,24
11/6/2004,15,0,9,15,39
11/7/2004,10,0,2,8,20
11/8/2004,15,0,12,5,32
11/9/2004,4,0,9,3,16
11/10/2004,8,0,4,5,17
11/11/2004,4,0,15,15,34
11/12/2004,12,0,6,14,32
11/13/2004,15,0,13,15,43
11/14/2004,4,0,15,16,35
11/15/2004,7,0,9,15,31
11/16/2004,12,0,12,15,39
11/17/2004,16,0,4,1,21
11/18/2004,9,0,6,14,29
11/19/2004,12,0,11,10,33
11/20/2004,12,0,9,14,35
11/21/2004,4,0,6,0,10
11/22/2004,5,0,15,10,30
11/23/2004,5,0,16,14,35
11/24/2004,16,0,5,3,24
11/25/2004,9,0,12,7,28
11/26/2004,15,0,9,10,34
11/27/2004,10,0,7,3,20
11/28/2004,4,0,5,0,9
11/29/2004,8,0,10,14,32
11/30/2004,4,0,15,5,24
12/1/2004,5,0,2,10,17
12/2/2004,5,0,14,12,31
12/3/2004,9,0,13,16,38
12/4/2004,14,0,9,5,28
12/5/2004,10,0,8,14,32
12/6/2004,13,0,2,12,27
12/7/2004,11,0,2,2,15
12/8/2004,8,0,10,5,23
12/9/2004,4,0,5,12,21
12/10/2004,12,0,8,16,36
12/11/2004,11,0,5,13,29
12/12/2004,14,0,10,11,35
12/13/2004,4,0,14,8,26
12/14/2004,12,0,7,3,22
12/15/2004,12,0,9,14,35
12/16/2004,9,0,5,1,15
12/17/2004,10,0,7,5,22
12/18/2004,15,0,8,5,28
12/19/2004,12,0,14,7,33
12/20/2004,14,0,8,4,26
12/21/2004,5,0,12,12,29
12/22/2004,10,0,14,4,28
12/23/2004,10,0,10,3,23
12/24/2004,7,0,6,15,28
12/25/2004,7,0,15,6,28
12/26/2004,6,0,7,6,19
12/27/2004,6,0,3,1,10
12/28/2004,12,0,15,9,36
12/29/2004,7,0,2,8,17
12/30/2004,12,0,7,6,25
12/31/2004,14,0,12,9,35
1/1/2005,4,0,2,4,10
1/2/2005,14,0,13,11,38
1/3/2005,16,0,11,1,28
1/4/2005,13,0,10,8,31
1/5/2005,6,0,4,12,22
1/6/2005,11,0,12,5,28
1/7/2005,6,0,9,14,29
1/8/2005,15,0,6,2,23
1/9/2005,5,0,10,9,24
1/10/2005,4,0,9,3,16
1/11/2005,4,0,12,6,22
1/12/2005,5,0,16,4,25
1/13/2005,6,0,10,16,32
1/14/2005,14,0,12,1,27
1/15/2005,16,0,10,1,27
1/16/2005,11,0,16,1,28
1/17/2005,15,0,3,15,33
1/18/2005,15,0,14,1,30
1/19/2005,16,0,15,9,40
1/20/2005,13,0,5,7,25
1/21/2005,6,0,6,2,14
1/22/2005,5,0,2,7,14
1/23/2005,9,0,13,3,25
1/24/2005,5,0,12,3,20
1/25/2005,7,0,16,9,32
1/26/2005,5,0,5,14,24
1/27/2005,7,0,16,8,31
1/28/2005,8,0,16,9,33
1/29/2005,4,0,6,9,19
1/30/2005,11,0,6,12,29
1/31/2005,15,0,10,0,25
2/1/2005,13,0,16,6,35
2/2/2005,8,0,6,1,15
2/3/2005,15,0,7,7,29
2/4/2005,10,0,15,16,41
2/5/2005,6,0,3,12,21
2/6/2005,5,0,11,8,24
2/7/2005,8,0,10,9,27
2/8/2005,7,0,4,3,14
2/9/2005,6,0,6,10,22
2/10/2005,12,0,2,12,26
2/11/2005,12,0,4,0,16
2/12/2005,10,0,2,6,18
2/13/2005,5,0,9,6,20
2/14/2005,10,0,10,13,33
2/15/2005,11,0,7,0,18
2/16/2005,5,0,3,10,18
2/17/2005,4,0,16,8,28
2/18/2005,15,0,2,10,27
2/19/2005,8,0,3,6,17
2/20/2005,8,0,6,11,25
2/21/2005,6,0,11,1,18
2/22/2005,4,0,16,6,26
2/23/2005,4,0,7,3,14
2/24/2005,5,0,5,12,22
2/25/2005,4,0,6,1,11
2/26/2005,16,0,16,14,46
2/27/2005,7,0,7,8,22
2/28/2005,11,0,3,13,27
3/1/2005,4,0,2,3,9
3/2/2005,11,0,12,2,25
3/3/2005,16,0,6,9,31
3/4/2005,4,0,8,13,25
3/5/2005,6,0,13,8,27
3/6/2005,15,0,4,7,26
3/7/2005,14,0,12,12,38
3/8/2005,9,0,11,3,23
3/9/2005,15,0,6,0,21
3/10/2005,11,0,8,8,27
3/11/2005,10,0,3,14,27
3/12/2005,16,0,8,6,30
3/13/2005,8,0,2,11,21
3/14/2005,5,0,9,1,15
3/15/2005,16,0,10,5,31
3/16/2005,12,0,13,4,29
3/17/2005,6,0,12,8,26
3/18/2005,11,0,9,14,34
3/19/2005,12,0,4,10,26
3/20/2005,6,0,14,1,21
3/21/2005,4,0,8,4,16
3/22/2005,5,0,9,16,30
3/23/2005,14,0,14,3,31
3/24/2005,16,0,4,13,33
3/25/2005,6,0,8,12,26
3/26/2005,4,0,3,12,19
3/27/2005,11,0,6,6,23
3/28/2005,16,0,4,8,28
3/29/2005,15,0,16,9,40
3/30/2005,5,0,2,5,12
3/31/2005,13,0,10,12,35
4/1/2005,9,0,13,2,24
4/2/2005,4,0,15,6,25
4/3/2005,14,0,11,3,28
4/4/2005,7,0,4,2,13
4/5/2005,5,0,3,11,19
4/6/2005,11,0,10,3,24
4/7/2005,12,0,9,8,29
4/8/2005,16,0,8,12,36
4/9/2005,7,0,3,15,25
4/10/2005,7,0,4,14,25
4/11/2005,6,0,12,4,22
4/12/2005,14,0,4,14,32
4/13/2005,10,0,3,3,16
4/14/2005,12,0,7,8,27
4/15/2005,14,0,10,1,25
4/16/2005,13,0,16,5,34
4/17/2005,11,0,7,4,22
4/18/2005,4,0,15,16,35
4/19/2005,16,0,11,10,37
4/20/2005,8,0,6,2,16
4/21/2005,13,0,8,7,28
4/22/2005,4,0,9,8,21
4/23/2005,11,0,10,11,32
4/24/2005,10,0,2,1,13
4/25/2005,10,0,5,4,19
4/26/2005,8,0,4,7,19
4/27/2005,9,0,13,1,23
4/28/2005,14,0,8,12,34
4/29/2005,5,0,15,2,22
4/30/2005,7,0,15,0,22
5/1/2005,7,0,16,1,24
5/2/2005,16,0,12,14,42
5/3/2005,8,0,3,16,27
5/4/2005,13,0,14,2,29
5/5/2005,12,0,6,7,25
5/6/2005,13,0,15,6,34
5/7/2005,5,0,7,9,21
5/8/2005,15,0,11,11,37
5/9/2005,6,0,7,12,25
5/10/2005,15,0,15,7,37
5/11/2005,8,0,6,14,28
5/12/2005,13,0,5,4,22
5/13/2005,16,0,7,0,23
5/14/2005,16,0,15,1,32
5/15/2005,13,0,14,6,33
5/16/2005,9,0,15,15,39
5/17/2005,7,0,9,10,26
5/18/2005,13,0,12,4,29
5/19/2005,13,0,8,8,29
5/20/2005,9,0,16,5,30
5/21/2005,14,0,14,14,42
5/22/2005,6,0,11,8,25
5/23/2005,7,0,7,2,16
5/24/2005,16,0,12,16,44
5/25/2005,12,0,7,12,31
5/26/2005,7,0,5,13,25
5/27/2005,15,0,11,16,42
5/28/2005,11,0,13,4,28
5/29/2005,14,0,13,6,33
5/30/2005,4,0,2,7,13
5/31/2005,11,0,13,11,35
6/1/2005,14,0,9,6,29
6/2/2005,8,0,12,16,36
6/3/2005,12,0,10,1,23
6/4/2005,9,0,14,0,23
6/5/2005,5,0,14,0,19
6/6/2005,10,0,12,9,31
6/7/2005,15,0,15,12,42
6/8/2005,13,0,13,15,41
6/9/2005,15,0,7,3,25
6/10/2005,10,0,10,4,24
6/11/2005,16,0,14,7,37
6/12/2005,9,0,8,1,18
6/13/2005,16,0,12,14,42
6/14/2005,5,0,9,11,25
6/15/2005,13,0,7,12,32
6/16/2005,14,0,15,7,36
6/17/2005,16,0,8,11,35
6/18/2005,14,0,14,13,41
6/19/2005,10,0,2,9,21
6/20/2005,15,0,7,11,33
6/21/2005,8,0,10,12,30
6/22/2005,8,0,11,13,32
6/23/2005,13,0,10,5,28
6/24/2005,5,0,14,9,28
6/25/2005,11,0,9,12,32
6/26/2005,4,0,13,6,23
6/27/2005,15,0,15,16,46
6/28/2005,11,0,7,13,31
6/29/2005,12,0,5,16,33
6/30/2005,6,0,11,2,19
7/1/2005,8,0,11,7,26
7/2/2005,15,0,10,11,36
7/3/2005,13,0,15,14,42
7/4/2005,16,0,5,2,23
7/5/2005,11,0,6,12,29
7/6/2005,12,0,16,13,41
7/7/2005,13,0,7,2,22
7/8/2005,6,0,2,6,14
7/9/2005,4,0,13,13,30
7/10/2005,10,0,12,12,34
7/11/2005,11,0,4,11,26
7/12/2005,15,0,13,4,32
7/13/2005,14,0,12,15,41
7/14/2005,14,0,11,11,36
7/15/2005,11,0,13,15,39
7/16/2005,12,0,15,12,39
7/17/2005,15,0,3,4,22
7/18/2005,13,0,11,0,24
7/19/2005,12,0,10,0,22
7/20/2005,16,0,14,1,31
7/21/2005,11,0,15,7,33
7/22/2005,10,0,7,3,20
7/23/2005,7,0,11,11,29
7/24/2005,15,0,16,1,32
7/25/2005,7,0,15,1,23
7/26/2005,4,0,15,11,30
7/27/2005,11,0,13,1,25
7/28/2005,12,0,8,14,34
7/29/2005,9,0,9,12,30
7/30/2005,9,0,8,7,24
7/31/2005,8,0,14,9,31
8/1/2005,9,0,8,15,32
8/2/2005,8,0,13,6,27
8/3/2005,8,0,15,1,24
8/4/2005,16,0,5,5,26
8/5/2005,14,0,10,15,39
8/6/2005,14,0,2,14,30
8/7/2005,11,0,5,0,16
8/8/2005,12,0,15,7,34
8/9/2005,10,0,14,1,25
8/10/2005,7,0,6,8,21
8/11/2005,16,0,11,3,30
8/12/2005,9,0,11,16,36
8/13/2005,7,0,6,2,15
8/14/2005,11,0,8,3,22
8/15/2005,8,0,3,2,13
8/16/2005,4,0,7,11,22
8/17/2005,16,0,16,9,41
8/18/2005,12,0,13,0,25
8/19/2005,10,0,7,6,23
8/20/2005,8,0,2,4,14
8/21/2005,6,0,8,2,16
8/22/2005,16,0,12,4,32
8/23/2005,8,0,11,2,21
8/24/2005,11,0,5,2,18
8/25/2005,8,0,2,2,12
8/26/2005,7,0,9,14,30
8/27/2005,16,0,11,6,33
8/28/2005,6,0,12,3,21
8/29/2005,5,0,10,16,31
8/30/2005,10,0,5,7,22
8/31/2005,7,0,13,16,36
9/1/2005,16,0,12,9,37
9/2/2005,15,0,4,9,28
9/3/2005,4,0,11,2,17
9/4/2005,7,0,13,0,20
9/5/2005,13,0,4,15,32
9/6/2005,6,0,7,12,25
9/7/2005,14,0,9,2,25
9/8/2005,16,0,11,15,42
9/9/2005,10,0,13,7,30
9/10/2005,6,0,9,1,16
9/11/2005,5,0,8,6,19
9/12/2005,8,0,8,5,21
9/13/2005,11,0,8,13,32
9/14/2005,12,0,9,14,35
9/15/2005,12,0,13,7,32
9/16/2005,16,0,4,8,28
9/17/2005,13,0,4,14,31
9/18/2005,6,0,3,9,18
9/19/2005,9,0,15,10,34
9/20/2005,10,0,8,13,31
9/21/2005,9,0,15,0,24
9/22/2005,4,0,16,15,35
9/23/2005,11,0,6,5,22
9/24/2005,12,0,16,4,32
9/25/2005,7,0,7,10,24
9/26/2005,11,0,5,6,22
9/27/2005,7,0,5,8,20
9/28/2005,6,0,13,7,26
9/29/2005,5,0,8,2,15
9/30/2005,13,0,4,2,19
10/1/2005,16,0,15,7,38
10/2/2005,11,0,3,3,17
10/3/2005,9,0,7,5,21
10/4/2005,6,0,11,6,23
10/5/2005,15,0,7,2,24
10/6/2005,14,0,3,13,30
10/7/2005,16,0,10,13,39
10/8/2005,16,0,16,1,33
10/9/2005,7,0,6,10,23
10/10/2005,8,0,16,1,25
10/11/2005,8,0,15,11,34
10/12/2005,10,0,3,8,21
10/13/2005,15,0,13,7,35
10/14/2005,10,0,9,1,20
10/15/2005,10,0,15,1,26
10/16/2005,15,0,12,3,30
10/17/2005,11,0,14,5,30
10/18/2005,12,0,16,11,39
10/19/2005,8,0,15,16,39
10/20/2005,10,0,16,0,26
10/21/2005,7,0,9,5,21
10/22/2005,5,0,15,11,31
10/23/2005,10,0,9,16,35
10/24/2005,8,0,15,5,28
10/25/2005,6,0,9,11,26
10/26/2005,5,0,6,7,18
10/27/2005,16,0,10,4,30
10/28/2005,6,0,6,0,12
10/29/2005,8,0,8,7,23
10/30/2005,6,0,8,13,27
10/31/2005,8,0,12,14,34
11/1/2005,14,0,10,2,26
11/2/2005,5,0,5,12,22
11/3/2005,8,0,4,3,15
11/4/2005,8,0,5,3,16
11/5/2005,4,0,8,2,14
11/6/2005,12,0,7,3,22
11/7/2005,8,0,10,16,34
11/8/2005,9,0,12,8,29
11/9/2005,9,0,8,5,22
11/10/2005,16,0,12,6,34
11/11/2005,16,0,14,14,44
11/12/2005,16,0,8,9,33
11/13/2005,9,0,13,7,29
11/14/2005,4,0,3,14,21
11/15/2005,12,0,7,12,31
11/16/2005,13,0,9,4,26
11/17/2005,16,0,9,9,34
11/18/2005,13,0,2,14,29
11/19/2005,9,0,12,2,23
11/20/2005,6,0,10,6,22
11/21/2005,7,0,14,0,21
11/22/2005,6,0,9,3,18
11/23/2005,5,0,3,4,12
11/24/2005,15,0,12,9,36
11/25/2005,15,0,11,15,41
11/26/2005,16,0,14,12,42
11/27/2005,4,0,14,16,34
11/28/2005,14,0,6,3,23
11/29/2005,4,0,8,7,19
11/30/2005,14,0,4,15,33
12/1/2005,11,0,3,7,21
12/2/2005,6,0,14,7,27
12/3/2005,14,0,6,16,36
12/4/2005,6,0,14,1,21
12/5/2005,6,0,3,11,20
12/6/2005,4,0,11,9,24
12/7/2005,15,0,5,13,33
12/8/2005,16,0,15,10,41
12/9/2005,9,0,12,0,21
12/10/2005,8,0,7,8,23
12/11/2005,5,0,3,4,12
12/12/2005,14,0,5,11,30
12/13/2005,4,0,16,15,35
12/14/2005,16,0,12,0,28
12/15/2005,9,0,4,4,17
12/16/2005,7,0,11,11,29
12/17/2005,4,0,11,10,25
12/18/2005,5,0,10,13,28
12/19/2005,12,0,6,13,31
12/20/2005,8,0,5,8,21
12/21/2005,16,0,16,8,40
12/22/2005,6,0,3,14,23
12/23/2005,4,0,4,15,23
12/24/2005,9,0,3,7,19
12/25/2005,6,0,7,10,23
12/26/2005,9,0,4,1,14
12/27/2005,6,0,9,9,24
12/28/2005,16,0,2,14,32
12/29/2005,16,0,7,8,31
12/30/2005,11,0,7,2,20
12/31/2005,6,0,3,5,14
1/1/2006,16,0,9,4,29
1/2/2006,16,0,13,14,43
1/3/2006,12,0,4,6,22
1/4/2006,5,0,16,15,36
1/5/2006,10,0,2,8,20
1/6/2006,9,0,2,2,13
1/7/2006,9,0,14,15,38
1/8/2006,11,0,8,14,33
1/9/2006,12,0,4,14,30
1/10/2006,5,0,16,1,22
1/11/2006,9,0,10,15,34
1/12/2006,14,0,14,4,32
1/13/2006,11,0,10,10,31
1/14/2006,11,0,7,7,25
1/15/2006,14,0,3,10,27
1/16/2006,15,0,3,0,18
1/17/2006,12,0,10,15,37
1/18/2006,12,0,10,12,34
1/19/2006,13,0,15,7,35
1/20/2006,8,0,10,8,26
1/21/2006,11,0,10,12,33
1/22/2006,15,0,11,0,26
1/23/2006,7,0,11,11,29
1/24/2006,5,0,10,4,19
1/25/2006,6,0,7,2,15
1/26/2006,6,0,10,14,30
1/27/2006,5,0,8,0,13
1/28/2006,10,0,15,6,31
1/29/2006,11,0,5,14,30
1/30/2006,9,0,7,16,32
1/31/2006,6,0,9,16,31
2/1/2006,4,0,10,13,27
2/2/2006,6,0,12,9,27
2/3/2006,6,0,9,6,21
2/4/2006,6,0,9,12,27
2/5/2006,11,0,2,2,15
2/6/2006,10,0,4,1,15
2/7/2006,13,0,14,12,39
2/8/2006,11,0,14,8,33
2/9/2006,10,0,7,7,24
2/10/2006,11,0,5,4,20
2/11/2006,10,0,15,3,28
2/12/2006,10,0,14,12,36
2/13/2006,14,0,8,14,36
2/14/2006,6,0,6,9,21
2/15/2006,7,0,7,8,22
2/16/2006,16,0,8,3,27
2/17/2006,12,0,11,1,24
2/18/2006,13,0,11,4,28
2/19/2006,13,0,3,13,29
2/20/2006,12,0,10,6,28
2/21/2006,11,0,14,12,37
2/22/2006,8,0,14,11,33
2/23/2006,4,0,11,0,15
2/24/2006,7,0,9,1,17
2/25/2006,11,0,4,3,18
2/26/2006,10,0,16,5,31
2/27/2006,12,0,11,8,31
2/28/2006,14,0,14,3,31
3/1/2006,9,0,15,6,30
3/2/2006,16,0,7,4,27
3/3/2006,12,0,13,9,34
3/4/2006,6,0,4,2,12
3/5/2006,13,0,9,6,28
3/6/2006,11,0,14,9,34
3/7/2006,5,0,11,4,20
3/8/2006,4,0,8,0,12
3/9/2006,10,0,11,3,24
3/10/2006,16,0,6,7,29
3/11/2006,12,0,10,14,36
3/12/2006,16,0,5,13,34
3/13/2006,5,0,6,2,13
3/14/2006,16,0,12,14,42
3/15/2006,13,0,13,10,36
3/16/2006,16,0,2,9,27
3/17/2006,4,0,16,14,34
3/18/2006,9,0,10,3,22
3/19/2006,9,0,4,7,20
3/20/2006,16,0,11,1,28
3/21/2006,6,0,9,16,31
3/22/2006,12,0,6,7,25
3/23/2006,5,0,4,16,25
3/24/2006,8,0,12,11,31
3/25/2006,10,0,16,7,33
3/26/2006,15,0,16,15,46
3/27/2006,6,0,10,12,28
3/28/2006,14,0,7,1,22
3/29/2006,11,0,7,10,28
3/30/2006,10,0,4,11,25
3/31/2006,8,0,3,11,22
4/1/2006,10,0,9,9,28
4/2/2006,14,0,15,4,33
4/3/2006,16,0,11,10,37
4/4/2006,12,0,12,16,40
4/5/2006,16,0,15,10,41
4/6/2006,5,0,11,3,19
4/7/2006,11,0,12,10,33
4/8/2006,10,0,16,10,36
4/9/2006,7,0,5,0,12
4/10/2006,10,0,9,15,34
4/11/2006,9,0,16,8,33
4/12/2006,5,0,5,14,24
4/13/2006,10,0,13,15,38
4/14/2006,14,0,12,13,39
4/15/2006,7,0,11,2,20
4/16/2006,9,0,15,2,26
4/17/2006,10,0,2,5,17
4/18/2006,4,0,8,13,25
4/19/2006,13,0,2,8,23
4/20/2006,10,0,15,10,35
4/21/2006,4,0,8,3,15
4/22/2006,15,0,10,8,33
4/23/2006,15,0,13,1,29
4/24/2006,5,0,3,1,9
4/25/2006,14,0,15,4,33
4/26/2006,11,0,7,15,33
4/27/2006,8,0,5,9,22
4/28/2006,7,0,11,2,20
4/29/2006,14,0,9,10,33
4/30/2006,7,0,8,1,16
5/1/2006,9,0,3,16,28
5/2/2006,8,0,2,6,16
5/3/2006,7,0,9,1,17
5/4/2006,9,0,6,5,20
5/5/2006,16,0,8,9,33
5/6/2006,9,0,16,2,27
5/7/2006,6,0,16,10,32
5/8/2006,4,0,4,9,17
5/9/2006,12,0,10,6,28
5/10/2006,5,0,13,3,21
5/11/2006,10,0,13,12,35
5/12/2006,5,0,14,13,32
5/13/2006,11,0,2,9,22
5/14/2006,5,0,13,15,33
5/15/2006,13,0,11,15,39
5/16/2006,4,0,14,11,29
5/17/2006,16,0,15,3,34
5/18/2006,14,0,11,6,31
5/19/2006,4,0,5,16,25
5/20/2006,10,0,4,6,20
5/21/2006,4,0,4,16,24
5/22/2006,4,0,7,3,14
5/23/2006,9,0,12,13,34
5/24/2006,7,0,8,2,17
5/25/2006,16,0,11,15,42
5/26/2006,13,0,3,16,32
5/27/2006,10,0,5,8,23
5/28/2006,13,0,4,1,18
5/29/2006,15,0,12,4,31
5/30/2006,14,0,13,13,40
5/31/2006,16,0,13,12,41
6/1/2006,8,0,9,7,24
6/2/2006,7,0,4,4,15
6/3/2006,15,0,10,3,28
6/4/2006,13,0,15,12,40
6/5/2006,8,0,2,3,13
6/6/2006,8,0,10,16,34
6/7/2006,11,0,12,6,29
6/8/2006,9,0,3,8,20
6/9/2006,4,0,2,1,7
6/10/2006,7,0,3,4,14
6/11/2006,13,0,13,9,35
6/12/2006,12,0,4,6,22
6/13/2006,6,0,5,7,18
6/14/2006,12,0,7,13,32
6/15/2006,16,0,4,10,30
6/16/2006,6,0,9,13,28
6/17/2006,10,0,11,11,32
6/18/2006,7,0,3,7,17
6/19/2006,15,0,14,12,41
6/20/2006,10,0,16,6,32
6/21/2006,14,0,15,1,30
6/22/2006,15,0,11,2,28
6/23/2006,5,0,9,9,23
6/24/2006,15,0,2,3,20
6/25/2006,4,0,16,0,20
6/26/2006,9,0,10,0,19
6/27/2006,15,0,6,3,24
6/28/2006,13,0,7,10,30
6/29/2006,16,0,6,5,27
6/30/2006,12,0,11,3,26
7/1/2006,5,0,9,15,29
7/2/2006,13,0,3,9,25
7/3/2006,13,0,12,14,39
7/4/2006,7,0,11,16,34
7/5/2006,13,0,4,0,17
7/6/2006,10,0,16,6,32
7/7/2006,5,0,14,1,20
7/8/2006,16,0,16,6,38
7/9/2006,9,0,13,16,38
7/10/2006,16,0,10,5,31
7/11/2006,12,0,11,14,37
7/12/2006,13,0,15,9,37
7/13/2006,7,0,5,14,26
7/14/2006,4,0,3,13,20
7/15/2006,11,0,15,14,40
7/16/2006,10,0,4,3,17
7/17/2006,11,0,3,2,16
7/18/2006,8,0,12,12,32
7/19/2006,4,0,14,14,32
7/20/2006,12,0,9,2,23
7/21/2006,15,0,2,4,21
7/22/2006,8,0,14,10,32
7/23/2006,4,0,12,0,16
7/24/2006,9,0,3,6,18
7/25/2006,13,0,14,7,34
7/26/2006,16,0,7,15,38
7/27/2006,9,0,10,11,30
7/28/2006,14,0,5,3,22
7/29/2006,14,0,13,4,31
7/30/2006,10,0,15,1,26
7/31/2006,5,0,2,16,23
8/1/2006,7,0,16,4,27
8/2/2006,8,0,2,5,15
8/3/2006,12,0,16,12,40
8/4/2006,7,0,2,15,24
8/5/2006,7,0,13,6,26
8/6/2006,12,0,3,4,19
8/7/2006,16,0,2,1,19
8/8/2006,14,0,14,6,34
8/9/2006,11,0,8,0,19
8/10/2006,7,0,15,13,35
8/11/2006,11,0,14,8,33
8/12/2006,14,0,15,14,43
8/13/2006,4,0,8,8,20
8/14/2006,11,0,2,14,27
8/15/2006,11,0,6,14,31
8/16/2006,12,0,12,12,36
8/17/2006,14,0,8,4,26
8/18/2006,11,0,15,12,38
8/19/2006,10,0,15,16,41
8/20/2006,8,0,13,3,24
8/21/2006,11,0,6,10,27
8/22/2006,5,0,3,16,24
8/23/2006,4,0,2,2,8
8/24/2006,16,0,11,10,37
8/25/2006,11,0,14,13,38
8/26/2006,4,0,7,8,19
8/27/2006,14,0,8,1,23
8/28/2006,5,0,10,9,24
8/29/2006,9,0,14,16,39
8/30/2006,16,0,5,2,23
8/31/2006,12,0,4,7,23
9/1/2006,10,0,14,0,24
9/2/2006,12,0,7,14,33
9/3/2006,4,0,6,4,14
9/4/2006,14,0,5,4,23
9/5/2006,6,0,8,15,29
9/6/2006,10,0,7,15,32
9/7/2006,8,0,7,0,15
9/8/2006,5,0,11,4,20
9/9/2006,7,0,4,15,26
9/10/2006,7,0,6,7,20
9/11/2006,10,0,14,11,35
9/12/2006,7,0,7,8,22
9/13/2006,7,0,11,11,29
9/14/2006,7,0,12,5,24
9/15/2006,11,0,4,15,30
9/16/2006,4,0,14,13,31
9/17/2006,15,0,4,0,19
9/18/2006,15,0,3,12,30
9/19/2006,4,0,16,0,20
9/20/2006,14,0,4,1,19
9/21/2006,16,0,6,12,34
9/22/2006,12,0,2,7,21
9/23/2006,15,0,12,11,38
9/24/2006,15,0,14,10,39
9/25/2006,5,0,8,3,16
9/26/2006,8,0,10,12,30
9/27/2006,13,0,14,11,38
9/28/2006,8,0,10,2,20
9/29/2006,13,0,11,12,36
9/30/2006,4,0,3,1,8
10/1/2006,10,0,11,7,28
10/2/2006,10,0,6,4,20
10/3/2006,7,0,6,12,25
10/4/2006,12,0,15,6,33
10/5/2006,9,0,12,16,37
10/6/2006,7,0,13,12,32
10/7/2006,9,0,11,12,32
10/8/2006,16,0,2,12,30
10/9/2006,6,0,2,13,21
10/10/2006,4,0,16,2,22
10/11/2006,10,0,9,13,32
10/12/2006,11,0,14,14,39
10/13/2006,4,0,6,6,16
10/14/2006,6,0,10,11,27
10/15/2006,13,0,2,13,28
10/16/2006,5,0,13,1,19
10/17/2006,6,0,3,9,18
10/18/2006,7,0,13,0,20
10/19/2006,5,0,9,2,16
10/20/2006,5,0,13,6,24
10/21/2006,16,0,7,3,26
10/22/2006,15,0,6,7,28
10/23/2006,6,0,3,15,24
10/24/2006,7,0,11,13,31
10/25/2006,9,0,13,8,30
10/26/2006,6,0,14,12,32
10/27/2006,14,0,8,15,37
10/28/2006,15,0,4,6,25
10/29/2006,14,0,7,0,21
10/30/2006,6,0,5,7,18
10/31/2006,15,0,5,2,22
11/1/2006,4,0,2,0,6
11/2/2006,5,0,8,11,24
11/3/2006,8,0,10,12,30
11/4/2006,10,0,10,10,30
11/5/2006,12,0,6,3,21
11/6/2006,14,0,9,6,29
11/7/2006,10,0,8,1,19
11/8/2006,7,0,10,16,33
11/9/2006,10,0,10,14,34
11/10/2006,13,0,4,5,22
11/11/2006,14,0,12,12,38
11/12/2006,11,0,14,4,29
11/13/2006,15,0,13,3,31
11/14/2006,16,0,15,9,40
11/15/2006,13,0,9,14,36
11/16/2006,4,0,2,16,22
11/17/2006,7,0,5,13,25
11/18/2006,10,0,2,9,21
11/19/2006,8,0,6,1,15
11/20/2006,9,0,2,15,26
11/21/2006,12,0,8,5,25
11/22/2006,6,0,3,2,11
11/23/2006,14,0,15,8,37
11/24/2006,11,0,10,1,22
11/25/2006,8,0,9,4,21
11/26/2006,4,0,11,8,23
11/27/2006,11,0,7,7,25
11/28/2006,10,0,13,3,26
11/29/2006,11,0,2,8,21
11/30/2006,16,0,15,11,42
12/1/2006,4,0,13,14,31
12/2/2006,13,0,15,6,34
12/3/2006,11,0,3,12,26
12/4/2006,13,0,9,12,34
12/5/2006,6,0,2,8,16
12/6/2006,7,0,6,7,20
12/7/2006,16,0,15,4,35
12/8/2006,7,0,5,8,20
12/9/2006,8,0,7,4,19
12/10/2006,16,0,13,15,44
12/11/2006,5,0,9,2,16
12/12/2006,9,0,16,8,33
12/13/2006,16,0,7,14,37
12/14/2006,8,0,6,12,26
12/15/2006,4,0,16,7,27
12/16/2006,6,0,2,4,12
12/17/2006,14,0,10,15,39
12/18/2006,4,0,2,1,7
12/19/2006,6,0,14,7,27
12/20/2006,7,0,14,8,29
12/21/2006,14,0,8,7,29
12/22/2006,9,0,12,15,36
12/23/2006,16,0,10,8,34
12/24/2006,8,0,13,6,27
12/25/2006,16,0,13,16,45
12/26/2006,4,0,8,2,14
12/27/2006,7,0,5,2,14
12/28/2006,12,0,2,15,29
12/29/2006,10,0,6,9,25
12/30/2006,9,0,12,12,33
12/31/2006,12,0,6,0,18
1/1/2007,14,0,16,8,38
1/2/2007,16,0,14,15,45
1/3/2007,15,0,6,9,30
1/4/2007,7,0,4,9,20
1/5/2007,8,0,7,4,19
1/6/2007,11,0,6,4,21
1/7/2007,8,0,13,1,22
1/8/2007,15,0,8,1,24
1/9/2007,15,0,7,0,22
1/10/2007,14,0,16,0,30
1/11/2007,11,0,8,15,34
1/12/2007,15,0,15,10,40
1/13/2007,8,0,5,5,18
1/14/2007,6,0,12,6,24
1/15/2007,5,0,10,9,24
1/16/2007,13,0,12,10,35
1/17/2007,9,0,15,10,34
1/18/2007,8,0,7,13,28
1/19/2007,14,0,13,3,30
1/20/2007,10,0,3,6,19
1/21/2007,9,0,10,2,21
1/22/2007,10,0,10,7,27
1/23/2007,8,0,6,3,17
1/24/2007,9,0,10,6,25
1/25/2007,6,0,4,5,15
1/26/2007,16,0,2,7,25
1/27/2007,8,0,6,15,29
1/28/2007,15,0,9,16,40
1/29/2007,11,0,8,5,24
1/30/2007,8,0,5,11,24
1/31/2007,13,0,3,13,29
2/1/2007,8,0,7,14,29
2/2/2007,16,0,5,14,35
2/3/2007,15,0,16,2,33
2/4/2007,7,0,9,5,21
2/5/2007,9,0,14,0,23
2/6/2007,10,0,9,7,26
2/7/2007,15,0,9,2,26
2/8/2007,16,0,10,2,28
2/9/2007,15,0,8,2,25
2/10/2007,16,0,14,11,41
2/11/2007,6,0,4,16,26
2/12/2007,13,0,8,14,35
2/13/2007,12,0,6,12,30
2/14/2007,7,0,10,9,26
2/15/2007,14,0,3,1,18
2/16/2007,10,0,5,0,15
2/17/2007,7,0,4,4,15
2/18/2007,11,0,9,1,21
2/19/2007,13,0,5,16,34
2/20/2007,15,0,14,12,41
2/21/2007,16,0,6,2,24
2/22/2007,16,0,11,5,32
2/23/2007,12,0,11,3,26
2/24/2007,9,0,15,4,28
2/25/2007,4,0,9,9,22
2/26/2007,16,0,7,1,24
2/27/2007,12,0,16,5,33
2/28/2007,7,0,7,9,23
3/1/2007,8,0,6,3,17
3/2/2007,11,0,2,11,24
3/3/2007,15,0,9,4,28
3/4/2007,4,0,3,15,22
3/5/2007,11,0,11,1,23
3/6/2007,11,0,15,8,34
3/7/2007,16,0,14,16,46
3/8/2007,6,0,12,4,22
3/9/2007,14,0,6,5,25
3/10/2007,9,0,12,9,30
3/11/2007,7,0,10,11,28
3/12/2007,14,0,16,11,41
3/13/2007,7,0,3,5,15
3/14/2007,8,0,2,2,12
3/15/2007,9,0,2,1,12
3/16/2007,5,0,16,12,33
3/17/2007,11,0,10,6,27
3/18/2007,13,0,5,11,29
3/19/2007,8,0,12,10,30
3/20/2007,8,0,2,14,24
3/21/2007,6,0,9,14,29
3/22/2007,15,0,11,16,42
3/23/2007,8,0,11,0,19
3/24/2007,9,0,8,3,20
3/25/2007,9,0,10,6,25
3/26/2007,12,0,15,5,32
3/27/2007,10,0,14,12,36
3/28/2007,5,0,16,2,23
3/29/2007,6,0,2,7,15
3/30/2007,10,0,5,1,16
3/31/2007,14,0,2,3,19
4/1/2007,5,0,10,3,18
4/2/2007,10,0,15,12,37
4/3/2007,9,0,14,5,28
4/4/2007,7,0,14,9,30
4/5/2007,6,0,4,10,20
4/6/2007,11,0,14,8,33
4/7/2007,6,0,6,1,13
4/8/2007,12,0,12,8,32
4/9/2007,9,0,16,14,39
4/10/2007,16,0,13,2,31
4/11/2007,10,0,2,10,22
4/12/2007,14,0,14,0,28
4/13/2007,13,0,14,10,37
4/14/2007,15,0,11,9,35
4/15/2007,5,0,9,4,18
4/16/2007,14,0,7,12,33
4/17/2007,4,0,15,3,22
4/18/2007,9,0,15,7,31
4/19/2007,15,0,9,2,26
4/20/2007,5,0,5,1,11
4/21/2007,9,0,3,6,18
4/22/2007,14,0,5,15,34
4/23/2007,6,0,4,7,17
4/24/2007,7,0,6,9,22
4/25/2007,7,0,2,0,9
4/26/2007,15,0,12,10,37
4/27/2007,4,0,10,15,29
4/28/2007,4,0,12,15,31
4/29/2007,7,0,2,3,12
4/30/2007,13,0,12,6,31
5/1/2007,16,0,15,14,45
5/2/2007,4,0,4,11,19
5/3/2007,13,0,6,6,25
5/4/2007,9,0,7,0,16
5/5/2007,16,0,13,16,45
5/6/2007,12,0,4,15,31
5/7/2007,7,0,6,4,17
5/8/2007,10,0,3,5,18
5/9/2007,13,0,2,2,17
5/10/2007,8,0,3,2,13
5/11/2007,7,0,9,5,21
5/12/2007,11,0,13,16,40
5/13/2007,5,0,8,7,20
5/14/2007,8,0,11,0,19
5/15/2007,6,0,14,4,24
5/16/2007,12,0,9,16,37
5/17/2007,6,0,4,12,22
5/18/2007,8,0,16,16,40
5/19/2007,6,0,13,9,28
5/20/2007,7,0,3,10,20
5/21/2007,10,0,10,10,30
5/22/2007,11,0,15,6,32
5/23/2007,12,0,15,11,38
5/24/2007,16,0,12,2,30
5/25/2007,14,0,2,1,17
5/26/2007,7,0,14,2,23
5/27/2007,13,0,3,9,25
5/28/2007,6,0,16,6,28
5/29/2007,6,0,10,5,21
5/30/2007,5,0,10,10,25
5/31/2007,10,0,16,15,41
6/1/2007,7,0,6,11,24
6/2/2007,6,0,15,10,31
6/3/2007,11,0,13,9,33
6/4/2007,6,0,14,5,25
6/5/2007,6,0,13,4,23
6/6/2007,4,0,13,3,20
6/7/2007,12,0,16,12,40
6/8/2007,6,0,10,7,23
6/9/2007,14,0,9,1,24
6/10/2007,13,0,8,16,37
6/11/2007,6,0,11,6,23
6/12/2007,12,0,3,1,16
6/13/2007,7,0,15,12,34
6/14/2007,11,0,13,0,24
6/15/2007,4,0,5,9,18
6/16/2007,5,0,10,13,28
6/17/2007,6,0,14,1,21
6/18/2007,15,0,4,12,31
6/19/2007,5,0,2,14,21
6/20/2007,5,0,16,5,26
6/21/2007,13,0,6,0,19
6/22/2007,8,0,15,5,28
6/23/2007,6,0,7,8,21
6/24/2007,15,0,4,10,29
6/25/2007,4,0,15,13,32
6/26/2007,7,0,14,13,34
6/27/2007,9,0,9,9,27
6/28/2007,6,0,15,8,29
6/29/2007,13,0,7,15,35
6/30/2007,9,0,13,13,35
7/1/2007,9,0,4,7,20
7/2/2007,8,0,7,11,26
7/3/2007,12,0,7,9,28
7/4/2007,8,0,8,12,28
7/5/2007,7,0,2,10,19
7/6/2007,5,0,15,7,27
7/7/2007,16,0,5,3,24
7/8/2007,4,0,5,0,9
7/9/2007,4,0,6,4,14
7/10/2007,12,0,16,14,42
7/11/2007,8,0,8,10,26
7/12/2007,9,0,6,6,21
7/13/2007,11,0,8,7,26
7/14/2007,13,0,8,2,23
7/15/2007,8,0,11,10,29
7/16/2007,15,0,5,15,35
7/17/2007,8,0,2,2,12
7/18/2007,11,0,6,9,26
7/19/2007,12,0,13,14,39
7/20/2007,4,0,9,16,29
7/21/2007,4,0,13,7,24
7/22/2007,5,0,15,10,30
7/23/2007,15,0,14,3,32
7/24/2007,9,0,3,14,26
7/25/2007,15,0,3,12,30
7/26/2007,5,0,12,16,33
7/27/2007,13,0,15,14,42
7/28/2007,15,0,16,9,40
7/29/2007,15,0,6,2,23
7/30/2007,9,0,12,12,33
7/31/2007,10,0,13,14,37
8/1/2007,13,0,5,15,33
8/2/2007,5,0,9,7,21
8/3/2007,7,0,9,0,16
8/4/2007,12,0,14,5,31
8/5/2007,9,0,5,6,20
8/6/2007,7,0,13,13,33
8/7/2007,16,0,8,5,29
8/8/2007,12,0,10,6,28
8/9/2007,10,0,4,7,21
8/10/2007,16,0,7,4,27
8/11/2007,6,0,12,13,31
8/12/2007,8,0,11,14,33
8/13/2007,6,0,4,8,18
8/14/2007,9,0,3,11,23
8/15/2007,12,0,3,11,26
8/16/2007,15,0,10,7,32
8/17/2007,12,0,15,15,42
8/18/2007,10,0,7,14,31
8/19/2007,6,0,13,14,33
8/20/2007,11,0,11,13,35
8/21/2007,10,0,3,5,18
8/22/2007,4,0,2,1,7
8/23/2007,9,0,13,0,22
8/24/2007,15,0,16,6,37
8/25/2007,15,0,11,16,42
8/26/2007,5,0,4,4,13
8/27/2007,15,0,16,5,36
8/28/2007,8,0,4,8,20
8/29/2007,11,0,12,12,35
8/30/2007,10,0,16,10,36
8/31/2007,6,0,2,7,15
9/1/2007,7,0,3,15,25
9/2/2007,10,0,6,2,18
9/3/2007,11,0,7,16,34
9/4/2007,16,0,7,12,35
9/5/2007,9,0,9,6,24
9/6/2007,13,0,10,4,27
9/7/2007,9,0,11,0,20
9/8/2007,10,0,3,2,15
9/9/2007,13,0,2,3,18
9/10/2007,8,0,2,4,14
9/11/2007,6,0,4,3,13
9/12/2007,8,0,7,8,23
9/13/2007,10,0,3,16,29
9/14/2007,16,0,11,3,30
9/15/2007,11,0,12,1,24
9/16/2007,15,0,14,6,35
9/17/2007,11,0,12,3,26
9/18/2007,13,0,8,6,27
9/19/2007,7,0,4,13,24
9/20/2007,6,0,10,8,24
9/21/2007,12,0,14,11,37
9/22/2007,16,0,10,16,42
9/23/2007,14,0,5,10,29
9/24/2007,5,0,5,5,15
9/25/2007,4,0,10,12,26
9/26/2007,8,0,13,7,28
9/27/2007,6,0,9,4,19
9/28/2007,13,0,3,4,20
9/29/2007,6,0,9,8,23
9/30/2007,12,0,4,4,20
10/1/2007,8,0,12,16,36
10/2/2007,12,0,3,10,25
10/3/2007,7,0,13,0,20
10/4/2007,8,0,6,15,29
10/5/2007,11,0,15,1,27
10/6/2007,13,0,5,2,20
10/7/2007,4,0,14,6,24
10/8/2007,16,0,14,8,38
10/9/2007,7,0,10,6,23
10/10/2007,7,0,12,15,34
10/11/2007,4,0,12,11,27
10/12/2007,8,0,12,10,30
10/13/2007,15,0,6,1,22
10/14/2007,5,0,15,9,29
10/15/2007,8,0,2,0,10
10/16/2007,10,0,3,9,22
10/17/2007,7,0,8,12,27
10/18/2007,16,0,5,15,36
10/19/2007,9,0,2,11,22
10/20/2007,10,0,11,10,31
10/21/2007,12,0,15,14,41
10/22/2007,5,0,9,9,23
10/23/2007,9,0,9,6,24
10/24/2007,9,0,6,4,19
10/25/2007,16,0,6,10,32
10/26/2007,14,0,12,11,37
10/27/2007,9,0,14,12,35
10/28/2007,5,0,11,6,22
10/29/2007,13,0,7,11,31
10/30/2007,9,0,2,5,16
10/31/2007,12,0,10,11,33
11/1/2007,14,0,13,6,33
11/2/2007,13,0,15,10,38
11/3/2007,5,0,5,13,23
11/4/2007,11,0,13,3,27
11/5/2007,14,0,2,5,21
11/6/2007,14,0,8,5,27
11/7/2007,15,0,10,4,29
11/8/2007,10,0,13,8,31
11/9/2007,6,0,11,0,17
11/10/2007,16,0,16,11,43
11/11/2007,5,0,9,13,27
11/12/2007,14,0,16,10,40
11/13/2007,13,0,5,1,19
11/14/2007,15,0,10,10,35
11/15/2007,9,0,14,0,23
11/16/2007,15,0,7,9,31
11/17/2007,5,0,12,0,17
11/18/2007,5,0,5,3,13
11/19/2007,5,0,7,15,27
11/20/2007,14,0,6,9,29
11/21/2007,11,0,2,4,17
11/22/2007,11,0,13,5,29
11/23/2007,4,0,2,9,15
11/24/2007,11,0,4,15,30
11/25/2007,16,0,9,0,25
11/26/2007,7,0,5,12,24
11/27/2007,8,0,15,6,29
11/28/2007,4,0,9,3,16
11/29/2007,10,0,14,7,31
11/30/2007,16,0,12,9,37
12/1/2007,13,0,7,12,32
12/2/2007,16,0,12,5,33
12/3/2007,7,0,16,12,35
12/4/2007,4,0,14,10,28
12/5/2007,16,0,13,10,39
12/6/2007,6,0,10,11,27
12/7/2007,10,0,8,7,25
12/8/2007,8,0,5,3,16
12/9/2007,13,0,8,4,25
12/10/2007,16,0,3,4,23
12/11/2007,16,0,2,9,27
12/12/2007,11,0,7,3,21
12/13/2007,16,0,5,2,23
12/14/2007,11,0,5,10,26
12/15/2007,10,0,8,1,19
12/16/2007,5,0,15,1,21
12/17/2007,5,0,2,15,22
12/18/2007,10,0,13,3,26
12/19/2007,4,0,9,0,13
12/20/2007,7,0,16,6,29
12/21/2007,14,0,2,6,22
12/22/2007,13,0,8,8,29
12/23/2007,5,0,3,5,13
12/24/2007,6,0,10,11,27
12/25/2007,6,0,3,1,10
12/26/2007,6,0,3,8,17
12/27/2007,15,0,15,16,46
12/28/2007,10,0,12,6,28
12/29/2007,7,0,5,7,19
12/30/2007,12,0,6,15,33
12/31/2007,9,0,11,9,29
1/1/2008,10,0,4,15,29
1/2/2008,7,0,6,11,24
1/3/2008,16,0,2,1,19
1/4/2008,7,0,12,9,28
1/5/2008,4,0,15,11,30
1/6/2008,13,0,4,11,28
1/7/2008,8,0,11,5,24
1/8/2008,8,0,6,12,26
1/9/2008,7,0,16,4,27
1/10/2008,14,0,4,1,19
1/11/2008,13,0,5,2,20
1/12/2008,10,0,7,16,33
1/13/2008,7,0,2,7,16
1/14/2008,10,0,16,5,31
1/15/2008,13,0,8,7,28
1/16/2008,14,0,3,7,24
1/17/2008,10,0,8,12,30
1/18/2008,5,0,9,2,16
1/19/2008,9,0,14,16,39
1/20/2008,16,0,14,4,34
1/21/2008,13,0,7,16,36
1/22/2008,10,0,3,5,18
1/23/2008,12,0,6,9,27
1/24/2008,4,0,4,16,24
1/25/2008,4,0,8,3,15
1/26/2008,7,0,10,15,32
1/27/2008,13,0,5,5,23
1/28/2008,10,0,10,9,29
1/29/2008,14,0,10,13,37
1/30/2008,12,0,6,8,26
1/31/2008,8,0,12,5,25
2/1/2008,16,0,7,0,23
2/2/2008,10,0,11,3,24
2/3/2008,11,0,5,4,20
2/4/2008,12,0,7,14,33
2/5/2008,5,0,5,14,24
2/6/2008,12,0,3,7,22
2/7/2008,11,0,2,1,14
2/8/2008,9,0,16,10,35
2/9/2008,15,0,15,2,32
2/10/2008,10,0,5,12,27
2/11/2008,16,0,11,1,28
2/12/2008,12,0,11,7,30
2/13/2008,14,0,3,2,19
2/14/2008,13,0,14,0,27
2/15/2008,7,0,12,14,33
2/16/2008,8,0,9,6,23
2/17/2008,10,0,11,9,30
2/18/2008,16,0,10,13,39
2/19/2008,10,0,4,7,21
2/20/2008,16,0,8,15,39
2/21/2008,7,0,7,15,29
2/22/2008,7,0,9,12,28
2/23/2008,9,0,15,11,35
2/24/2008,4,0,13,4,21
2/25/2008,6,0,10,11,27
2/26/2008,8,0,7,3,18
2/27/2008,7,0,14,2,23
2/28/2008,11,0,8,12,31
2/29/2008,6,0,14,6,26
3/1/2008,7,0,4,13,24
3/2/2008,16,0,3,14,33
3/3/2008,12,0,14,12,38
3/4/2008,16,0,7,16,39
3/5/2008,13,0,13,11,37
3/6/2008,7,0,4,11,22
3/7/2008,11,0,15,13,39
3/8/2008,10,0,12,5,27
3/9/2008,13,0,11,9,33
3/10/2008,9,0,12,12,33
3/11/2008,14,0,3,13,30
3/12/2008,11,0,11,2,24
3/13/2008,15,0,2,15,32
3/14/2008,16,0,13,4,33
3/15/2008,13,0,6,5,24
3/16/2008,14,0,16,13,43
3/17/2008,15,0,8,12,35
3/18/2008,11,0,10,5,26
3/19/2008,16,0,15,0,31
3/20/2008,14,0,15,13,42
3/21/2008,11,0,6,4,21
3/22/2008,16,0,3,14,33
3/23/2008,7,0,13,11,31
3/24/2008,14,0,10,5,29
3/25/2008,11,0,16,6,33
3/26/2008,14,0,2,7,23
3/27/2008,11,0,16,9,36
3/28/2008,5,0,8,13,26
3/29/2008,10,0,2,8,20
3/30/2008,8,0,16,6,30
3/31/2008,4,0,14,4,22
4/1/2008,5,0,15,8,28
4/2/2008,14,0,3,7,24
4/3/2008,7,0,14,15,36
4/4/2008,8,0,15,5,28
4/5/2008,8,0,5,4,17
4/6/2008,10,0,12,9,31
4/7/2008,11,0,4,14,29
4/8/2008,14,0,11,6,31
4/9/2008,9,0,13,14,36
4/10/2008,16,0,5,16,37
4/11/2008,14,0,6,10,30
4/12/2008,14,0,15,10,39
4/13/2008,7,0,14,10,31
4/14/2008,12,0,14,3,29
4/15/2008,16,0,6,14,36
4/16/2008,5,0,10,1,16
4/17/2008,6,0,12,0,18
4/18/2008,12,0,16,16,44
4/19/2008,6,0,11,11,28
4/20/2008,8,0,14,10,32
4/21/2008,10,0,16,11,37
4/22/2008,9,0,7,2,18
4/23/2008,16,0,2,9,27
4/24/2008,11,0,9,1,21
4/25/2008,4,0,13,9,26
4/26/2008,11,0,3,9,23
4/27/2008,12,0,8,6,26
4/28/2008,13,0,9,15,37
4/29/2008,9,0,16,4,29
4/30/2008,10,0,16,12,38
5/1/2008,9,0,10,5,24
5/2/2008,7,0,4,1,12
5/3/2008,16,0,4,4,24
5/4/2008,11,0,11,3,25
5/5/2008,10,0,12,1,23
5/6/2008,6,0,6,2,14
5/7/2008,11,0,4,2,17
5/8/2008,9,0,9,1,19
5/9/2008,16,0,11,3,30
5/10/2008,10,0,16,5,31
5/11/2008,15,0,8,15,38
5/12/2008,4,0,8,1,13
5/13/2008,16,0,6,5,27
5/14/2008,5,0,4,5,14
5/15/2008,10,0,6,14,30
5/16/2008,13,0,12,11,36
5/17/2008,10,0,6,10,26
5/18/2008,4,0,7,1,12
5/19/2008,8,0,4,13,25
5/20/2008,11,0,5,14,30
5/21/2008,7,0,16,3,26
5/22/2008,12,0,5,5,22
5/23/2008,5,0,8,3,16
5/24/2008,6,0,9,13,28
5/25/2008,4,0,9,13,26
5/26/2008,10,0,6,0,16
5/27/2008,13,0,14,4,31
5/28/2008,13,0,7,16,36
5/29/2008,14,0,15,4,33
5/30/2008,15,0,15,10,40
5/31/2008,13,0,8,7,28
6/1/2008,4,0,10,0,14
6/2/2008,13,0,7,4,24
6/3/2008,13,0,13,2,28
6/4/2008,13,0,12,0,25
6/5/2008,7,0,8,2,17
6/6/2008,8,0,4,15,27
6/7/2008,5,0,5,0,10
6/8/2008,10,0,10,11,31
6/9/2008,7,0,13,2,22
6/10/2008,13,0,16,11,40
6/11/2008,7,0,10,0,17
6/12/2008,7,0,7,8,22
6/13/2008,4,0,9,7,20
6/14/2008,16,0,11,14,41
6/15/2008,5,0,3,11,19
6/16/2008,15,0,16,8,39
6/17/2008,6,0,2,3,11
6/18/2008,7,0,15,1,23
6/19/2008,10,0,8,15,33
6/20/2008,13,0,10,2,25
6/21/2008,6,0,8,8,22
6/22/2008,9,0,16,2,27
6/23/2008,11,0,13,14,38
6/24/2008,13,0,4,16,33
6/25/2008,14,0,8,9,31
6/26/2008,15,0,6,1,22
6/27/2008,9,0,2,0,11
6/28/2008,15,0,7,12,34
6/29/2008,4,0,5,14,23
6/30/2008,11,0,9,16,36
7/1/2008,15,0,8,13,36
7/2/2008,13,0,13,0,26
7/3/2008,9,0,10,6,25
7/4/2008,10,0,4,5,19
7/5/2008,12,0,11,0,23
7/6/2008,4,0,13,3,20
7/7/2008,6,0,8,14,28
7/8/2008,11,0,11,13,35
7/9/2008,10,0,10,2,22
7/10/2008,16,0,12,11,39
7/11/2008,14,0,16,10,40
7/12/2008,9,0,2,2,13
7/13/2008,13,0,13,16,42
7/14/2008,10,0,6,8,24
7/15/2008,12,0,16,5,33
7/16/2008,9,0,13,13,35
7/17/2008,10,0,6,16,32
7/18/2008,10,0,2,7,19
7/19/2008,7,0,2,0,9
7/20/2008,13,0,5,9,27
7/21/2008,5,0,5,10,20
7/22/2008,5,0,14,13,32
7/23/2008,8,0,9,7,24
7/24/2008,9,0,10,10,29
7/25/2008,15,0,6,12,33
7/26/2008,10,0,8,16,34
7/27/2008,14,0,14,0,28
7/28/2008,5,0,9,5,19
7/29/2008,15,0,16,2,33
7/30/2008,5,0,14,3,22
7/31/2008,16,0,14,8,38
8/1/2008,15,0,5,15,35
8/2/2008,15,0,9,8,32
8/3/2008,10,0,11,16,37
8/4/2008,8,0,16,8,32
8/5/2008,9,0,8,14,31
8/6/2008,7,0,16,3,26
8/7/2008,11,0,3,8,22
8/8/2008,7,0,13,13,33
8/9/2008,16,0,4,13,33
8/10/2008,14,0,2,0,16
8/11/2008,15,0,14,8,37
8/12/2008,8,0,15,14,37
8/13/2008,15,0,16,8,39
8/14/2008,4,0,15,6,25
8/15/2008,9,0,14,1,24
8/16/2008,11,0,9,4,24
8/17/2008,6,0,11,12,29
8/18/2008,9,0,4,11,24
8/19/2008,10,0,14,10,34
8/20/2008,5,0,2,3,10
8/21/2008,4,0,2,3,9
8/22/2008,8,0,4,11,23
8/23/2008,14,0,16,3,33
8/24/2008,8,0,15,11,34
8/25/2008,6,0,3,8,17
8/26/2008,13,0,5,11,29
8/27/2008,4,0,5,3,12
8/28/2008,5,0,9,1,15
8/29/2008,13,0,6,13,32
8/30/2008,11,0,2,14,27
8/31/2008,11,0,10,3,24
9/1/2008,14,0,10,1,25
9/2/2008,16,0,11,1,28
9/3/2008,11,0,14,16,41
9/4/2008,9,0,8,3,20
9/5/2008,13,0,3,8,24
9/6/2008,12,0,12,6,30
9/7/2008,9,0,12,7,28
9/8/2008,12,0,15,14,41
9/9/2008,8,0,5,9,22
9/10/2008,5,0,8,10,23
9/11/2008,12,0,13,11,36
9/12/2008,13,0,10,6,29
9/13/2008,6,0,6,11,23
9/14/2008,7,0,11,15,33
9/15/2008,16,0,6,4,26
9/16/2008,9,0,3,4,16
9/17/2008,6,0,12,4,22
9/18/2008,5,0,12,10,27
9/19/2008,13,0,16,12,41
9/20/2008,10,0,7,10,27
9/21/2008,7,0,2,14,23
9/22/2008,16,0,14,0,30
9/23/2008,16,0,15,6,37
9/24/2008,10,0,9,12,31
9/25/2008,7,0,4,14,25
9/26/2008,11,0,12,7,30
9/27/2008,10,0,7,9,26
9/28/2008,14,0,3,7,24
9/29/2008,14,0,16,6,36
9/30/2008,11,0,10,2,23
10/1/2008,11,0,4,14,29
10/2/2008,15,0,16,7,38
10/3/2008,13,0,11,5,29
10/4/2008,10,0,16,0,26
10/5/2008,14,0,8,3,25
10/6/2008,13,0,4,16,33
10/7/2008,5,0,8,12,25
10/8/2008,14,0,3,1,18
10/9/2008,11,0,6,16,33
10/10/2008,10,0,7,3,20
10/11/2008,8,0,2,0,10
10/12/2008,8,0,11,4,23
10/13/2008,9,0,8,16,33
10/14/2008,7,0,10,0,17
10/15/2008,16,0,3,8,27
10/16/2008,10,0,14,11,35
10/17/2008,15,0,3,5,23
10/18/2008,6,0,11,0,17
10/19/2008,6,0,8,9,23
10/20/2008,7,0,2,13,22
10/21/2008,11,0,10,14,35
10/22/2008,15,0,2,4,21
10/23/2008,14,0,12,15,41
10/24/2008,5,0,9,14,28
10/25/2008,16,0,4,8,28
10/26/2008,4,0,13,0,17
10/27/2008,9,0,10,5,24
10/28/2008,11,0,3,0,14
10/29/2008,11,0,11,8,30
10/30/2008,10,0,16,16,42
10/31/2008,11,0,8,8,27
11/1/2008,8,0,15,3,26
11/2/2008,13,0,2,12,27
11/3/2008,6,0,7,9,22
11/4/2008,10,0,8,0,18
11/5/2008,14,0,13,10,37
11/6/2008,11,0,11,7,29
11/7/2008,13,0,9,3,25
11/8/2008,13,0,9,12,34
11/9/2008,16,0,2,13,31
11/10/2008,6,0,10,15,31
11/11/2008,15,0,3,8,26
11/12/2008,16,0,15,1,32
11/13/2008,13,0,12,9,34
11/14/2008,4,0,9,11,24
11/15/2008,9,0,8,16,33
11/16/2008,7,0,15,5,27
11/17/2008,15,0,15,8,38
11/18/2008,5,0,2,0,7
11/19/2008,16,0,5,1,22
11/20/2008,6,0,5,10,21
11/21/2008,6,0,3,11,20
11/22/2008,9,0,11,12,32
11/23/2008,9,0,4,0,13
11/24/2008,5,0,4,16,25
11/25/2008,8,0,14,3,25
11/26/2008,10,0,9,13,32
11/27/2008,16,0,12,3,31
11/28/2008,16,0,15,11,42
11/29/2008,5,0,14,16,35
11/30/2008,4,0,8,6,18
12/1/2008,6,0,8,11,25
12/2/2008,10,0,4,16,30
12/3/2008,5,0,8,12,25
12/4/2008,11,0,2,0,13
12/5/2008,4,0,16,5,25
12/6/2008,12,0,15,9,36
12/7/2008,11,0,2,14,27
12/8/2008,10,0,12,11,33
12/9/2008,8,0,2,13,23
12/10/2008,16,0,15,11,42
12/11/2008,14,0,15,0,29
12/12/2008,16,0,16,0,32
12/13/2008,6,0,5,1,12
12/14/2008,4,0,7,16,27
12/15/2008,4,0,11,5,20
12/16/2008,5,0,2,0,7
12/17/2008,9,0,15,14,38
12/18/2008,11,0,4,15,30
12/19/2008,15,0,4,8,27
12/20/2008,7,0,12,12,31
12/21/2008,16,0,14,10,40
12/22/2008,14,0,9,0,23
12/23/2008,10,0,3,2,15
12/24/2008,8,0,7,11,26
12/25/2008,14,0,14,13,41
12/26/2008,10,0,14,6,30
12/27/2008,6,0,14,3,23
12/28/2008,15,0,6,10,31
12/29/2008,8,0,3,13,24
12/30/2008,6,0,11,10,27
12/31/2008,13,0,11,6,30
1/1/2009,10,0,8,1,19
1/2/2009,7,0,10,14,31
1/3/2009,5,0,16,4,25
1/4/2009,8,0,5,3,16
1/5/2009,6,0,9,0,15
1/6/2009,4,0,3,10,17
1/7/2009,14,0,15,15,44
1/8/2009,5,0,8,13,26
1/9/2009,10,0,15,13,38
1/10/2009,14,0,16,10,40
1/11/2009,14,0,2,1,17
1/12/2009,4,0,2,6,12
1/13/2009,9,0,15,2,26
1/14/2009,7,0,11,11,29
1/15/2009,15,0,10,8,33
1/16/2009,12,0,6,3,21
1/17/2009,13,0,11,2,26
1/18/2009,11,0,3,2,16
1/19/2009,13,0,2,14,29
1/20/2009,6,0,14,5,25
1/21/2009,14,0,13,9,36
1/22/2009,13,0,15,10,38
1/23/2009,5,0,6,15,26
1/24/2009,5,0,6,2,13
1/25/2009,4,0,8,14,26
1/26/2009,12,0,2,11,25
1/27/2009,8,0,13,4,25
1/28/2009,10,0,4,0,14
1/29/2009,13,0,14,11,38
1/30/2009,4,0,15,9,28
1/31/2009,11,0,3,5,19
2/1/2009,7,0,16,2,25
2/2/2009,12,0,10,9,31
2/3/2009,11,0,8,10,29
2/4/2009,6,0,4,13,23
2/5/2009,8,0,10,11,29
2/6/2009,5,0,10,13,28
2/7/2009,8,0,6,0,14
2/8/2009,13,0,7,14,34
2/9/2009,12,0,8,9,29
2/10/2009,9,0,3,5,17
2/11/2009,5,0,9,13,27
2/12/2009,8,0,11,9,28
2/13/2009,4,0,4,9,17
2/14/2009,6,0,14,14,34
2/15/2009,14,0,15,8,37
2/16/2009,7,0,2,8,17
2/17/2009,10,0,13,6,29
2/18/2009,16,0,6,4,26
2/19/2009,16,0,3,5,24
2/20/2009,6,0,14,13,33
2/21/2009,7,0,2,13,22
2/22/2009,14,0,16,6,36
2/23/2009,6,0,8,13,27
2/24/2009,12,0,2,16,30
2/25/2009,12,0,7,10,29
2/26/2009,8,0,13,8,29
2/27/2009,16,0,11,11,38
2/28/2009,4,0,12,8,24
3/1/2009,16,0,2,15,33
3/2/2009,5,0,6,5,16
3/3/2009,6,0,6,8,20
3/4/2009,9,0,16,13,38
3/5/2009,14,0,3,8,25
3/6/2009,15,0,13,4,32
3/7/2009,10,0,2,15,27
3/8/2009,4,0,5,1,10
3/9/2009,9,0,5,8,22
3/10/2009,15,0,4,4,23
3/11/2009,10,0,5,15,30
3/12/2009,10,0,9,14,33
3/13/2009,14,0,7,8,29
3/14/2009,5,0,16,3,24
3/15/2009,4,0,14,16,34
3/16/2009,11,0,10,9,30
3/17/2009,11,0,5,13,29
3/18/2009,13,0,9,13,35
3/19/2009,13,0,4,10,27
3/20/2009,9,0,5,16,30
3/21/2009,8,0,4,5,17
3/22/2009,16,0,4,14,34
3/23/2009,10,0,15,6,31
3/24/2009,15,0,11,6,32
3/25/2009,6,0,10,8,24
3/26/2009,7,0,14,14,35
3/27/2009,6,0,12,6,24
3/28/2009,14,0,6,4,24
3/29/2009,7,0,16,4,27
3/30/2009,16,0,15,13,44
3/31/2009,16,0,3,4,23
4/1/2009,8,0,6,6,20
4/2/2009,16,0,2,16,34
4/3/2009,9,0,6,13,28
4/4/2009,11,0,5,6,22
4/5/2009,10,0,13,5,28
4/6/2009,4,0,11,13,28
4/7/2009,15,0,2,2,19
4/8/2009,11,0,10,5,26
4/9/2009,6,0,10,1,17
4/10/2009,12,0,6,8,26
4/11/2009,16,0,10,5,31
4/12/2009,9,0,14,16,39
4/13/2009,12,0,4,12,28
4/14/2009,12,0,16,14,42
4/15/2009,11,0,5,4,20
4/16/2009,4,0,7,13,24
4/17/2009,8,0,15,9,32
4/18/2009,8,0,10,15,33
4/19/2009,10,0,3,15,28
4/20/2009,6,0,6,1,13
4/21/2009,10,0,7,7,24
4/22/2009,11,0,7,16,34
4/23/2009,7,0,12,16,35
4/24/2009,12,0,6,7,25
4/25/2009,16,0,12,2,30
4/26/2009,9,0,11,16,36
4/27/2009,4,0,12,4,20
4/28/2009,10,0,4,6,20
4/29/2009,13,0,7,13,33
4/30/2009,10,0,9,13,32
5/1/2009,6,0,6,6,18
5/2/2009,6,0,14,8,28
5/3/2009,7,0,9,13,29
5/4/2009,15,0,5,14,34
5/5/2009,13,0,7,14,34
5/6/2009,12,0,6,2,20
5/7/2009,6,0,16,13,35
5/8/2009,10,0,2,1,13
5/9/2009,7,0,12,1,20
5/10/2009,8,0,8,4,20
5/11/2009,7,0,7,5,19
5/12/2009,6,0,4,0,10
5/13/2009,10,0,2,1,13
5/14/2009,9,0,3,6,18
5/15/2009,12,0,13,10,35
5/16/2009,6,0,8,0,14
5/17/2009,5,0,6,0,11
5/18/2009,14,0,16,7,37
5/19/2009,4,0,13,12,29
5/20/2009,7,0,7,1,15
5/21/2009,5,0,5,15,25
5/22/2009,13,0,16,16,45
5/23/2009,9,0,3,12,24
5/24/2009,12,0,11,12,35
5/25/2009,16,0,16,14,46
5/26/2009,4,0,16,14,34
5/27/2009,5,0,9,4,18
5/28/2009,12,0,13,13,38
5/29/2009,12,0,3,4,19
5/30/2009,6,0,12,7,25
5/31/2009,6,0,15,0,21
6/1/2009,7,0,2,13,22
6/2/2009,15,0,16,11,42
6/3/2009,10,0,5,16,31
6/4/2009,11,0,8,11,30
6/5/2009,9,0,9,14,32
6/6/2009,15,0,2,6,23
6/7/2009,12,0,11,5,28
6/8/2009,13,0,4,5,22
6/9/2009,5,0,6,15,26
6/10/2009,11,0,5,1,17
6/11/2009,15,0,3,8,26
6/12/2009,10,0,7,0,17
6/13/2009,6,0,12,10,28
6/14/2009,16,0,13,5,34
6/15/2009,14,0,7,2,23
6/16/2009,15,0,9,15,39
6/17/2009,7,0,11,5,23
6/18/2009,9,0,10,12,31
6/19/2009,5,0,14,15,34
6/20/2009,15,0,4,7,26
6/21/2009,8,0,13,2,23
6/22/2009,9,0,5,9,23
6/23/2009,9,0,11,1,21
6/24/2009,6,0,10,13,29
6/25/2009,6,0,3,11,20
6/26/2009,9,0,3,11,23
6/27/2009,5,0,4,6,15
6/28/2009,16,0,12,9,37
6/29/2009,10,0,11,5,26
6/30/2009,16,0,2,1,19
7/1/2009,11,0,7,11,29
7/2/2009,5,0,12,4,21
7/3/2009,12,0,8,15,35
7/4/2009,16,0,16,3,35
7/5/2009,8,0,3,12,23
7/6/2009,13,0,15,5,33
7/7/2009,14,0,10,13,37
7/8/2009,11,0,5,12,28
7/9/2009,11,0,14,4,29
7/10/2009,8,0,9,6,23
7/11/2009,14,0,9,6,29
7/12/2009,16,0,16,2,34
7/13/2009,5,0,16,1,22
7/14/2009,11,0,16,3,30
7/15/2009,15,0,16,13,44
7/16/2009,9,0,6,12,27
7/17/2009,9,0,16,6,31
7/18/2009,5,0,14,4,23
7/19/2009,12,0,5,12,29
7/20/2009,9,0,7,1,17
7/21/2009,6,0,15,9,30
7/22/2009,15,0,13,10,38
7/23/2009,14,0,10,8,32
7/24/2009,10,0,4,16,30
7/25/2009,5,0,9,4,18
7/26/2009,14,0,3,2,19
7/27/2009,12,0,15,1,28
7/28/2009,9,0,2,1,12
7/29/2009,6,0,16,2,24
7/30/2009,15,0,16,14,45
7/31/2009,6,0,12,7,25
8/1/2009,4,0,8,11,23
8/2/2009,9,0,2,5,16
8/3/2009,11,0,6,3,20
8/4/2009,10,0,16,0,26
8/5/2009,15,0,5,16,36
8/6/2009,7,0,15,16,38
8/7/2009,8,0,10,2,20
8/8/2009,14,0,15,4,33
8/9/2009,12,0,7,9,28
8/10/2009,11,0,11,16,38
8/11/2009,10,0,5,10,25
8/12/2009,14,0,8,2,24
8/13/2009,4,0,14,16,34
8/14/2009,13,0,9,4,26
8/15/2009,12,0,7,9,28
8/16/2009,14,0,12,8,34
8/17/2009,15,0,7,0,22
8/18/2009,6,0,9,0,15
8/19/2009,11,0,4,7,22
8/20/2009,4,0,11,12,27
8/21/2009,9,0,7,12,28
8/22/2009,11,0,12,14,37
8/23/2009,5,0,9,9,23
8/24/2009,11,0,2,7,20
8/25/2009,12,0,4,16,32
8/26/2009,4,0,6,3,13
8/27/2009,15,0,15,1,31
8/28/2009,13,0,12,2,27
8/29/2009,14,0,8,1,23
8/30/2009,16,0,10,16,42
8/31/2009,13,0,11,14,38
9/1/2009,8,0,7,12,27
9/2/2009,6,0,14,9,29
9/3/2009,10,0,12,0,22
9/4/2009,15,0,4,9,28
9/5/2009,15,0,7,4,26
9/6/2009,10,0,13,8,31
9/7/2009,5,0,13,1,19
9/8/2009,8,0,10,8,26
9/9/2009,14,0,5,3,22
9/10/2009,6,0,2,11,19
9/11/2009,14,0,14,1,29
9/12/2009,7,0,7,15,29
9/13/2009,14,0,7,4,25
9/14/2009,9,0,5,12,26
9/15/2009,10,0,9,6,25
9/16/2009,5,0,15,12,32
9/17/2009,4,0,5,16,25
9/18/2009,16,0,10,13,39
9/19/2009,14,0,8,14,36
9/20/2009,11,0,16,14,41
9/21/2009,16,0,12,6,34
9/22/2009,15,0,9,5,29
9/23/2009,12,0,14,8,34
9/24/2009,15,0,12,13,40
9/25/2009,5,0,5,10,20
9/26/2009,6,0,3,16,25
9/27/2009,15,0,8,3,26
9/28/2009,5,0,5,16,26
9/29/2009,4,0,7,1,12
9/30/2009,14,0,14,0,28
10/1/2009,9,0,14,8,31
10/2/2009,8,0,7,14,29
10/3/2009,9,0,3,10,22
10/4/2009,16,0,3,8,27
10/5/2009,11,0,7,8,26
10/6/2009,8,0,3,5,16
10/7/2009,12,0,13,8,33
10/8/2009,11,0,6,3,20
10/9/2009,16,0,9,2,27
10/10/2009,4,0,14,7,25
10/11/2009,6,0,14,10,30
10/12/2009,14,0,15,0,29
10/13/2009,12,0,2,0,14
10/14/2009,8,0,14,13,35
10/15/2009,13,0,11,12,36
10/16/2009,14,0,15,0,29
10/17/2009,7,0,10,6,23
10/18/2009,4,0,3,10,17
10/19/2009,10,0,7,6,23
10/20/2009,5,0,9,12,26
10/21/2009,14,0,14,0,28
10/22/2009,15,0,9,7,31
10/23/2009,13,0,4,4,21
10/24/2009,15,0,5,8,28
10/25/2009,6,0,5,14,25
10/26/2009,6,0,12,15,33
10/27/2009,14,0,13,1,28
10/28/2009,8,0,4,16,28
10/29/2009,10,0,13,7,30
10/30/2009,12,0,2,6,20
10/31/2009,6,0,12,15,33
11/1/2009,13,0,2,7,22
11/2/2009,13,0,3,15,31
11/3/2009,13,0,3,8,24
11/4/2009,6,0,10,13,29
11/5/2009,7,0,11,5,23
11/6/2009,6,0,7,2,15
11/7/2009,14,0,16,11,41
11/8/2009,5,0,3,15,23
11/9/2009,14,0,5,5,24
11/10/2009,4,0,6,16,26
11/11/2009,6,0,14,0,20
11/12/2009,6,0,9,3,18
11/13/2009,8,0,9,1,18
11/14/2009,8,0,2,13,23
11/15/2009,11,0,5,5,21
11/16/2009,9,0,8,7,24
11/17/2009,8,0,15,12,35
11/18/2009,6,0,4,9,19
11/19/2009,11,0,16,4,31
11/20/2009,13,0,13,5,31
11/21/2009,9,0,3,9,21
11/22/2009,7,0,5,5,17
11/23/2009,14,0,5,15,34
11/24/2009,8,0,7,4,19
11/25/2009,6,0,2,8,16
11/26/2009,5,0,9,0,14
11/27/2009,9,0,8,1,18
11/28/2009,9,0,8,9,26
11/29/2009,7,0,9,2,18
11/30/2009,10,0,11,0,21
12/1/2009,11,0,9,14,34
12/2/2009,6,0,16,4,26
12/3/2009,6,0,2,11,19
12/4/2009,8,0,7,14,29
12/5/2009,6,0,8,8,22
12/6/2009,15,0,4,4,23
12/7/2009,11,0,10,13,34
12/8/2009,6,0,2,13,21
12/9/2009,12,0,13,4,29
12/10/2009,9,0,2,4,15
12/11/2009,4,0,7,3,14
12/12/2009,10,0,3,16,29
12/13/2009,16,0,9,5,30
12/14/2009,12,0,11,2,25
12/15/2009,16,0,2,2,20
12/16/2009,11,0,6,1,18
12/17/2009,16,0,15,10,41
12/18/2009,5,0,2,15,22
12/19/2009,8,0,13,8,29
12/20/2009,6,0,14,14,34
12/21/2009,6,0,2,0,8
12/22/2009,10,0,9,12,31
12/23/2009,10,0,6,0,16
12/24/2009,10,0,12,12,34
12/25/2009,6,0,9,7,22
12/26/2009,5,0,13,0,18
12/27/2009,11,0,3,7,21
12/28/2009,6,0,11,10,27
12/29/2009,6,0,3,6,15
12/30/2009,7,0,2,8,17
12/31/2009,10,0,8,16,34
1/1/2010,8,0,7,11,26
1/2/2010,5,0,10,14,29
1/3/2010,16,0,8,0,24
1/4/2010,10,0,8,9,27
1/5/2010,5,0,3,7,15
1/6/2010,12,0,16,7,35
1/7/2010,15,0,9,15,39
1/8/2010,11,0,6,11,28
1/9/2010,6,0,6,2,14
1/10/2010,14,0,2,14,30
1/11/2010,16,0,15,15,46
1/12/2010,9,0,14,1,24
1/13/2010,8,0,11,5,24
1/14/2010,4,0,7,14,25
1/15/2010,4,0,15,5,24
1/16/2010,10,0,2,16,28
1/17/2010,16,0,14,6,36
1/18/2010,10,0,11,11,32
1/19/2010,10,0,11,16,37
1/20/2010,8,0,6,10,24
1/21/2010,13,0,6,13,32
1/22/2010,6,0,15,12,33
1/23/2010,4,0,5,3,12
1/24/2010,7,0,4,16,27
1/25/2010,10,0,9,12,31
1/26/2010,15,0,7,16,38
1/27/2010,6,0,8,8,22
1/28/2010,11,0,16,16,43
1/29/2010,5,0,16,13,34
1/30/2010,16,0,4,12,32
1/31/2010,11,0,10,4,25
2/1/2010,8,0,12,11,31
2/2/2010,4,0,9,4,17
2/3/2010,5,0,10,8,23
2/4/2010,9,0,2,2,13
2/5/2010,8,0,5,11,24
2/6/2010,5,0,16,14,35
2/7/2010,6,0,9,10,25
2/8/2010,10,0,3,4,17
2/9/2010,9,0,16,16,41
2/10/2010,12,0,7,12,31
2/11/2010,16,0,11,0,27
2/12/2010,7,0,2,5,14
2/13/2010,5,0,4,13,22
2/14/2010,13,0,5,4,22
2/15/2010,13,0,15,9,37
2/16/2010,10,0,11,16,37
2/17/2010,4,0,15,16,35
2/18/2010,10,0,2,8,20
2/19/2010,10,0,7,14,31
2/20/2010,4,0,11,14,29
2/21/2010,12,0,6,15,33
2/22/2010,15,0,11,10,36
2/23/2010,15,0,3,14,32
2/24/2010,10,0,10,0,20
2/25/2010,15,0,3,10,28
2/26/2010,6,0,16,0,22
2/27/2010,8,0,15,7,30
2/28/2010,5,0,7,2,14
3/1/2010,14,0,7,3,24
3/2/2010,9,0,4,15,28
3/3/2010,9,0,5,8,22
3/4/2010,8,0,8,7,23
3/5/2010,15,0,4,9,28
3/6/2010,7,0,8,10,25
3/7/2010,5,0,2,16,23
3/8/2010,9,0,12,7,28
3/9/2010,7,0,10,12,29
3/10/2010,13,0,14,0,27
3/11/2010,6,0,14,15,35
3/12/2010,16,0,2,9,27
3/13/2010,5,0,3,14,22
3/14/2010,8,0,6,0,14
3/15/2010,12,0,11,10,33
3/16/2010,4,0,14,6,24
3/17/2010,16,0,10,13,39
3/18/2010,7,0,7,9,23
3/19/2010,14,0,12,9,35
3/20/2010,14,0,10,4,28
3/21/2010,15,0,5,12,32
3/22/2010,7,0,5,4,16
3/23/2010,10,0,14,7,31
3/24/2010,10,0,13,13,36
3/25/2010,8,0,7,7,22
3/26/2010,9,0,9,6,24
3/27/2010,10,0,5,2,17
3/28/2010,15,0,3,0,18
3/29/2010,11,0,11,9,31
3/30/2010,5,0,10,2,17
3/31/2010,7,0,15,0,22
4/1/2010,13,0,8,16,37
4/2/2010,9,0,11,7,27
4/3/2010,13,0,9,12,34
4/4/2010,11,0,12,12,35
4/5/2010,6,0,4,15,25
4/6/2010,11,0,9,4,24
4/7/2010,15,0,6,7,28
4/8/2010,5,0,12,12,29
4/9/2010,12,0,13,2,27
4/10/2010,9,0,7,13,29
4/11/2010,4,0,12,2,18
4/12/2010,8,0,6,6,20
4/13/2010,12,0,16,1,29
4/14/2010,5,0,3,13,21
4/15/2010,16,0,11,1,28
4/16/2010,8,0,7,8,23
4/17/2010,6,0,13,13,32
4/18/2010,9,0,14,15,38
4/19/2010,13,0,15,3,31
4/20/2010,15,0,13,11,39
4/21/2010,8,0,5,5,18
4/22/2010,14,0,7,12,33
4/23/2010,5,0,3,8,16
4/24/2010,10,0,4,16,30
4/25/2010,15,0,13,14,42
4/26/2010,7,0,9,10,26
4/27/2010,6,0,3,4,13
4/28/2010,15,0,3,3,21
4/29/2010,8,0,8,3,19
4/30/2010,6,0,14,6,26
5/1/2010,11,0,3,11,25
5/2/2010,8,0,16,6,30
5/3/2010,9,0,14,2,25
5/4/2010,10,0,7,13,30
5/5/2010,16,0,14,3,33
5/6/2010,10,0,15,13,38
5/7/2010,15,0,7,13,35
5/8/2010,13,0,8,14,35
5/9/2010,4,0,16,13,33
5/10/2010,10,0,13,9,32
5/11/2010,9,0,6,9,24
5/12/2010,7,0,9,10,26
5/13/2010,12,0,11,5,28
5/14/2010,15,0,14,2,31
5/15/2010,11,0,9,5,25
5/16/2010,12,0,7,8,27
5/17/2010,6,0,10,16,32
5/18/2010,7,0,10,12,29
5/19/2010,4,0,14,10,28
5/20/2010,4,0,6,16,26
5/21/2010,13,0,9,0,22
5/22/2010,4,0,16,5,25
5/23/2010,15,0,14,8,37
5/24/2010,6,0,3,12,21
5/25/2010,9,0,5,6,20
5/26/2010,5,0,6,2,13
5/27/2010,15,0,13,10,38
5/28/2010,15,0,2,14,31
5/29/2010,11,0,5,10,26
5/30/2010,14,0,13,11,38
5/31/2010,4,0,14,9,27
6/1/2010,14,0,11,5,30
6/2/2010,14,0,16,7,37
6/3/2010,15,0,8,4,27
6/4/2010,9,0,10,4,23
6/5/2010,12,0,3,10,25
6/6/2010,9,0,4,8,21
6/7/2010,8,0,12,11,31
6/8/2010,9,0,7,10,26
6/9/2010,10,0,8,2,20
6/10/2010,15,0,13,7,35
6/11/2010,11,0,9,9,29
6/12/2010,15,0,14,8,37
6/13/2010,9,0,13,4,26
6/14/2010,13,0,3,5,21
6/15/2010,10,0,7,7,24
6/16/2010,9,0,7,2,18
6/17/2010,15,0,7,12,34
6/18/2010,16,0,3,4,23
6/19/2010,11,0,12,0,23
6/20/2010,12,0,4,11,27
6/21/2010,9,0,5,15,29
6/22/2010,7,0,4,11,22
6/23/2010,16,0,8,2,26
6/24/2010,14,0,8,11,33
6/25/2010,12,0,16,5,33
6/26/2010,6,0,7,10,23
6/27/2010,10,0,5,4,19
6/28/2010,5,0,8,13,26
6/29/2010,8,0,15,1,24
6/30/2010,13,0,10,13,36
7/1/2010,13,0,16,16,45
7/2/2010,4,0,8,15,27
7/3/2010,4,0,3,10,17
7/4/2010,6,0,10,14,30
7/5/2010,5,0,8,12,25
7/6/2010,8,0,9,12,29
7/7/2010,11,0,7,10,28
7/8/2010,5,0,15,15,35
7/9/2010,9,0,10,15,34
7/10/2010,14,0,2,3,19
7/11/2010,12,0,15,5,32
7/12/2010,13,0,15,9,37
7/13/2010,12,0,3,12,27
7/14/2010,4,0,15,10,29
7/15/2010,13,0,15,0,28
7/16/2010,16,0,4,5,25
7/17/2010,13,0,9,5,27
7/18/2010,8,0,4,0,12
7/19/2010,10,0,9,13,32
7/20/2010,4,0,2,9,15
7/21/2010,6,0,15,14,35
7/22/2010,12,0,12,13,37
7/23/2010,6,0,2,12,20
7/24/2010,11,0,3,2,16
7/25/2010,8,0,15,7,30
7/26/2010,11,0,12,11,34
7/27/2010,11,0,8,3,22
7/28/2010,5,0,4,15,24
7/29/2010,8,0,3,10,21
7/30/2010,6,0,4,15,25
7/31/2010,10,0,11,4,25
8/1/2010,14,0,3,8,25
8/2/2010,12,0,12,3,27
8/3/2010,13,0,12,15,40
8/4/2010,7,0,3,0,10
8/5/2010,12,0,15,16,43
8/6/2010,6,0,12,15,33
8/7/2010,7,0,15,14,36
8/8/2010,11,0,8,7,26
8/9/2010,6,0,9,12,27
8/10/2010,11,0,12,12,35
8/11/2010,7,0,9,16,32
8/12/2010,15,0,10,9,34
8/13/2010,6,0,4,5,15
8/14/2010,14,0,11,16,41
8/15/2010,16,0,16,1,33
8/16/2010,12,0,6,15,33
8/17/2010,10,0,5,14,29
8/18/2010,13,0,9,9,31
8/19/2010,15,0,10,13,38
8/20/2010,7,0,5,2,14
8/21/2010,12,0,5,0,17
8/22/2010,15,0,12,14,41
8/23/2010,4,0,11,6,21
8/24/2010,7,0,15,1,23
8/25/2010,16,0,7,10,33
8/26/2010,6,0,7,15,28
8/27/2010,5,0,12,7,24
8/28/2010,15,0,8,8,31
8/29/2010,15,0,4,1,20
8/30/2010,10,0,14,15,39
8/31/2010,15,0,5,3,23
9/1/2010,15,0,15,0,30
9/2/2010,6,0,2,6,14
9/3/2010,12,0,12,1,25
9/4/2010,11,0,15,11,37
9/5/2010,6,0,2,4,12
9/6/2010,4,0,14,0,18
9/7/2010,15,0,14,4,33
9/8/2010,6,0,5,13,24
9/9/2010,12,0,3,15,30
9/10/2010,8,0,11,12,31
9/11/2010,7,0,16,14,37
9/12/2010,9,0,4,10,23
9/13/2010,14,0,4,16,34
9/14/2010,7,0,16,9,32
9/15/2010,8,0,8,10,26
9/16/2010,15,0,6,0,21
9/17/2010,13,0,9,3,25
9/18/2010,10,0,9,1,20
9/19/2010,5,0,7,10,22
9/20/2010,9,0,6,14,29
9/21/2010,13,0,11,6,30
9/22/2010,13,0,11,8,32
9/23/2010,14,0,6,3,23
9/24/2010,7,0,10,14,31
9/25/2010,12,0,14,14,40
9/26/2010,11,0,16,7,34
9/27/2010,10,0,5,12,27
9/28/2010,7,0,3,16,26
9/29/2010,7,0,9,7,23
9/30/2010,5,0,15,5,25
10/1/2010,12,0,12,15,39
10/2/2010,6,0,11,2,19
10/3/2010,12,0,10,10,32
10/4/2010,9,0,9,2,20
10/5/2010,14,0,4,9,27
10/6/2010,11,0,7,11,29
10/7/2010,12,0,16,13,41
10/8/2010,9,0,11,15,35
10/9/2010,4,0,16,7,27
10/10/2010,13,0,3,16,32
10/11/2010,12,0,10,13,35
10/12/2010,11,0,13,9,33
10/13/2010,8,0,11,8,27
10/14/2010,8,0,5,12,25
10/15/2010,13,0,4,6,23
10/16/2010,4,0,9,8,21
10/17/2010,4,0,6,4,14
10/18/2010,10,0,2,7,19
10/19/2010,7,0,3,4,14
10/20/2010,6,0,8,2,16
10/21/2010,14,0,10,6,30
10/22/2010,8,0,11,13,32
10/23/2010,16,0,14,5,35
10/24/2010,16,0,10,16,42
10/25/2010,8,0,16,8,32
10/26/2010,15,0,7,5,27
10/27/2010,15,0,2,5,22
10/28/2010,16,0,11,2,29
10/29/2010,6,0,3,13,22
10/30/2010,4,0,7,7,18
10/31/2010,10,0,6,1,17
11/1/2010,9,0,2,11,22
11/2/2010,4,0,16,6,26
11/3/2010,12,0,10,7,29
11/4/2010,12,0,8,2,22
11/5/2010,8,0,15,14,37
11/6/2010,9,0,13,6,28
11/7/2010,13,0,3,1,17
11/8/2010,12,0,5,16,33
11/9/2010,16,0,16,15,47
11/10/2010,11,0,14,12,37
11/11/2010,13,0,16,16,45
11/12/2010,6,0,8,6,20
11/13/2010,5,0,8,6,19
11/14/2010,13,0,7,10,30
11/15/2010,7,0,3,8,18
11/16/2010,5,0,5,10,20
11/17/2010,11,0,10,6,27
11/18/2010,8,0,13,2,23
11/19/2010,8,0,14,7,29
11/20/2010,14,0,15,14,43
11/21/2010,9,0,14,5,28
11/22/2010,13,0,4,8,25
11/23/2010,12,0,10,15,37
11/24/2010,13,0,13,11,37
11/25/2010,5,0,9,0,14
11/26/2010,8,0,5,11,24
11/27/2010,7,0,9,12,28
11/28/2010,12,0,10,14,36
11/29/2010,15,0,8,8,31
11/30/2010,4,0,5,14,23
12/1/2010,4,0,9,1,14
12/2/2010,4,0,11,0,15
12/3/2010,11,0,10,6,27
12/4/2010,11,0,10,8,29
12/5/2010,16,0,11,1,28
12/6/2010,8,0,6,3,17
12/7/2010,9,0,5,3,17
12/8/2010,12,0,6,13,31
12/9/2010,6,0,5,6,17
12/10/2010,8,0,14,4,26
12/11/2010,12,0,12,15,39
12/12/2010,10,0,2,15,27
12/13/2010,12,0,12,13,37
12/14/2010,13,0,9,16,38
12/15/2010,11,0,16,2,29
12/16/2010,16,0,12,15,43
12/17/2010,15,0,7,0,22
12/18/2010,8,0,13,2,23
12/19/2010,13,0,2,6,21
12/20/2010,15,0,3,12,30
12/21/2010,14,0,2,10,26
12/22/2010,13,0,7,15,35
12/23/2010,11,0,15,11,37
12/24/2010,10,0,6,3,19
12/25/2010,15,0,9,3,27
12/26/2010,9,0,10,9,28
12/27/2010,15,0,7,15,37
12/28/2010,9,0,12,9,30
12/29/2010,11,0,11,0,22
12/30/2010,14,0,10,4,28
12/31/2010,4,0,10,1,15
1/1/2011,8,0,14,11,33
1/2/2011,11,0,5,13,29
1/3/2011,14,0,5,7,26
1/4/2011,6,0,3,2,11
1/5/2011,11,0,3,5,19
1/6/2011,13,0,6,3,22
1/7/2011,12,0,7,6,25
1/8/2011,4,0,11,12,27
1/9/2011,5,0,5,4,14
1/10/2011,12,0,7,12,31
1/11/2011,5,0,3,9,17
1/12/2011,15,0,3,8,26
1/13/2011,9,0,9,9,27
1/14/2011,14,0,3,5,22
1/15/2011,16,0,14,6,36
1/16/2011,12,0,12,4,28
1/17/2011,6,0,9,4,19
1/18/2011,7,0,12,10,29
1/19/2011,5,0,3,1,9
1/20/2011,6,0,9,16,31
1/21/2011,11,0,7,5,23
1/22/2011,14,0,6,4,24
1/23/2011,9,0,16,14,39
1/24/2011,5,0,16,4,25
1/25/2011,13,0,10,11,34
1/26/2011,10,0,2,14,26
1/27/2011,4,0,14,8,26
1/28/2011,5,0,12,15,32
1/29/2011,14,0,10,13,37
1/30/2011,7,0,14,1,22
1/31/2011,6,0,10,5,21
2/1/2011,15,0,9,11,35
2/2/2011,8,0,7,9,24
2/3/2011,7,0,10,6,23
2/4/2011,12,0,4,8,24
2/5/2011,10,0,12,1,23
2/6/2011,16,0,9,10,35
2/7/2011,9,0,16,9,34
2/8/2011,13,0,7,2,22
2/9/2011,10,0,3,7,20
2/10/2011,5,0,16,15,36
2/11/2011,7,0,6,1,14
2/12/2011,11,0,16,2,29
2/13/2011,7,0,14,9,30
2/14/2011,13,0,11,5,29
2/15/2011,16,0,5,6,27
2/16/2011,13,0,15,9,37
2/17/2011,10,0,4,15,29
2/18/2011,9,0,11,8,28
2/19/2011,5,0,2,3,10
2/20/2011,4,0,6,10,20
2/21/2011,15,0,2,9,26
2/22/2011,11,0,2,7,20
2/23/2011,15,0,15,6,36
2/24/2011,16,0,9,9,34
2/25/2011,14,0,12,5,31
2/26/2011,13,0,15,14,42
2/27/2011,16,0,13,15,44
2/28/2011,7,0,14,15,36
3/1/2011,14,0,9,5,28
3/2/2011,9,0,4,4,17
3/3/2011,9,0,5,14,28
3/4/2011,14,0,15,0,29
3/5/2011,16,0,7,13,36
3/6/2011,4,0,8,0,12
3/7/2011,7,0,7,8,22
3/8/2011,14,0,6,5,25
3/9/2011,8,0,15,1,24
3/10/2011,6,0,10,1,17
3/11/2011,14,0,2,8,24
3/12/2011,14,0,10,6,30
3/13/2011,7,0,8,15,30
3/14/2011,5,0,14,16,35
3/15/2011,12,0,14,5,31
3/16/2011,11,0,10,3,24
3/17/2011,5,0,10,16,31
3/18/2011,14,0,9,11,34
3/19/2011,13,0,3,7,23
3/20/2011,16,0,11,14,41
3/21/2011,9,0,14,5,28
3/22/2011,12,0,4,1,17
3/23/2011,11,0,10,0,21
3/24/2011,10,0,5,15,30
3/25/2011,16,0,15,8,39
3/26/2011,4,0,14,8,26
3/27/2011,8,0,8,0,16
3/28/2011,16,0,5,11,32
3/29/2011,9,0,13,6,28
3/30/2011,15,0,14,4,33
3/31/2011,7,0,7,7,21
4/1/2011,14,0,7,5,26
4/2/2011,13,0,3,8,24
4/3/2011,4,0,15,0,19
4/4/2011,12,0,10,2,24
4/5/2011,10,0,11,8,29
4/6/2011,13,0,8,4,25
4/7/2011,4,0,8,6,18
4/8/2011,12,0,13,15,40
4/9/2011,8,0,8,6,22
4/10/2011,6,0,5,15,26
4/11/2011,4,0,10,10,24
4/12/2011,5,0,12,10,27
4/13/2011,12,0,5,14,31
4/14/2011,7,0,6,12,25
4/15/2011,12,0,12,8,32
4/16/2011,4,0,12,14,30
4/17/2011,5,0,15,13,33
4/18/2011,11,0,4,4,19
4/19/2011,9,0,4,12,25
4/20/2011,4,0,9,10,23
4/21/2011,8,0,2,11,21
4/22/2011,9,0,6,3,18
4/23/2011,14,0,10,1,25
4/24/2011,13,0,4,7,24
4/25/2011,5,0,3,1,9
4/26/2011,14,0,11,10,35
4/27/2011,15,0,6,0,21
4/28/2011,16,0,7,3,26
4/29/2011,15,0,10,5,30
4/30/2011,5,0,3,9,17
5/1/2011,6,0,15,13,34
5/2/2011,16,0,8,10,34
5/3/2011,16,0,10,13,39
5/4/2011,15,0,2,6,23
5/5/2011,6,0,14,11,31
5/6/2011,12,0,5,16,33
5/7/2011,4,0,5,7,16
5/8/2011,4,0,2,10,16
5/9/2011,14,0,8,1,23
5/10/2011,9,0,11,2,22
5/11/2011,5,0,8,6,19
5/12/2011,6,0,11,13,30
5/13/2011,4,0,4,9,17
5/14/2011,4,0,3,16,23
5/15/2011,9,0,9,12,30
5/16/2011,10,0,9,0,19
5/17/2011,12,0,12,8,32
5/18/2011,9,0,7,5,21
5/19/2011,12,0,11,10,33
5/20/2011,6,0,14,0,20
5/21/2011,11,0,16,15,42
5/22/2011,7,0,5,8,20
5/23/2011,7,0,6,5,18
5/24/2011,16,0,9,12,37
5/25/2011,11,0,7,5,23
5/26/2011,5,0,9,10,24
5/27/2011,11,0,14,13,38
5/28/2011,14,0,13,8,35
5/29/2011,9,0,5,7,21
5/30/2011,6,0,10,5,21
5/31/2011,7,0,4,1,12
6/1/2011,16,0,4,13,33
6/2/2011,7,0,13,15,35
6/3/2011,10,0,7,14,31
6/4/2011,9,0,13,11,33
6/5/2011,7,0,13,10,30
6/6/2011,6,0,9,4,19
6/7/2011,15,0,5,6,26
6/8/2011,16,0,5,3,24
6/9/2011,4,0,8,5,17
6/10/2011,6,0,2,11,19
6/11/2011,16,0,13,1,30
6/12/2011,7,0,11,10,28
6/13/2011,4,0,3,15,22
6/14/2011,6,0,8,14,28
6/15/2011,13,0,2,3,18
6/16/2011,13,0,8,4,25
6/17/2011,16,0,12,3,31
6/18/2011,13,0,10,13,36
6/19/2011,8,0,3,13,24
6/20/2011,9,0,11,5,25
6/21/2011,5,0,15,0,20
6/22/2011,8,0,11,9,28
6/23/2011,8,0,5,7,20
6/24/2011,11,0,15,4,30
6/25/2011,15,0,9,4,28
6/26/2011,8,0,4,5,17
6/27/2011,13,0,5,12,30
6/28/2011,5,0,16,5,26
6/29/2011,15,0,10,3,28
6/30/2011,13,0,9,15,37
7/1/2011,13,0,5,9,27
7/2/2011,5,0,13,6,24
7/3/2011,10,0,15,11,36
7/4/2011,7,0,2,2,11
7/5/2011,7,0,8,12,27
7/6/2011,11,0,14,5,30
7/7/2011,12,0,14,0,26
7/8/2011,6,0,14,5,25
7/9/2011,8,0,6,15,29
7/10/2011,7,0,15,6,28
7/11/2011,8,0,8,4,20
7/12/2011,6,0,10,15,31
7/13/2011,4,0,16,14,34
7/14/2011,14,0,9,11,34
7/15/2011,16,0,15,12,43
7/16/2011,16,0,2,1,19
7/17/2011,16,0,10,6,32
7/18/2011,13,0,16,9,38
7/19/2011,16,0,15,8,39
7/20/2011,14,0,3,0,17
7/21/2011,6,0,14,16,36
7/22/2011,6,0,11,8,25
7/23/2011,8,0,10,3,21
7/24/2011,8,0,11,8,27
7/25/2011,4,0,14,1,19
7/26/2011,11,0,10,15,36
7/27/2011,13,0,16,10,39
7/28/2011,14,0,14,12,40
7/29/2011,6,0,11,4,21
7/30/2011,5,0,4,14,23
7/31/2011,7,0,11,15,33
8/1/2011,6,0,4,9,19
8/2/2011,8,0,7,4,19
8/3/2011,11,0,14,11,36
8/4/2011,16,0,16,4,36
8/5/2011,16,0,2,4,22
8/6/2011,5,0,9,4,18
8/7/2011,7,0,6,12,25
8/8/2011,7,0,9,11,27
8/9/2011,6,0,11,13,30
8/10/2011,13,0,16,15,44
8/11/2011,16,0,16,8,40
8/12/2011,13,0,11,5,29
8/13/2011,9,0,9,0,18
8/14/2011,6,0,16,12,34
8/15/2011,10,0,3,8,21
8/16/2011,4,0,15,13,32
8/17/2011,12,0,3,15,30
8/18/2011,8,0,13,10,31
8/19/2011,16,0,2,15,33
8/20/2011,5,0,6,16,27
8/21/2011,6,0,4,2,12
8/22/2011,16,0,8,13,37
8/23/2011,4,0,8,3,15
8/24/2011,16,0,13,11,40
8/25/2011,9,0,2,13,24
8/26/2011,10,0,9,11,30
8/27/2011,15,0,14,16,45
8/28/2011,15,0,4,0,19
8/29/2011,4,0,6,10,20
8/30/2011,4,0,5,5,14
8/31/2011,14,0,4,5,23
9/1/2011,16,0,8,6,30
9/2/2011,8,0,10,2,20
9/3/2011,8,0,2,1,11
9/4/2011,8,0,15,16,39
9/5/2011,7,0,13,10,30
9/6/2011,6,0,8,11,25
9/7/2011,14,0,3,9,26
9/8/2011,10,0,6,13,29
9/9/2011,11,0,7,6,24
9/10/2011,7,0,15,8,30
9/11/2011,7,0,12,4,23
9/12/2011,15,0,11,5,31
9/13/2011,10,0,9,12,31
9/14/2011,11,0,16,7,34
9/15/2011,7,0,10,3,20
9/16/2011,11,0,8,1,20
9/17/2011,11,0,16,10,37
9/18/2011,16,0,2,13,31
9/19/2011,7,0,9,7,23
9/20/2011,4,0,3,14,21
9/21/2011,10,0,5,3,18
9/22/2011,4,0,3,3,10
9/23/2011,14,0,16,12,42
9/24/2011,11,0,12,13,36
9/25/2011,15,0,16,9,40
9/26/2011,13,0,11,3,27
9/27/2011,8,0,14,2,24
9/28/2011,13,0,12,3,28
9/29/2011,9,0,15,12,36
9/30/2011,12,0,9,1,22
10/1/2011,14,0,3,0,17
10/2/2011,9,0,9,10,28
10/3/2011,14,0,2,7,23
10/4/2011,9,0,14,15,38
10/5/2011,13,0,6,6,25
10/6/2011,11,0,14,0,25
10/7/2011,7,0,9,2,18
10/8/2011,9,0,4,7,20
10/9/2011,11,0,3,10,24
10/10/2011,10,0,14,3,27
10/11/2011,12,0,15,13,40
10/12/2011,6,0,5,5,16
10/13/2011,11,0,7,4,22
10/14/2011,13,0,15,2,30
10/15/2011,10,0,10,13,33
10/16/2011,12,0,5,8,25
10/17/2011,4,0,16,11,31
10/18/2011,12,0,4,14,30
10/19/2011,14,0,11,3,28
10/20/2011,4,0,10,8,22
10/21/2011,11,0,5,13,29
10/22/2011,9,0,10,2,21
10/23/2011,14,0,4,3,21
10/24/2011,6,0,11,11,28
10/25/2011,5,0,14,7,26
10/26/2011,9,0,12,5,26
10/27/2011,6,0,10,10,26
10/28/2011,11,0,4,7,22
10/29/2011,10,0,13,8,31
10/30/2011,11,0,3,4,18
10/31/2011,5,0,2,14,21
11/1/2011,7,0,15,5,27
11/2/2011,10,0,11,0,21
11/3/2011,15,0,4,4,23
11/4/2011,12,0,2,3,17
11/5/2011,9,0,13,10,32
11/6/2011,5,0,3,9,17
11/7/2011,15,0,8,0,23
11/8/2011,14,0,4,10,28
11/9/2011,7,0,10,6,23
11/10/2011,15,0,15,6,36
11/11/2011,8,0,4,13,25
11/12/2011,9,0,8,15,32
11/13/2011,13,0,9,5,27
11/14/2011,10,0,6,13,29
11/15/2011,4,0,8,1,13
11/16/2011,15,0,4,8,27
11/17/2011,15,0,10,4,29
11/18/2011,16,0,12,13,41
11/19/2011,16,0,12,7,35
11/20/2011,6,0,8,11,25
11/21/2011,16,0,9,11,36
11/22/2011,10,0,11,11,32
11/23/2011,6,0,7,6,19
11/24/2011,13,0,14,0,27
11/25/2011,13,0,12,1,26
11/26/2011,14,0,9,13,36
11/27/2011,8,0,14,6,28
11/28/2011,6,0,11,1,18
11/29/2011,6,0,6,12,24
11/30/2011,9,0,9,10,28
12/1/2011,7,0,5,1,13
12/2/2011,16,0,16,8,40
12/3/2011,12,0,2,15,29
12/4/2011,5,0,3,6,14
12/5/2011,15,0,12,8,35
12/6/2011,9,0,16,0,25
12/7/2011,16,0,10,10,36
12/8/2011,5,0,16,10,31
12/9/2011,15,0,9,5,29
12/10/2011,10,0,5,14,29
12/11/2011,4,0,12,8,24
12/12/2011,15,0,9,9,33
12/13/2011,9,0,16,4,29
12/14/2011,6,0,7,7,20
12/15/2011,6,0,5,5,16
12/16/2011,16,0,12,15,43
12/17/2011,10,0,5,10,25
12/18/2011,12,0,10,1,23
12/19/2011,5,0,10,8,23
12/20/2011,6,0,14,12,32
12/21/2011,11,0,15,0,26
12/22/2011,15,0,11,13,39
12/23/2011,16,0,6,12,34
12/24/2011,12,0,6,6,24
12/25/2011,5,0,4,1,10
12/26/2011,4,0,10,4,18
12/27/2011,4,0,13,5,22
12/28/2011,11,0,7,10,28
12/29/2011,10,0,8,2,20
12/30/2011,12,0,2,0,14
12/31/2011,8,0,6,13,27
1/1/2012,5,0,9,5,19
1/2/2012,6,0,5,3,14
1/3/2012,10,0,12,7,29
1/4/2012,8,0,9,10,27
1/5/2012,6,0,4,13,23
1/6/2012,4,0,6,8,18
1/7/2012,13,0,16,15,44
1/8/2012,8,0,13,6,27
1/9/2012,7,0,2,13,22
1/10/2012,16,0,15,14,45
1/11/2012,6,0,9,6,21
1/12/2012,12,0,5,5,22
1/13/2012,16,0,15,2,33
1/14/2012,12,0,12,14,38
1/15/2012,4,0,9,0,13
1/16/2012,15,0,2,0,17
1/17/2012,14,0,12,13,39
1/18/2012,10,0,2,1,13
1/19/2012,12,0,9,4,25
1/20/2012,14,0,7,14,35
1/21/2012,10,0,9,3,22
1/22/2012,8,0,10,8,26
1/23/2012,10,0,10,6,26
1/24/2012,4,0,8,12,24
1/25/2012,12,0,7,4,23
1/26/2012,8,0,11,13,32
1/27/2012,7,0,11,14,32
1/28/2012,14,0,14,13,41
1/29/2012,16,0,10,7,33
1/30/2012,6,0,13,3,22
1/31/2012,6,0,15,14,35
2/1/2012,8,0,10,0,18
2/2/2012,10,0,6,9,25
2/3/2012,11,0,15,11,37
2/4/2012,6,0,7,6,19
2/5/2012,15,0,12,12,39
2/6/2012,15,0,11,14,40
2/7/2012,10,0,14,10,34
2/8/2012,8,0,3,0,11
2/9/2012,16,0,16,16,48
2/10/2012,15,0,9,2,26
2/11/2012,4,0,5,4,13
2/12/2012,13,0,10,11,34
2/13/2012,10,0,6,3,19
2/14/2012,6,0,8,9,23
2/15/2012,15,0,16,13,44
2/16/2012,4,0,4,16,24
2/17/2012,14,0,16,15,45
2/18/2012,12,0,8,9,29
2/19/2012,8,0,12,6,26
2/20/2012,8,0,4,2,14
2/21/2012,15,0,4,9,28
2/22/2012,12,0,11,3,26
2/23/2012,14,0,10,16,40
2/24/2012,9,0,15,9,33
2/25/2012,11,0,16,10,37
2/26/2012,5,0,8,11,24
2/27/2012,14,0,13,2,29
2/28/2012,13,0,7,16,36
2/29/2012,12,0,14,15,41
3/1/2012,4,0,13,10,27
3/2/2012,14,0,11,4,29
3/3/2012,13,0,4,14,31
3/4/2012,7,0,10,2,19
3/5/2012,9,0,14,8,31
3/6/2012,13,0,12,7,32
3/7/2012,16,0,2,11,29
3/8/2012,11,0,7,14,32
3/9/2012,16,0,6,8,30
3/10/2012,12,0,10,16,38
3/11/2012,10,0,6,14,30
3/12/2012,9,0,3,7,19
3/13/2012,10,0,14,16,40
3/14/2012,7,0,12,10,29
3/15/2012,12,0,12,10,34
3/16/2012,9,0,6,2,17
3/17/2012,6,0,6,14,26
3/18/2012,7,0,9,3,19
3/19/2012,14,0,10,10,34
3/20/2012,6,0,13,9,28
3/21/2012,15,0,11,0,26
3/22/2012,13,0,15,6,34
3/23/2012,10,0,15,9,34
3/24/2012,9,0,14,4,27
3/25/2012,8,0,3,0,11
3/26/2012,5,0,14,8,27
3/27/2012,8,0,4,16,28
3/28/2012,15,0,16,12,43
3/29/2012,11,0,12,1,24
3/30/2012,15,0,4,5,24
3/31/2012,9,0,6,1,16
4/1/2012,4,0,13,10,27
4/2/2012,8,0,8,9,25
4/3/2012,11,0,2,8,21
4/4/2012,16,0,7,4,27
4/5/2012,7,0,8,14,29
4/6/2012,9,0,5,1,15
4/7/2012,8,0,4,15,27
4/8/2012,9,0,3,4,16
4/9/2012,9,0,4,5,18
4/10/2012,4,0,3,8,15
4/11/2012,7,0,5,6,18
4/12/2012,12,0,2,14,28
4/13/2012,4,0,4,10,18
4/14/2012,4,0,12,16,32
4/15/2012,14,0,2,1,17
4/16/2012,15,0,12,8,35
4/17/2012,6,0,10,10,26
4/18/2012,8,0,15,15,38
4/19/2012,10,0,2,5,17
4/20/2012,7,0,5,13,25
4/21/2012,8,0,10,0,18
4/22/2012,5,0,4,2,11
4/23/2012,14,0,7,15,36
4/24/2012,10,0,11,7,28
4/25/2012,6,0,8,16,30
4/26/2012,14,0,11,12,37
4/27/2012,12,0,11,11,34
4/28/2012,10,0,6,5,21
4/29/2012,8,0,8,6,22
4/30/2012,15,0,8,1,24
5/1/2012,11,0,9,0,20
5/2/2012,9,0,11,8,28
5/3/2012,14,0,12,8,34
5/4/2012,9,0,10,8,27
5/5/2012,15,0,6,6,27
5/6/2012,11,0,15,13,39
5/7/2012,14,0,7,3,24
5/8/2012,6,0,4,14,24
5/9/2012,16,0,13,16,45
5/10/2012,8,0,5,14,27
5/11/2012,11,0,6,6,23
5/12/2012,11,0,14,11,36
5/13/2012,10,0,4,15,29
5/14/2012,13,0,6,11,30
5/15/2012,11,0,10,11,32
5/16/2012,16,0,11,7,34
5/17/2012,5,0,12,8,25
5/18/2012,15,0,6,3,24
5/19/2012,11,0,6,9,26
5/20/2012,13,0,14,2,29
5/21/2012,14,0,5,8,27
5/22/2012,15,0,9,6,30
5/23/2012,9,0,14,2,25
5/24/2012,7,0,10,16,33
5/25/2012,5,0,5,12,22
5/26/2012,16,0,9,8,33
5/27/2012,15,0,5,12,32
5/28/2012,15,0,6,7,28
5/29/2012,16,0,2,1,19
5/30/2012,14,0,2,15,31
5/31/2012,8,0,2,1,11
6/1/2012,7,0,12,6,25
6/2/2012,8,0,12,10,30
6/3/2012,13,0,2,10,25
6/4/2012,15,0,15,12,42
6/5/2012,16,0,6,8,30
6/6/2012,9,0,3,7,19
6/7/2012,12,0,7,10,29
6/8/2012,7,0,8,10,25
6/9/2012,5,0,6,13,24
6/10/2012,7,0,13,0,20
6/11/2012,10,0,10,16,36
6/12/2012,9,0,4,13,26
6/13/2012,10,0,13,2,25
6/14/2012,7,0,5,7,19
6/15/2012,4,0,12,8,24
6/16/2012,16,0,15,3,34
6/17/2012,14,0,2,8,24
6/18/2012,10,0,10,13,33
6/19/2012,9,0,6,0,15
6/20/2012,10,0,2,7,19
6/21/2012,8,0,14,8,30
6/22/2012,4,0,5,0,9
6/23/2012,6,0,12,13,31
6/24/2012,8,0,8,10,26
6/25/2012,12,0,13,4,29
6/26/2012,4,0,16,3,23
6/27/2012,12,0,16,15,43
6/28/2012,9,0,14,0,23
6/29/2012,10,0,12,4,26
6/30/2012,16,0,6,2,24
7/1/2012,15,0,2,12,29
7/2/2012,14,0,3,3,20
7/3/2012,9,0,9,13,31
7/4/2012,12,0,12,6,30
7/5/2012,9,0,12,7,28
7/6/2012,10,0,8,5,23
7/7/2012,9,0,6,0,15
7/8/2012,10,0,14,10,34
7/9/2012,9,0,13,0,22
7/10/2012,8,0,8,6,22
7/11/2012,11,0,8,6,25
7/12/2012,14,0,2,4,20
7/13/2012,12,0,7,6,25
7/14/2012,7,0,10,8,25
7/15/2012,14,0,2,16,32
7/16/2012,9,0,10,7,26
7/17/2012,6,0,12,1,19
7/18/2012,16,0,6,16,38
7/19/2012,12,0,12,15,39
7/20/2012,11,0,12,4,27
7/21/2012,7,0,5,12,24
7/22/2012,7,0,14,13,34
7/23/2012,5,0,7,16,28
7/24/2012,11,0,4,11,26
7/25/2012,12,0,4,7,23
7/26/2012,4,0,5,3,12
7/27/2012,13,0,3,9,25
7/28/2012,9,0,9,7,25
7/29/2012,12,0,11,3,26
7/30/2012,8,0,10,7,25
7/31/2012,6,0,5,15,26
8/1/2012,10,0,10,15,35
8/2/2012,6,0,4,12,22
8/3/2012,10,0,7,11,28
8/4/2012,10,0,12,3,25
8/5/2012,11,0,12,0,23
8/6/2012,5,0,13,16,34
8/7/2012,6,0,9,6,21
8/8/2012,16,0,16,5,37
8/9/2012,6,0,12,12,30
8/10/2012,9,0,11,11,31
8/11/2012,6,0,6,14,26
8/12/2012,15,0,3,9,27
8/13/2012,11,0,13,14,38
8/14/2012,12,0,4,2,18
8/15/2012,5,0,11,7,23
8/16/2012,5,0,5,13,23
8/17/2012,16,0,13,4,33
8/18/2012,7,0,9,3,19
8/19/2012,16,0,11,1,28
8/20/2012,10,0,6,0,16
8/21/2012,14,0,10,16,40
8/22/2012,8,0,14,5,27
8/23/2012,4,0,6,5,15
8/24/2012,16,0,14,11,41
8/25/2012,15,0,9,3,27
8/26/2012,16,0,16,7,39
8/27/2012,6,0,8,14,28
8/28/2012,16,0,6,5,27
8/29/2012,7,0,5,0,12
8/30/2012,8,0,8,15,31
8/31/2012,8,0,5,2,15
9/1/2012,4,0,10,14,28
9/2/2012,10,0,15,11,36
9/3/2012,13,0,15,0,28
9/4/2012,7,0,9,11,27
9/5/2012,7,0,8,13,28
9/6/2012,6,0,10,16,32
9/7/2012,10,0,6,12,28
9/8/2012,16,0,8,7,31
9/9/2012,5,0,2,15,22
9/10/2012,8,0,8,4,20
9/11/2012,8,0,7,4,19
9/12/2012,13,0,5,9,27
9/13/2012,12,0,12,8,32
9/14/2012,15,0,15,12,42
9/15/2012,16,0,11,1,28
9/16/2012,10,0,10,8,28
9/17/2012,7,0,9,16,32
9/18/2012,16,0,10,7,33
9/19/2012,11,0,9,1,21
9/20/2012,12,0,8,2,22
9/21/2012,5,0,11,7,23
9/22/2012,11,0,12,3,26
9/23/2012,15,0,5,8,28
9/24/2012,15,0,8,8,31
9/25/2012,11,0,13,6,30
9/26/2012,7,0,5,10,22
9/27/2012,9,0,9,15,33
9/28/2012,7,0,9,12,28
9/29/2012,8,0,13,7,28
9/30/2012,8,0,16,4,28
10/1/2012,15,0,3,12,30
10/2/2012,10,0,8,1,19
10/3/2012,11,0,7,5,23
10/4/2012,9,0,16,12,37
10/5/2012,15,0,2,5,22
10/6/2012,8,0,7,6,21
10/7/2012,5,0,8,5,18
10/8/2012,5,0,11,12,28
10/9/2012,12,0,7,0,19
10/10/2012,12,0,16,12,40
10/11/2012,14,0,9,13,36
10/12/2012,15,0,14,5,34
10/13/2012,15,0,8,2,25
10/14/2012,8,0,4,0,12
10/15/2012,15,0,14,7,36
10/16/2012,12,0,2,6,20
10/17/2012,9,0,13,12,34
10/18/2012,9,0,3,7,19
10/19/2012,9,0,10,10,29
10/20/2012,15,0,15,4,34
10/21/2012,11,0,2,8,21
10/22/2012,12,0,11,2,25
10/23/2012,9,0,7,3,19
10/24/2012,16,0,15,4,35
10/25/2012,4,0,15,16,35
10/26/2012,9,0,6,8,23
10/27/2012,14,0,5,11,30
10/28/2012,4,0,16,14,34
10/29/2012,11,0,8,11,30
10/30/2012,8,0,10,16,34
10/31/2012,12,0,10,2,24
11/1/2012,16,0,11,3,30
11/2/2012,9,0,13,11,33
11/3/2012,16,0,11,6,33
11/4/2012,10,0,7,9,26
11/5/2012,14,0,5,2,21
11/6/2012,12,0,8,7,27
11/7/2012,15,0,7,14,36
11/8/2012,7,0,6,0,13
11/9/2012,12,0,4,13,29
11/10/2012,6,0,14,4,24
11/11/2012,8,0,13,4,25
11/12/2012,5,0,5,6,16
11/13/2012,5,0,12,14,31
11/14/2012,4,0,2,6,12
11/15/2012,16,0,13,11,40
11/16/2012,14,0,16,12,42
11/17/2012,7,0,7,15,29
11/18/2012,8,0,14,3,25
11/19/2012,6,0,10,8,24
11/20/2012,7,0,12,4,23
11/21/2012,15,0,4,16,35
11/22/2012,10,0,3,13,26
11/23/2012,15,0,7,3,25
11/24/2012,13,0,13,6,32
11/25/2012,8,0,2,7,17
11/26/2012,11,0,7,3,21
11/27/2012,12,0,13,11,36
11/28/2012,10,0,7,13,30
11/29/2012,11,0,13,14,38
11/30/2012,16,0,10,4,30
12/1/2012,8,0,9,10,27
12/2/2012,4,0,9,7,20
12/3/2012,7,0,6,1,14
12/4/2012,13,0,16,14,43
12/5/2012,13,0,3,7,23
12/6/2012,12,0,15,0,27
12/7/2012,10,0,5,5,20
12/8/2012,13,0,8,2,23
12/9/2012,10,0,8,12,30
12/10/2012,5,0,4,0,9
12/11/2012,4,0,12,11,27
12/12/2012,9,0,9,8,26
12/13/2012,5,0,15,8,28
12/14/2012,10,0,9,9,28
12/15/2012,15,0,16,3,34
12/16/2012,16,0,11,13,40
12/17/2012,7,0,9,8,24
12/18/2012,15,0,5,4,24
12/19/2012,9,0,11,7,27
12/20/2012,15,0,14,11,40
12/21/2012,15,0,6,16,37
12/22/2012,5,0,3,10,18
12/23/2012,14,0,8,9,31
12/24/2012,12,0,2,12,26
12/25/2012,5,0,6,12,23
12/26/2012,9,0,13,11,33
12/27/2012,10,0,14,15,39
12/28/2012,12,0,3,3,18
12/29/2012,9,0,7,11,27
12/30/2012,5,0,10,15,30
12/31/2012,5,0,2,13,20
1/1/2013,14,0,9,15,38
1/2/2013,10,0,5,15,30
1/3/2013,9,0,16,12,37
1/4/2013,12,0,12,10,34
1/5/2013,11,0,2,0,13
1/6/2013,15,0,7,1,23
1/7/2013,11,0,6,15,32
1/8/2013,4,0,10,15,29
1/9/2013,5,0,12,12,29
1/10/2013,15,0,16,11,42
1/11/2013,14,0,6,12,32
1/12/2013,5,0,11,11,27
1/13/2013,8,0,7,14,29
1/14/2013,7,0,12,7,26
1/15/2013,15,0,11,16,42
1/16/2013,16,0,10,13,39
1/17/2013,9,0,14,11,34
1/18/2013,4,0,16,5,25
1/19/2013,16,0,10,15,41
1/20/2013,14,0,5,16,35
1/21/2013,5,0,6,1,12
1/22/2013,7,0,3,15,25
1/23/2013,6,0,2,6,14
1/24/2013,10,0,8,0,18
1/25/2013,14,0,8,7,29
1/26/2013,12,0,16,3,31
1/27/2013,16,0,5,3,24
1/28/2013,16,0,7,0,23
1/29/2013,15,0,8,1,24
1/30/2013,5,0,15,5,25
1/31/2013,12,0,12,7,31
2/1/2013,11,0,11,13,35
2/2/2013,7,0,16,0,23
2/3/2013,16,0,2,16,34
2/4/2013,10,0,9,15,34
2/5/2013,4,0,4,7,15
2/6/2013,12,0,9,9,30
2/7/2013,12,0,2,7,21
2/8/2013,14,0,7,6,27
2/9/2013,11,0,10,15,36
2/10/2013,5,0,14,7,26
2/11/2013,15,0,16,9,40
2/12/2013,12,0,11,0,23
2/13/2013,9,0,10,2,21
2/14/2013,13,0,8,2,23
2/15/2013,9,0,11,6,26
2/16/2013,14,0,4,10,28
2/17/2013,10,0,12,10,32
2/18/2013,15,0,6,6,27
2/19/2013,14,0,3,11,28
2/20/2013,16,0,16,6,38
2/21/2013,13,0,12,1,26
2/22/2013,6,0,16,14,36
2/23/2013,13,0,11,10,34
2/24/2013,13,0,3,0,16
2/25/2013,11,0,4,2,17
2/26/2013,12,0,9,4,25
2/27/2013,11,0,3,1,15
2/28/2013,12,0,8,16,36
3/1/2013,9,0,13,6,28
3/2/2013,12,0,6,6,24
3/3/2013,11,0,8,3,22
3/4/2013,7,0,16,2,25
3/5/2013,8,0,8,15,31
3/6/2013,11,0,11,14,36
3/7/2013,4,0,15,5,24
3/8/2013,11,0,11,15,37
3/9/2013,7,0,7,13,27
3/10/2013,11,0,8,13,32
3/11/2013,13,0,8,10,31
3/12/2013,4,0,6,7,17
3/13/2013,13,0,8,14,35
3/14/2013,14,0,13,16,43
3/15/2013,7,0,14,9,30
3/16/2013,12,0,5,0,17
3/17/2013,7,0,9,0,16
3/18/2013,12,0,13,14,39
3/19/2013,4,0,16,12,32
3/20/2013,5,0,6,14,25
3/21/2013,5,0,15,16,36
3/22/2013,7,0,6,5,18
3/23/2013,7,0,12,3,22
3/24/2013,7,0,3,10,20
3/25/2013,16,0,9,5,30
3/26/2013,14,0,16,7,37
3/27/2013,11,0,2,5,18
3/28/2013,13,0,12,0,25
3/29/2013,11,0,16,3,30
3/30/2013,7,0,15,1,23
3/31/2013,13,0,15,14,42
4/1/2013,11,0,8,3,22
4/2/2013,4,0,7,5,16
4/3/2013,12,0,4,12,28
4/4/2013,8,0,3,3,14
4/5/2013,4,0,15,2,21
4/6/2013,16,0,15,15,46
4/7/2013,12,0,10,16,38
4/8/2013,5,0,5,4,14
4/9/2013,8,0,9,9,26
4/10/2013,6,0,6,6,18
4/11/2013,16,0,6,6,28
4/12/2013,12,0,13,5,30
4/13/2013,12,0,14,9,35
4/14/2013,10,0,13,8,31
4/15/2013,10,0,7,5,22
4/16/2013,6,0,6,6,18
4/17/2013,16,0,16,10,42
4/18/2013,6,0,5,1,12
4/19/2013,7,0,5,5,17
4/20/2013,10,0,15,5,30
4/21/2013,6,0,8,2,16
4/22/2013,6,0,4,5,15
4/23/2013,10,0,15,2,27
4/24/2013,8,0,4,7,19
4/25/2013,6,0,15,2,23
4/26/2013,12,0,8,11,31
4/27/2013,16,0,14,3,33
4/28/2013,10,0,7,12,29
4/29/2013,11,0,10,13,34
4/30/2013,14,0,15,7,36
5/1/2013,12,0,16,6,34
5/2/2013,5,0,12,2,19
5/3/2013,4,0,16,3,23
5/4/2013,12,0,4,1,17
5/5/2013,15,0,3,16,34
5/6/2013,4,0,10,13,27
5/7/2013,13,0,13,11,37
5/8/2013,4,0,4,12,20
5/9/2013,8,0,15,13,36
5/10/2013,13,0,8,2,23
5/11/2013,14,0,3,1,18
5/12/2013,16,0,13,5,34
5/13/2013,6,0,7,13,26
5/14/2013,4,0,16,14,34
5/15/2013,6,0,11,0,17
5/16/2013,6,0,16,16,38
5/17/2013,13,0,11,10,34
5/18/2013,12,0,7,12,31
5/19/2013,12,0,13,4,29
5/20/2013,10,0,2,14,26
5/21/2013,4,0,15,5,24
5/22/2013,12,0,3,16,31
5/23/2013,10,0,5,8,23
5/24/2013,6,0,5,9,20
5/25/2013,7,0,7,11,25
5/26/2013,6,0,12,9,27
5/27/2013,14,0,13,1,28
5/28/2013,4,0,9,4,17
5/29/2013,9,0,5,6,20
5/30/2013,7,0,4,8,19
5/31/2013,6,0,7,14,27
6/1/2013,9,0,12,4,25
6/2/2013,8,0,10,16,34
6/3/2013,4,0,3,13,20
6/4/2013,7,0,15,7,29
6/5/2013,7,0,11,13,31
6/6/2013,12,0,4,7,23
6/7/2013,9,0,7,5,21
6/8/2013,5,0,11,4,20
6/9/2013,6,0,16,15,37
6/10/2013,15,0,5,9,29
6/11/2013,11,0,11,4,26
6/12/2013,5,0,13,0,18
6/13/2013,6,0,3,12,21
6/14/2013,5,0,15,8,28
6/15/2013,4,0,2,9,15
6/16/2013,15,0,15,13,43
6/17/2013,15,0,5,13,33
6/18/2013,13,0,7,16,36
6/19/2013,11,0,3,16,30
6/20/2013,8,0,12,1,21
6/21/2013,8,0,14,14,36
6/22/2013,14,0,4,2,20
6/23/2013,11,0,15,13,39
6/24/2013,10,0,11,3,24
6/25/2013,10,0,2,4,16
6/26/2013,15,0,11,10,36
6/27/2013,5,0,5,0,10
6/28/2013,5,0,4,11,20
6/29/2013,9,0,3,16,28
6/30/2013,16,0,14,0,30
7/1/2013,15,0,13,8,36
7/2/2013,4,0,2,5,11
7/3/2013,6,0,7,3,16
7/4/2013,6,0,2,9,17
7/5/2013,11,0,9,11,31
7/6/2013,5,0,15,15,35
7/7/2013,15,0,14,4,33
7/8/2013,8,0,14,5,27
7/9/2013,15,0,12,0,27
7/10/2013,13,0,8,9,30
7/11/2013,16,0,3,12,31
7/12/2013,16,0,10,4,30
7/13/2013,7,0,13,13,33
7/14/2013,12,0,15,5,32
7/15/2013,16,0,11,10,37
7/16/2013,5,0,5,10,20
7/17/2013,14,0,5,4,23
7/18/2013,4,0,13,3,20
7/19/2013,8,0,9,8,25
7/20/2013,7,0,4,4,15
7/21/2013,16,0,10,3,29
7/22/2013,11,0,12,10,33
7/23/2013,8,0,15,4,27
7/24/2013,15,0,12,9,36
7/25/2013,16,0,11,1,28
7/26/2013,7,0,9,2,18
7/27/2013,15,0,5,13,33
7/28/2013,15,0,10,9,34
7/29/2013,8,0,9,3,20
7/30/2013,10,0,14,11,35
7/31/2013,7,0,8,10,25
8/1/2013,14,0,5,9,28
8/2/2013,5,0,6,7,18
8/3/2013,13,0,2,9,24
8/4/2013,11,0,2,14,27
8/5/2013,5,0,14,15,34
8/6/2013,4,0,9,3,16
8/7/2013,4,0,5,6,15
8/8/2013,11,0,16,13,40
8/9/2013,12,0,16,1,29
8/10/2013,9,0,7,9,25
8/11/2013,14,0,6,14,34
8/12/2013,7,0,13,10,30
8/13/2013,6,0,12,5,23
8/14/2013,9,0,13,16,38
8/15/2013,7,0,16,1,24
8/16/2013,10,0,11,3,24
8/17/2013,7,0,10,3,20
8/18/2013,10,0,7,0,17
8/19/2013,9,0,12,11,32
8/20/2013,9,0,10,8,27
8/21/2013,4,0,13,13,30
8/22/2013,10,0,6,15,31
8/23/2013,14,0,3,10,27
8/24/2013,7,0,7,10,24
8/25/2013,16,0,7,2,25
8/26/2013,15,0,4,7,26
8/27/2013,16,0,10,11,37
8/28/2013,7,0,8,8,23
8/29/2013,7,0,12,13,32
8/30/2013,6,0,16,13,35
8/31/2013,14,0,14,6,34
9/1/2013,9,0,6,5,20
9/2/2013,12,0,13,12,37
9/3/2013,5,0,12,1,18
9/4/2013,15,0,12,12,39
9/5/2013,16,0,6,3,25
9/6/2013,14,0,7,7,28
9/7/2013,14,0,9,5,28
9/8/2013,4,0,15,14,33
9/9/2013,16,0,6,0,22
9/10/2013,4,0,2,0,6
9/11/2013,5,0,15,11,31
9/12/2013,10,0,11,9,30
9/13/2013,4,0,6,16,26
9/14/2013,12,0,9,14,35
9/15/2013,16,0,16,16,48
9/16/2013,6,0,6,1,13
9/17/2013,6,0,9,2,17
9/18/2013,6,0,12,3,21
9/19/2013,9,0,16,9,34
9/20/2013,12,0,10,13,35
9/21/2013,12,0,3,12,27
9/22/2013,9,0,12,5,26
9/23/2013,9,0,5,12,26
9/24/2013,7,0,14,0,21
9/25/2013,6,0,15,8,29
9/26/2013,10,0,16,7,33
9/27/2013,8,0,12,11,31
9/28/2013,5,0,4,10,19
9/29/2013,16,0,3,4,23
9/30/2013,8,0,7,10,25
10/1/2013,14,0,15,8,37
10/2/2013,10,0,9,3,22
10/3/2013,15,0,6,4,25
10/4/2013,8,0,11,14,33
10/5/2013,10,0,11,8,29
10/6/2013,8,0,3,4,15
10/7/2013,16,0,15,13,44
10/8/2013,9,0,12,8,29
10/9/2013,5,0,4,3,12
10/10/2013,16,0,8,5,29
10/11/2013,10,0,8,9,27
10/12/2013,4,0,10,1,15
10/13/2013,16,0,6,1,23
10/14/2013,16,0,15,3,34
10/15/2013,8,0,12,10,30
10/16/2013,14,0,9,4,27
10/17/2013,15,0,7,0,22
10/18/2013,16,0,12,3,31
10/19/2013,5,0,14,0,19
10/20/2013,12,0,8,11,31
10/21/2013,8,0,4,15,27
10/22/2013,9,0,6,16,31
10/23/2013,8,0,14,15,37
10/24/2013,7,0,9,11,27
10/25/2013,10,0,14,3,27
10/26/2013,10,0,5,3,18
10/27/2013,5,0,8,2,15
10/28/2013,16,0,13,8,37
10/29/2013,12,0,4,11,27
10/30/2013,16,0,13,11,40
10/31/2013,9,0,15,5,29
11/1/2013,15,0,13,15,43
11/2/2013,16,0,12,0,28
11/3/2013,4,0,12,7,23
11/4/2013,14,0,4,8,26
11/5/2013,11,0,4,12,27
11/6/2013,9,0,7,3,19
11/7/2013,11,0,4,14,29
11/8/2013,11,0,8,0,19
11/9/2013,16,0,7,13,36
11/10/2013,11,0,10,3,24
11/11/2013,7,0,8,4,19
11/12/2013,12,0,8,3,23
11/13/2013,16,0,5,13,34
11/14/2013,11,0,13,2,26
11/15/2013,15,0,7,8,30
11/16/2013,15,0,7,3,25
11/17/2013,8,0,10,7,25
11/18/2013,9,0,14,12,35
11/19/2013,10,0,8,6,24
11/20/2013,9,0,6,0,15
11/21/2013,7,0,13,14,34
11/22/2013,10,0,12,14,36
11/23/2013,4,0,9,1,14
11/24/2013,6,0,14,8,28
11/25/2013,6,0,4,6,16
11/26/2013,6,0,3,11,20
11/27/2013,15,0,10,5,30
11/28/2013,15,0,6,15,36
11/29/2013,13,0,13,9,35
11/30/2013,14,0,7,3,24
12/1/2013,9,0,12,7,28
12/2/2013,8,0,5,5,18
12/3/2013,12,0,8,1,21
12/4/2013,7,0,15,16,38
12/5/2013,15,0,16,0,31
12/6/2013,15,0,8,3,26
12/7/2013,13,0,15,13,41
12/8/2013,4,0,7,11,22
12/9/2013,12,0,4,15,31
12/10/2013,8,0,6,16,30
12/11/2013,13,0,10,16,39
12/12/2013,15,0,10,2,27
12/13/2013,7,0,8,9,24
12/14/2013,7,0,8,13,28
12/15/2013,7,0,15,10,32
12/16/2013,13,0,16,0,29
12/17/2013,15,0,6,9,30
12/18/2013,7,0,6,3,16
12/19/2013,16,0,5,3,24
12/20/2013,4,0,11,12,27
12/21/2013,10,0,8,10,28
12/22/2013,8,0,4,6,18
12/23/2013,11,0,13,10,34
12/24/2013,14,0,7,13,34
12/25/2013,6,0,8,4,18
12/26/2013,11,0,11,10,32
12/27/2013,6,0,4,9,19
12/28/2013,13,0,8,10,31
12/29/2013,5,0,14,14,33
12/30/2013,15,0,8,2,25
12/31/2013,13,0,3,14,30
1/1/2014,5,0,8,10,23
1/2/2014,16,0,6,12,34
1/3/2014,12,0,14,6,32
1/4/2014,11,0,15,10,36
1/5/2014,14,0,15,8,37
1/6/2014,14,0,10,2,26
1/7/2014,10,0,12,0,22
1/8/2014,8,0,2,15,25
1/9/2014,13,0,6,1,20
1/10/2014,16,0,5,1,22
1/11/2014,12,0,2,13,27
1/12/2014,9,0,9,9,27
1/13/2014,10,0,14,6,30
1/14/2014,4,0,2,5,11
1/15/2014,16,0,5,6,27
1/16/2014,9,0,3,8,20
1/17/2014,6,0,3,3,12
1/18/2014,13,0,3,2,18
1/19/2014,11,0,13,11,35
1/20/2014,12,0,16,7,35
1/21/2014,10,0,7,7,24
1/22/2014,15,0,2,5,22
1/23/2014,15,0,9,8,32
1/24/2014,5,0,2,16,23
1/25/2014,4,0,16,2,22
1/26/2014,13,0,4,9,26
1/27/2014,6,0,2,5,13
1/28/2014,4,0,5,0,9
1/29/2014,9,0,3,7,19
1/30/2014,10,0,14,11,35
1/31/2014,4,0,13,15,32
2/1/2014,15,0,15,11,41
2/2/2014,15,0,6,3,24
2/3/2014,14,0,3,13,30
2/4/2014,10,0,16,2,28
2/5/2014,4,0,16,0,20
2/6/2014,11,0,12,10,33
2/7/2014,15,0,12,9,36
2/8/2014,7,0,12,0,19
2/9/2014,11,0,4,6,21
2/10/2014,14,0,6,1,21
2/11/2014,8,0,16,12,36
2/12/2014,6,0,16,8,30
2/13/2014,6,0,8,9,23
2/14/2014,4,0,12,0,16
2/15/2014,11,0,4,9,24
2/16/2014,7,0,14,12,33
2/17/2014,9,0,14,4,27
2/18/2014,13,0,7,13,33
2/19/2014,13,0,16,14,43
2/20/2014,6,0,6,6,18
2/21/2014,7,0,11,13,31
2/22/2014,12,0,12,12,36
2/23/2014,5,0,11,12,28
2/24/2014,4,0,3,2,9
2/25/2014,4,0,16,7,27
2/26/2014,8,0,10,0,18
2/27/2014,14,0,6,8,28
2/28/2014,11,0,12,9,32
3/1/2014,11,0,4,4,19
3/2/2014,12,0,7,10,29
3/3/2014,16,0,16,9,41
3/4/2014,9,0,8,6,23
3/5/2014,13,0,11,0,24
3/6/2014,15,0,12,6,33
3/7/2014,10,0,14,1,25
3/8/2014,9,0,15,9,33
3/9/2014,9,0,4,9,22
3/10/2014,10,0,9,7,26
3/11/2014,7,0,5,12,24
3/12/2014,10,0,5,5,20
3/13/2014,10,0,10,16,36
3/14/2014,11,0,13,12,36
3/15/2014,6,0,11,16,33
3/16/2014,15,0,15,9,39
3/17/2014,13,0,12,16,41
3/18/2014,10,0,3,5,18
3/19/2014,15,0,7,7,29
3/20/2014,9,0,10,0,19
3/21/2014,4,0,6,8,18
3/22/2014,12,0,9,15,36
3/23/2014,11,0,2,0,13
3/24/2014,5,0,9,3,17
3/25/2014,10,0,13,0,23
3/26/2014,11,0,5,5,21
3/27/2014,14,0,7,9,30
3/28/2014,16,0,13,3,32
3/29/2014,16,0,7,10,33
3/30/2014,5,0,7,6,18
3/31/2014,14,0,11,9,34
4/1/2014,12,0,15,12,39
4/2/2014,7,0,3,11,21
4/3/2014,5,0,7,10,22
4/4/2014,7,0,3,6,16
4/5/2014,4,0,7,15,26
4/6/2014,12,0,10,5,27
4/7/2014,6,0,12,13,31
4/8/2014,11,0,6,1,18
4/9/2014,12,0,7,1,20
4/10/2014,12,0,12,1,25
4/11/2014,15,0,4,0,19
4/12/2014,12,0,15,9,36
4/13/2014,15,0,12,8,35
4/14/2014,5,0,6,10,21
4/15/2014,9,0,2,11,22
4/16/2014,15,0,16,6,37
4/17/2014,10,0,5,10,25
4/18/2014,4,0,9,14,27
4/19/2014,10,0,6,10,26
4/20/2014,9,0,16,15,40
4/21/2014,9,0,9,2,20
4/22/2014,14,0,7,1,22
4/23/2014,9,0,15,12,36
4/24/2014,5,0,11,14,30
4/25/2014,9,0,11,9,29
4/26/2014,8,0,8,9,25
4/27/2014,16,0,7,5,28
4/28/2014,6,0,7,14,27
4/29/2014,4,0,4,7,15
4/30/2014,10,0,4,12,26
5/1/2014,8,0,8,5,21
5/2/2014,15,0,10,4,29
5/3/2014,15,0,3,16,34
5/4/2014,12,0,7,4,23
5/5/2014,5,0,5,10,20
5/6/2014,7,0,11,2,20
5/7/2014,13,0,2,9,24
5/8/2014,5,0,12,0,17
5/9/2014,5,0,13,16,34
5/10/2014,8,0,13,15,36
5/11/2014,6,0,6,7,19
5/12/2014,15,0,9,7,31
5/13/2014,4,0,2,4,10
5/14/2014,15,0,12,10,37
5/15/2014,13,0,12,5,30
5/16/2014,6,0,11,10,27
5/17/2014,14,0,14,7,35
5/18/2014,11,0,7,12,30
5/19/2014,5,0,14,11,30
5/20/2014,12,0,12,12,36
5/21/2014,15,0,6,13,34
5/22/2014,8,0,8,12,28
5/23/2014,15,0,10,6,31
5/24/2014,11,0,11,16,38
5/25/2014,6,0,12,7,25
5/26/2014,14,0,8,5,27
5/27/2014,12,0,16,16,44
5/28/2014,10,0,2,9,21
5/29/2014,7,0,14,0,21
5/30/2014,4,0,6,5,15
5/31/2014,7,0,7,2,16
6/1/2014,5,0,16,13,34
6/2/2014,6,0,13,15,34
6/3/2014,6,0,15,13,34
6/4/2014,7,0,8,13,28
6/5/2014,4,0,16,5,25
6/6/2014,6,0,4,1,11
6/7/2014,16,0,11,5,32
6/8/2014,16,0,8,13,37
6/9/2014,15,0,5,0,20
6/10/2014,15,0,13,4,32
6/11/2014,16,0,9,2,27
6/12/2014,7,0,4,14,25
6/13/2014,6,0,12,6,24
6/14/2014,13,0,11,13,37
6/15/2014,6,0,6,15,27
6/16/2014,16,0,3,14,33
6/17/2014,10,0,10,10,30
6/18/2014,6,0,11,12,29
6/19/2014,9,0,15,3,27
6/20/2014,6,0,4,2,12
6/21/2014,13,0,16,12,41
6/22/2014,6,0,7,15,28
6/23/2014,9,0,11,2,22
6/24/2014,7,0,10,0,17
6/25/2014,4,0,8,1,13
6/26/2014,4,0,16,2,22
6/27/2014,5,0,10,4,19
6/28/2014,4,0,9,11,24
6/29/2014,6,0,14,4,24
6/30/2014,14,0,12,2,28
7/1/2014,7,0,7,15,29
7/2/2014,16,0,7,6,29
7/3/2014,5,0,10,4,19
7/4/2014,15,0,15,0,30
7/5/2014,14,0,7,12,33
7/6/2014,12,0,14,0,26
7/7/2014,13,0,6,14,33
7/8/2014,13,0,8,14,35
7/9/2014,6,0,4,6,16
7/10/2014,10,0,4,7,21
7/11/2014,6,0,13,11,30
7/12/2014,10,0,16,4,30
7/13/2014,12,0,15,16,43
7/14/2014,7,0,6,1,14
7/15/2014,14,0,3,1,18
7/16/2014,10,0,15,2,27
7/17/2014,16,0,3,16,35
7/18/2014,6,0,14,6,26
7/19/2014,11,0,15,9,35
7/20/2014,13,0,15,14,42
7/21/2014,14,0,13,7,34
7/22/2014,5,0,4,3,12
7/23/2014,13,0,9,8,30
7/24/2014,7,0,10,12,29
7/25/2014,8,0,16,14,38
7/26/2014,8,0,6,8,22
7/27/2014,11,0,6,15,32
7/28/2014,4,0,3,16,23
7/29/2014,5,0,4,0,9
7/30/2014,15,0,2,9,26
7/31/2014,7,0,5,5,17
8/1/2014,10,0,11,9,30
8/2/2014,14,0,5,4,23
8/3/2014,15,0,14,7,36
8/4/2014,8,0,3,11,22
8/5/2014,13,0,11,8,32
8/6/2014,14,0,15,12,41
8/7/2014,12,0,12,8,32
8/8/2014,15,0,6,14,35
8/9/2014,4,0,9,5,18
8/10/2014,8,0,16,5,29
8/11/2014,6,0,12,5,23
8/12/2014,13,0,9,2,24
8/13/2014,11,0,10,9,30
8/14/2014,13,0,13,14,40
8/15/2014,9,0,13,3,25
8/16/2014,9,0,7,8,24
8/17/2014,6,0,14,5,25
8/18/2014,11,0,2,0,13
8/19/2014,13,0,8,4,25
8/20/2014,16,0,16,5,37
8/21/2014,14,0,5,8,27
8/22/2014,4,0,11,15,30
8/23/2014,16,0,10,4,30
8/24/2014,16,0,6,16,38
8/25/2014,9,0,2,12,23
8/26/2014,12,0,10,6,28
8/27/2014,9,0,2,15,26
8/28/2014,5,0,12,14,31
8/29/2014,6,0,3,10,19
8/30/2014,6,0,6,4,16
8/31/2014,12,0,5,1,18
9/1/2014,5,0,12,8,25
9/2/2014,8,0,6,11,25
9/3/2014,7,0,6,0,13
9/4/2014,8,0,11,1,20
9/5/2014,5,0,2,5,12
9/6/2014,9,0,2,1,12
9/7/2014,13,0,11,13,37
9/8/2014,5,0,15,15,35
9/9/2014,14,0,2,1,17
9/10/2014,11,0,11,0,22
9/11/2014,16,0,10,16,42
9/12/2014,13,0,5,5,23
9/13/2014,7,0,15,9,31
9/14/2014,7,0,16,2,25
9/15/2014,14,0,3,9,26
9/16/2014,10,0,9,2,21
9/17/2014,8,0,16,2,26
9/18/2014,9,0,13,9,31
9/19/2014,11,0,12,10,33
9/20/2014,13,0,14,7,34
9/21/2014,5,0,6,11,22
9/22/2014,4,0,2,11,17
9/23/2014,15,0,15,16,46
9/24/2014,5,0,14,14,33
9/25/2014,10,0,6,4,20
9/26/2014,9,0,16,16,41
9/27/2014,14,0,8,6,28
9/28/2014,5,0,12,13,30
9/29/2014,15,0,5,5,25
9/30/2014,12,0,10,6,28
10/1/2014,11,0,12,13,36
10/2/2014,12,0,15,4,31
10/3/2014,8,0,11,13,32
10/4/2014,8,0,5,16,29
10/5/2014,5,0,3,6,14
10/6/2014,15,0,5,4,24
10/7/2014,9,0,9,15,33
10/8/2014,12,0,6,8,26
10/9/2014,9,0,16,12,37
10/10/2014,12,0,14,1,27
10/11/2014,4,0,15,14,33
10/12/2014,8,0,4,14,26
10/13/2014,10,0,7,15,32
10/14/2014,14,0,12,15,41
10/15/2014,14,0,15,7,36
10/16/2014,11,0,3,15,29
10/17/2014,6,0,5,13,24
10/18/2014,4,0,12,12,28
10/19/2014,11,0,2,13,26
10/20/2014,12,0,14,3,29
10/21/2014,8,0,14,13,35
10/22/2014,10,0,11,2,23
10/23/2014,7,0,13,6,26
10/24/2014,4,0,4,3,11
10/25/2014,9,0,11,16,36
10/26/2014,12,0,8,6,26
10/27/2014,13,0,6,6,25
10/28/2014,13,0,6,13,32
10/29/2014,4,0,2,5,11
10/30/2014,12,0,12,9,33
10/31/2014,8,0,13,2,23
11/1/2014,11,0,6,12,29
11/2/2014,16,0,13,10,39
11/3/2014,15,0,9,14,38
11/4/2014,9,0,4,9,22
11/5/2014,8,0,11,12,31
11/6/2014,12,0,2,6,20
11/7/2014,6,0,3,6,15
11/8/2014,6,0,4,16,26
11/9/2014,7,0,15,8,30
11/10/2014,14,0,5,8,27
11/11/2014,12,0,6,4,22
11/12/2014,8,0,14,13,35
11/13/2014,16,0,7,11,34
11/14/2014,13,0,16,12,41
11/15/2014,15,0,2,14,31
11/16/2014,7,0,16,1,24
11/17/2014,14,0,16,1,31
11/18/2014,9,0,2,13,24
11/19/2014,10,0,15,1,26
11/20/2014,9,0,10,7,26
11/21/2014,14,0,5,5,24
11/22/2014,6,0,14,15,35
11/23/2014,12,0,2,13,27
11/24/2014,14,0,12,1,27
11/25/2014,12,0,4,8,24
11/26/2014,4,0,3,0,7
11/27/2014,4,0,14,12,30
11/28/2014,10,0,3,0,13
11/29/2014,11,0,16,6,33
11/30/2014,4,0,9,0,13
12/1/2014,11,0,12,1,24
12/2/2014,9,0,14,12,35
12/3/2014,10,0,10,8,28
12/4/2014,14,0,6,10,30
12/5/2014,13,0,2,11,26
12/6/2014,15,0,14,3,32
12/7/2014,13,0,3,10,26
12/8/2014,12,0,5,16,33
12/9/2014,7,0,5,1,13
12/10/2014,11,0,9,15,35
12/11/2014,5,0,13,13,31
12/12/2014,7,0,15,5,27
12/13/2014,9,0,15,2,26
12/14/2014,10,0,16,2,28
12/15/2014,7,0,11,0,18
12/16/2014,12,0,14,6,32
12/17/2014,16,0,16,5,37
12/18/2014,8,0,4,7,19
12/19/2014,4,0,15,4,23
12/20/2014,4,0,11,8,23
12/21/2014,11,0,5,5,21
12/22/2014,11,0,10,13,34
12/23/2014,5,0,14,5,24
12/24/2014,9,0,13,11,33
12/25/2014,9,0,12,0,21
12/26/2014,10,0,14,16,40
12/27/2014,7,0,7,4,18
12/28/2014,16,0,5,7,28
12/29/2014,14,0,3,10,27
12/30/2014,16,0,12,10,38
12/31/2014,16,0,9,15,40
1/1/2015,16,0,4,5,25
1/2/2015,9,0,15,12,36
1/3/2015,12,0,2,10,24
1/4/2015,6,0,6,13,25
1/5/2015,16,0,9,6,31
1/6/2015,14,0,11,8,33
1/7/2015,4,0,14,1,19
1/8/2015,15,0,5,15,35
1/9/2015,11,0,9,13,33
1/10/2015,9,0,8,7,24
1/11/2015,8,0,6,11,25
1/12/2015,7,0,6,14,27
1/13/2015,14,0,11,12,37
1/14/2015,15,0,7,7,29
1/15/2015,11,0,10,14,35
1/16/2015,4,0,4,8,16
1/17/2015,15,0,10,2,27
1/18/2015,11,0,9,9,29
1/19/2015,8,0,4,11,23
1/20/2015,13,0,7,3,23
1/21/2015,15,0,7,16,38
1/22/2015,12,0,16,9,37
1/23/2015,11,0,4,11,26
1/24/2015,9,0,12,8,29
1/25/2015,5,0,13,16,34
1/26/2015,5,0,13,0,18
1/27/2015,11,0,10,13,34
1/28/2015,12,0,9,7,28
1/29/2015,16,0,5,12,33
1/30/2015,4,0,7,11,22
1/31/2015,4,0,13,7,24
2/1/2015,6,0,8,8,22
2/2/2015,4,0,11,15,30
2/3/2015,16,0,10,3,29
2/4/2015,10,0,3,6,19
2/5/2015,7,0,15,15,37
2/6/2015,4,0,12,5,21
2/7/2015,8,0,16,8,32
2/8/2015,12,0,13,16,41
2/9/2015,7,0,16,3,26
2/10/2015,14,0,16,13,43
2/11/2015,12,0,15,0,27
2/12/2015,11,0,14,16,41
2/13/2015,15,0,9,4,28
2/14/2015,5,0,8,11,24
2/15/2015,12,0,13,12,37
2/16/2015,9,0,4,15,28
2/17/2015,4,0,12,14,30
2/18/2015,8,0,6,4,18
2/19/2015,13,0,5,1,19
2/20/2015,6,0,16,8,30
2/21/2015,4,0,14,15,33
2/22/2015,7,0,11,0,18
2/23/2015,6,0,3,2,11
2/24/2015,13,0,11,12,36
2/25/2015,6,0,10,13,29
2/26/2015,15,0,5,13,33
2/27/2015,9,0,5,10,24
2/28/2015,6,0,14,9,29
3/1/2015,15,0,10,15,40
3/2/2015,6,0,6,9,21
3/3/2015,6,0,6,1,13
3/4/2015,7,0,12,10,29
3/5/2015,5,0,12,7,24
3/6/2015,5,0,16,13,34
3/7/2015,4,0,14,13,31
3/8/2015,11,0,11,4,26
3/9/2015,14,0,6,11,31
3/10/2015,7,0,16,3,26
3/11/2015,8,0,12,13,33
3/12/2015,14,0,16,16,46
3/13/2015,16,0,3,2,21
3/14/2015,6,0,9,13,28
3/15/2015,15,0,15,14,44
3/16/2015,13,0,9,12,34
3/17/2015,8,0,11,10,29
3/18/2015,15,0,5,1,21
3/19/2015,15,0,11,3,29
3/20/2015,7,0,16,15,38
3/21/2015,12,0,9,16,37
3/22/2015,4,0,14,6,24
3/23/2015,5,0,2,5,12
3/24/2015,13,0,3,0,16
3/25/2015,9,0,12,9,30
3/26/2015,15,0,6,6,27
3/27/2015,14,0,11,5,30
3/28/2015,7,0,4,2,13
3/29/2015,7,0,6,9,22
3/30/2015,5,0,3,0,8
3/31/2015,7,0,8,3,18
4/1/2015,16,0,11,11,38
4/2/2015,14,0,4,8,26
4/3/2015,4,0,10,4,18
4/4/2015,12,0,12,2,26
4/5/2015,15,0,4,5,24
4/6/2015,4,0,8,2,14
4/7/2015,8,0,9,11,28
4/8/2015,5,0,12,7,24
4/9/2015,5,0,6,11,22
4/10/2015,9,0,6,12,27
4/11/2015,7,0,5,14,26
4/12/2015,12,0,4,2,18
4/13/2015,6,0,6,10,22
4/14/2015,7,0,9,9,25
4/15/2015,13,0,15,11,39
4/16/2015,14,0,10,9,33
4/17/2015,13,0,2,5,20
4/18/2015,10,0,6,2,18
4/19/2015,13,0,15,3,31
4/20/2015,5,0,9,5,19
4/21/2015,10,0,9,14,33
4/22/2015,12,0,11,15,38
4/23/2015,14,0,9,13,36
4/24/2015,11,0,3,9,23
4/25/2015,4,0,10,2,16
4/26/2015,9,0,12,0,21
4/27/2015,16,0,8,2,26
4/28/2015,13,0,10,8,31
4/29/2015,16,0,3,1,20
4/30/2015,6,0,13,0,19
5/1/2015,12,0,12,4,28
5/2/2015,15,0,7,10,32
5/3/2015,16,0,13,10,39
5/4/2015,14,0,10,11,35
5/5/2015,9,0,4,8,21
5/6/2015,5,0,9,2,16
5/7/2015,11,0,14,4,29
5/8/2015,6,0,16,6,28
5/9/2015,11,0,8,15,34
5/10/2015,8,0,14,8,30
5/11/2015,12,0,7,4,23
5/12/2015,9,0,9,13,31
5/13/2015,11,0,11,15,37
5/14/2015,4,0,14,16,34
5/15/2015,16,0,15,13,44
5/16/2015,14,0,5,1,20
5/17/2015,5,0,8,3,16
5/18/2015,12,0,7,0,19
5/19/2015,6,0,10,1,17
5/20/2015,10,0,13,14,37
5/21/2015,16,0,9,10,35
5/22/2015,4,0,4,5,13
5/23/2015,8,0,16,0,24
5/24/2015,6,0,5,4,15
5/25/2015,4,0,5,14,23
5/26/2015,7,0,5,6,18
5/27/2015,8,0,6,13,27
5/28/2015,15,0,13,13,41
5/29/2015,9,0,7,1,17
5/30/2015,15,0,2,5,22
5/31/2015,11,0,16,3,30
6/1/2015,5,0,16,4,25
6/2/2015,15,0,4,14,33
6/3/2015,4,0,7,2,13
6/4/2015,13,0,8,13,34
6/5/2015,15,0,8,4,27
6/6/2015,12,0,5,8,25
6/7/2015,5,0,5,9,19
6/8/2015,11,0,13,10,34
6/9/2015,16,0,11,14,41
6/10/2015,15,0,14,7,36
6/11/2015,9,0,12,11,32
6/12/2015,7,0,10,4,21
6/13/2015,15,0,5,3,23
6/14/2015,8,0,6,12,26
6/15/2015,15,0,10,5,30
6/16/2015,12,0,11,16,39
6/17/2015,8,0,9,15,32
6/18/2015,7,0,8,15,30
6/19/2015,8,0,15,4,27
6/20/2015,9,0,3,2,14
6/21/2015,5,0,11,15,31
6/22/2015,13,0,13,2,28
6/23/2015,5,0,14,14,33
6/24/2015,14,0,9,0,23
6/25/2015,14,0,7,14,35
6/26/2015,5,0,3,0,8
6/27/2015,13,0,15,9,37
6/28/2015,14,0,11,8,33
6/29/2015,7,0,9,6,22
6/30/2015,6,0,3,15,24
7/1/2015,7,0,10,15,32
7/2/2015,10,0,2,6,18
7/3/2015,11,0,4,0,15
7/4/2015,15,0,11,9,35
7/5/2015,13,0,8,0,21
7/6/2015,11,0,8,13,32
7/7/2015,7,0,15,10,32
7/8/2015,4,0,14,9,27
7/9/2015,8,0,5,12,25
7/10/2015,7,0,5,14,26
7/11/2015,13,0,14,7,34
7/12/2015,8,0,11,16,35
7/13/2015,13,0,8,9,30
7/14/2015,10,0,9,16,35
7/15/2015,9,0,13,7,29
7/16/2015,16,0,6,7,29
7/17/2015,15,0,3,14,32
7/18/2015,9,0,3,8,20
7/19/2015,9,0,14,10,33
7/20/2015,14,0,10,7,31
7/21/2015,12,0,8,6,26
7/22/2015,6,0,14,4,24
7/23/2015,11,0,2,14,27
7/24/2015,11,0,2,1,14
7/25/2015,11,0,8,1,20
7/26/2015,9,0,2,9,20
7/27/2015,5,0,3,10,18
7/28/2015,12,0,4,5,21
7/29/2015,5,0,13,1,19
7/30/2015,10,0,11,2,23
7/31/2015,11,0,10,12,33
8/1/2015,8,0,6,1,15
8/2/2015,15,0,2,9,26
8/3/2015,13,0,15,2,30
8/4/2015,15,0,2,5,22
8/5/2015,6,0,12,2,20
8/6/2015,4,0,4,5,13
8/7/2015,6,0,13,0,19
8/8/2015,8,0,9,14,31
8/9/2015,5,0,7,2,14
8/10/2015,6,0,16,1,23
8/11/2015,6,0,8,16,30
8/12/2015,4,0,14,12,30
8/13/2015,16,0,3,4,23
8/14/2015,11,0,9,11,31
8/15/2015,11,0,15,4,30
8/16/2015,9,0,9,4,22
8/17/2015,16,0,3,8,27
8/18/2015,13,0,5,11,29
8/19/2015,9,0,9,4,22
8/20/2015,7,0,15,0,22
8/21/2015,14,0,14,15,43
8/22/2015,5,0,15,7,27
8/23/2015,10,0,5,14,29
8/24/2015,12,0,4,9,25
8/25/2015,12,0,4,15,31
8/26/2015,7,0,7,3,17
8/27/2015,8,0,4,2,14
8/28/2015,7,0,13,9,29
8/29/2015,8,0,10,11,29
8/30/2015,4,0,4,6,14
8/31/2015,5,0,2,2,9
9/1/2015,4,0,13,14,31
9/2/2015,4,0,13,10,27
9/3/2015,7,0,14,13,34
9/4/2015,4,0,10,11,25
9/5/2015,4,0,2,5,11
9/6/2015,9,0,7,11,27
9/7/2015,5,0,15,0,20
9/8/2015,11,0,7,10,28
9/9/2015,7,0,11,5,23
9/10/2015,15,0,14,0,29
9/11/2015,8,0,2,11,21
9/12/2015,4,0,9,15,28
9/13/2015,13,0,5,10,28
9/14/2015,13,0,6,14,33
9/15/2015,11,0,5,8,24
9/16/2015,5,0,13,5,23
9/17/2015,6,0,11,7,24
9/18/2015,8,0,8,7,23
9/19/2015,11,0,16,1,28
9/20/2015,12,0,3,0,15
9/21/2015,7,0,6,6,19
9/22/2015,8,0,16,2,26
9/23/2015,4,0,7,12,23
9/24/2015,9,0,13,6,28
9/25/2015,9,0,14,5,28
9/26/2015,15,0,16,2,33
9/27/2015,5,0,5,11,21
9/28/2015,11,0,10,10,31
9/29/2015,4,0,15,5,24
9/30/2015,5,0,10,12,27
10/1/2015,10,0,15,8,33
10/2/2015,5,0,10,1,16
10/3/2015,10,0,12,16,38
10/4/2015,12,0,2,14,28
10/5/2015,13,0,6,14,33
10/6/2015,8,0,15,10,33
10/7/2015,4,0,12,4,20
10/8/2015,7,0,8,6,21
10/9/2015,8,0,11,10,29
10/10/2015,15,0,13,5,33
10/11/2015,8,0,6,10,24
10/12/2015,9,0,9,8,26
10/13/2015,8,0,5,8,21
10/14/2015,9,0,13,2,24
10/15/2015,15,0,2,16,33
10/16/2015,16,0,9,4,29
10/17/2015,8,0,10,13,31
10/18/2015,4,0,8,13,25
10/19/2015,11,0,9,15,35
10/20/2015,8,0,11,4,23
10/21/2015,8,0,11,9,28
10/22/2015,11,0,12,8,31
10/23/2015,15,0,12,9,36
10/24/2015,15,0,8,8,31
10/25/2015,10,0,4,1,15
10/26/2015,10,0,15,0,25
10/27/2015,4,0,2,3,9
10/28/2015,6,0,12,11,29
10/29/2015,11,0,3,4,18
10/30/2015,12,0,11,14,37
10/31/2015,6,0,4,6,16
11/1/2015,16,0,15,10,41
11/2/2015,15,0,11,9,35
11/3/2015,9,0,6,1,16
11/4/2015,11,0,2,16,29
11/5/2015,10,0,3,4,17
11/6/2015,7,0,11,12,30
11/7/2015,8,0,10,5,23
11/8/2015,10,0,14,3,27
11/9/2015,12,0,5,14,31
11/10/2015,9,0,4,7,20
11/11/2015,7,0,2,11,20
11/12/2015,4,0,4,13,21
11/13/2015,11,0,10,2,23
11/14/2015,6,0,7,12,25
11/15/2015,12,0,4,15,31
11/16/2015,12,0,4,11,27
11/17/2015,13,0,4,3,20
11/18/2015,15,0,9,14,38
11/19/2015,11,0,3,9,23
11/20/2015,10,0,14,3,27
11/21/2015,5,0,7,8,20
11/22/2015,11,0,3,4,18
11/23/2015,14,0,2,9,25
11/24/2015,8,0,16,11,35
11/25/2015,6,0,10,7,23
11/26/2015,8,0,6,3,17
11/27/2015,12,0,16,0,28
11/28/2015,11,0,9,10,30
11/29/2015,13,0,2,2,17
11/30/2015,11,0,13,8,32
12/1/2015,9,0,4,6,19
12/2/2015,13,0,9,12,34
12/3/2015,13,0,15,16,44
12/4/2015,7,0,3,8,18
12/5/2015,6,0,10,6,22
12/6/2015,10,0,16,1,27
12/7/2015,10,0,5,7,22
12/8/2015,4,0,4,10,18
12/9/2015,15,0,3,11,29
12/10/2015,6,0,15,2,23
12/11/2015,11,0,2,14,27
12/12/2015,5,0,4,1,10
12/13/2015,16,0,10,9,35
12/14/2015,9,0,15,13,37
12/15/2015,15,0,14,2,31
12/16/2015,4,0,3,3,10
12/17/2015,11,0,16,13,40
12/18/2015,16,0,16,12,44
12/19/2015,6,0,3,6,15
12/20/2015,15,0,2,12,29
12/21/2015,5,0,6,3,14
12/22/2015,8,0,3,8,19
12/23/2015,4,0,15,10,29
12/24/2015,6,0,14,0,20
12/25/2015,5,0,4,8,17
12/26/2015,15,0,2,13,30
12/27/2015,4,0,12,11,27
12/28/2015,7,0,10,10,27
12/29/2015,8,0,11,0,19
12/30/2015,14,0,10,16,40
12/31/2015,9,0,5,8,22
1/1/2016,11,0,8,9,28
1/2/2016,7,0,2,16,25
1/3/2016,16,0,10,11,37
1/4/2016,9,0,10,2,21
1/5/2016,15,0,9,2,26
1/6/2016,4,0,10,11,25
1/7/2016,16,0,8,11,35
1/8/2016,9,0,3,2,14
1/9/2016,7,0,3,6,16
1/10/2016,13,0,7,6,26
1/11/2016,16,0,9,14,39
1/12/2016,11,0,11,7,29
1/13/2016,4,0,4,11,19
1/14/2016,10,0,10,14,34
1/15/2016,9,0,9,12,30
1/16/2016,14,0,5,3,22
1/17/2016,13,0,5,10,28
1/18/2016,6,0,3,13,22
1/19/2016,7,0,13,8,28
1/20/2016,16,0,2,13,31
1/21/2016,6,0,3,10,19
1/22/2016,16,0,15,5,36
1/23/2016,12,0,10,2,24
1/24/2016,7,0,14,0,21
1/25/2016,4,0,10,10,24
1/26/2016,11,0,5,8,24
1/27/2016,13,0,10,4,27
1/28/2016,16,0,12,13,41
1/29/2016,5,0,2,8,15
1/30/2016,6,0,7,16,29
1/31/2016,16,0,16,6,38
2/1/2016,12,0,9,7,28
2/2/2016,11,0,3,15,29
2/3/2016,11,0,8,13,32
2/4/2016,6,0,9,2,17
2/5/2016,16,0,2,7,25
2/6/2016,11,0,2,1,14
2/7/2016,15,0,11,13,39
2/8/2016,4,0,6,8,18
2/9/2016,5,0,5,5,15
2/10/2016,7,0,12,11,30
2/11/2016,11,0,12,0,23
2/12/2016,4,0,3,8,15
2/13/2016,12,0,15,12,39
2/14/2016,11,0,2,5,18
2/15/2016,15,0,4,15,34
2/16/2016,13,0,9,15,37
2/17/2016,8,0,16,8,32
2/18/2016,11,0,7,12,30
2/19/2016,13,0,15,6,34
2/20/2016,4,0,15,15,34
2/21/2016,11,0,8,16,35
2/22/2016,11,0,11,12,34
2/23/2016,11,0,7,1,19
2/24/2016,4,0,4,8,16
2/25/2016,16,0,4,15,35
2/26/2016,12,0,3,6,21
2/27/2016,12,0,3,13,28
2/28/2016,10,0,10,0,20
2/29/2016,9,0,15,5,29
3/1/2016,12,0,7,16,35
3/2/2016,13,0,9,10,32
3/3/2016,13,0,7,8,28
3/4/2016,11,0,5,7,23
3/5/2016,13,0,10,6,29
3/6/2016,16,0,5,0,21
3/7/2016,10,0,6,0,16
3/8/2016,5,0,14,10,29
3/9/2016,16,0,7,13,36
3/10/2016,5,0,9,2,16
3/11/2016,8,0,15,15,38
3/12/2016,8,0,10,12,30
3/13/2016,13,0,12,7,32
3/14/2016,8,0,9,10,27
3/15/2016,13,0,2,9,24
3/16/2016,5,0,16,1,22
3/17/2016,7,0,14,12,33
3/18/2016,14,0,9,6,29
3/19/2016,10,0,6,0,16
3/20/2016,16,0,12,6,34
3/21/2016,12,0,8,10,30
3/22/2016,15,0,9,11,35
3/23/2016,5,0,5,1,11
3/24/2016,8,0,9,7,24
3/25/2016,10,0,3,9,22
3/26/2016,8,0,13,5,26
3/27/2016,6,0,8,14,28
3/28/2016,9,0,12,1,22
3/29/2016,9,0,8,14,31
3/30/2016,4,0,6,16,26
3/31/2016,7,0,10,10,27
4/1/2016,6,0,9,5,20
4/2/2016,8,0,3,3,14
4/3/2016,8,0,11,13,32
4/4/2016,11,0,4,3,18
4/5/2016,15,0,7,1,23
4/6/2016,6,0,2,15,23
4/7/2016,7,0,9,11,27
4/8/2016,13,0,8,2,23
4/9/2016,9,0,13,16,38
4/10/2016,10,0,16,0,26
4/11/2016,13,0,7,3,23
4/12/2016,11,0,10,15,36
4/13/2016,11,0,10,16,37
4/14/2016,8,0,12,2,22
4/15/2016,4,0,8,9,21
4/16/2016,4,0,6,13,23
4/17/2016,5,0,14,10,29
4/18/2016,11,0,15,0,26
4/19/2016,10,0,4,9,23
4/20/2016,11,0,16,9,36
4/21/2016,9,0,2,10,21
4/22/2016,4,0,11,11,26
4/23/2016,14,0,5,2,21
4/24/2016,12,0,4,0,16
4/25/2016,16,0,14,5,35
4/26/2016,6,0,8,2,16
4/27/2016,16,0,6,13,35
4/28/2016,10,0,7,2,19
4/29/2016,8,0,15,0,23
4/30/2016,12,0,8,7,27
5/1/2016,15,0,14,2,31
5/2/2016,9,0,4,10,23
5/3/2016,9,0,3,2,14
5/4/2016,11,0,4,13,28
5/5/2016,13,0,7,16,36
5/6/2016,8,0,5,14,27
5/7/2016,15,0,3,15,33
5/8/2016,8,0,2,4,14
5/9/2016,10,0,2,5,17
5/10/2016,14,0,2,4,20
5/11/2016,12,0,16,9,37
5/12/2016,9,0,10,8,27
5/13/2016,10,0,9,8,27
5/14/2016,5,0,10,16,31
5/15/2016,6,0,6,10,22
5/16/2016,4,0,3,8,15
5/17/2016,12,0,7,1,20
5/18/2016,8,0,10,1,19
5/19/2016,6,0,11,1,18
5/20/2016,4,0,4,15,23
5/21/2016,6,0,4,8,18
5/22/2016,12,0,8,13,33
5/23/2016,7,0,6,1,14
5/24/2016,13,0,11,10,34
5/25/2016,10,0,3,0,13
5/26/2016,8,0,3,12,23
5/27/2016,9,0,4,7,20
5/28/2016,4,0,15,4,23
5/29/2016,14,0,14,9,37
5/30/2016,4,0,13,15,32
5/31/2016,11,0,2,7,20
6/1/2016,12,0,2,8,22
6/2/2016,16,0,12,8,36
6/3/2016,7,0,10,0,17
6/4/2016,6,0,2,10,18
6/5/2016,13,0,9,1,23
6/6/2016,11,0,4,7,22
6/7/2016,9,0,16,14,39
6/8/2016,7,0,15,1,23
6/9/2016,7,0,14,8,29
6/10/2016,16,0,8,4,28
6/11/2016,9,0,5,15,29
6/12/2016,4,0,9,4,17
6/13/2016,16,0,5,8,29
6/14/2016,16,0,12,4,32
6/15/2016,9,0,3,11,23
6/16/2016,4,0,4,3,11
6/17/2016,10,0,15,5,30
6/18/2016,9,0,10,6,25
6/19/2016,11,0,14,10,35
6/20/2016,4,0,2,7,13
6/21/2016,12,0,9,11,32
6/22/2016,14,0,10,3,27
6/23/2016,12,0,12,9,33
6/24/2016,8,0,11,16,35
6/25/2016,6,0,15,1,22
6/26/2016,14,0,7,11,32
6/27/2016,14,0,15,5,34
6/28/2016,15,0,9,16,40
6/29/2016,11,0,4,4,19
6/30/2016,16,0,8,0,24
7/1/2016,11,0,11,7,29
7/2/2016,11,0,4,3,18
7/3/2016,13,0,8,6,27
7/4/2016,14,0,2,1,17
7/5/2016,9,0,11,7,27
7/6/2016,14,0,7,7,28
7/7/2016,14,0,14,2,30
7/8/2016,8,0,8,1,17
7/9/2016,4,0,3,6,13
7/10/2016,13,0,9,3,25
7/11/2016,14,0,5,5,24
7/12/2016,16,0,15,5,36
7/13/2016,4,0,15,14,33
7/14/2016,4,0,8,4,16
7/15/2016,15,0,12,7,34
7/16/2016,7,0,8,8,23
7/17/2016,10,0,5,6,21
7/18/2016,11,0,3,6,20
7/19/2016,7,0,10,8,25
7/20/2016,15,0,8,10,33
7/21/2016,15,0,16,10,41
7/22/2016,4,0,16,9,29
7/23/2016,8,0,9,1,18
7/24/2016,11,0,3,7,21
7/25/2016,16,0,2,12,30
7/26/2016,4,0,16,11,31
7/27/2016,15,0,11,9,35
7/28/2016,16,0,16,7,39
7/29/2016,5,0,3,0,8
7/30/2016,14,0,12,14,40
7/31/2016,14,0,12,12,38
8/1/2016,15,0,14,11,40
8/2/2016,11,0,12,11,34
8/3/2016,8,0,13,8,29
8/4/2016,6,0,10,10,26
8/5/2016,12,0,7,0,19
8/6/2016,13,0,16,3,32
8/7/2016,4,0,2,15,21
8/8/2016,15,0,13,7,35
8/9/2016,14,0,9,1,24
8/10/2016,5,0,15,3,23
8/11/2016,5,0,3,12,20
8/12/2016,10,0,7,0,17
8/13/2016,7,0,11,6,24
8/14/2016,8,0,7,6,21
8/15/2016,13,0,13,2,28
8/16/2016,5,0,11,16,32
8/17/2016,4,0,7,16,27
8/18/2016,4,0,6,9,19
8/19/2016,11,0,16,4,31
8/20/2016,8,0,3,5,16
8/21/2016,10,0,16,0,26
8/22/2016,16,0,14,4,34
8/23/2016,12,0,11,16,39
8/24/2016,14,0,11,9,34
8/25/2016,10,0,15,11,36
8/26/2016,13,0,7,8,28
8/27/2016,14,0,9,16,39
8/28/2016,10,0,15,8,33
8/29/2016,16,0,6,11,33
8/30/2016,15,0,3,1,19
8/31/2016,15,0,7,8,30
9/1/2016,14,0,14,4,32
9/2/2016,7,0,7,0,14
9/3/2016,8,0,15,6,29
9/4/2016,14,0,7,16,37
9/5/2016,11,0,5,3,19
9/6/2016,8,0,3,11,22
9/7/2016,16,0,8,11,35
9/8/2016,5,0,6,9,20
9/9/2016,5,0,6,9,20
9/10/2016,7,0,10,12,29
9/11/2016,9,0,7,2,18
9/12/2016,14,0,6,1,21
9/13/2016,13,0,13,0,26
9/14/2016,16,0,5,14,35
9/15/2016,4,0,7,4,15
9/16/2016,8,0,9,0,17
9/17/2016,14,0,16,10,40
9/18/2016,11,0,12,9,32
9/19/2016,5,0,2,8,15
9/20/2016,13,0,2,10,25
9/21/2016,11,0,3,0,14
9/22/2016,4,0,4,14,22
9/23/2016,16,0,9,8,33
9/24/2016,11,0,14,4,29
9/25/2016,16,0,5,2,23
9/26/2016,7,0,7,10,24
9/27/2016,12,0,12,1,25
9/28/2016,9,0,16,0,25
9/29/2016,14,0,15,8,37
9/30/2016,13,0,4,14,31
10/1/2016,12,0,13,13,38
10/2/2016,7,0,8,5,20
10/3/2016,10,0,3,15,28
10/4/2016,13,0,8,10,31
10/5/2016,12,0,6,1,19
10/6/2016,16,0,8,11,35
10/7/2016,4,0,15,7,26
10/8/2016,6,0,4,9,19
10/9/2016,7,0,6,9,22
10/10/2016,6,0,16,11,33
10/11/2016,11,0,10,9,30
10/12/2016,8,0,3,11,22
10/13/2016,11,0,3,9,23
10/14/2016,15,0,2,6,23
10/15/2016,7,0,12,11,30
10/16/2016,8,0,13,10,31
10/17/2016,14,0,16,12,42
10/18/2016,6,0,11,9,26
10/19/2016,10,0,7,5,22
10/20/2016,10,0,8,9,27
10/21/2016,16,0,4,8,28
10/22/2016,15,0,13,10,38
10/23/2016,15,0,12,7,34
10/24/2016,9,0,6,3,18
10/25/2016,7,0,15,5,27
10/26/2016,10,0,10,13,33
10/27/2016,11,0,14,9,34
10/28/2016,10,0,14,10,34
10/29/2016,13,0,2,0,15
10/30/2016,14,0,9,4,27
10/31/2016,10,0,14,11,35
11/1/2016,4,0,4,4,12
11/2/2016,11,0,12,4,27
11/3/2016,4,0,13,2,19
11/4/2016,7,0,9,7,23
11/5/2016,13,0,4,15,32
11/6/2016,11,0,14,14,39
11/7/2016,16,0,6,5,27
11/8/2016,8,0,12,2,22
11/9/2016,10,0,13,13,36
11/10/2016,8,0,16,10,34
11/11/2016,7,0,8,13,28
11/12/2016,6,0,12,6,24
11/13/2016,5,0,14,3,22
11/14/2016,15,0,13,15,43
11/15/2016,8,0,7,11,26
11/16/2016,12,0,8,2,22
11/17/2016,6,0,11,10,27
11/18/2016,15,0,16,6,37
11/19/2016,12,0,14,16,42
11/20/2016,7,0,15,0,22
11/21/2016,13,0,5,0,18
11/22/2016,16,0,7,3,26
11/23/2016,10,0,2,13,25
11/24/2016,7,0,9,1,17
11/25/2016,8,0,12,7,27
11/26/2016,4,0,4,15,23
11/27/2016,10,0,2,10,22
11/28/2016,9,0,12,14,35
11/29/2016,13,0,14,3,30
11/30/2016,13,0,2,14,29
12/1/2016,6,0,11,7,24
12/2/2016,9,0,13,6,28
12/3/2016,6,0,6,15,27
12/4/2016,11,0,13,11,35
12/5/2016,11,0,3,15,29
12/6/2016,4,0,14,0,18
12/7/2016,4,0,9,0,13
12/8/2016,15,0,6,14,35
12/9/2016,8,0,9,2,19
12/10/2016,14,0,5,16,35
12/11/2016,5,0,12,9,26
12/12/2016,10,0,5,1,16
12/13/2016,10,0,15,9,34
12/14/2016,7,0,14,1,22
12/15/2016,12,0,15,0,27
12/16/2016,14,0,13,12,39
12/17/2016,4,0,7,1,12
12/18/2016,13,0,6,7,26
12/19/2016,15,0,9,11,35
12/20/2016,9,0,11,9,29
12/21/2016,9,0,8,2,19
12/22/2016,13,0,12,9,34
12/23/2016,11,0,8,10,29
12/24/2016,16,0,12,2,30
12/25/2016,10,0,3,10,23
12/26/2016,6,0,4,14,24
12/27/2016,5,0,16,15,36
12/28/2016,7,0,4,2,13
12/29/2016,13,0,12,7,32
12/30/2016,8,0,6,13,27
12/31/2016,11,0,7,1,19
1/1/2017,6,0,12,5,23
1/2/2017,6,0,7,14,27
1/3/2017,6,0,12,13,31
1/4/2017,9,0,13,4,26
1/5/2017,7,0,13,7,27
1/6/2017,10,0,8,14,32
1/7/2017,16,0,10,9,35
1/8/2017,6,0,9,3,18
1/9/2017,14,0,12,15,41
1/10/2017,6,0,14,11,31
1/11/2017,12,0,3,11,26
1/12/2017,12,0,12,15,39
1/13/2017,12,0,11,10,33
1/14/2017,8,0,2,1,11
1/15/2017,12,0,9,5,26
1/16/2017,5,0,3,15,23
1/17/2017,4,0,14,10,28
1/18/2017,8,0,13,14,35
1/19/2017,13,0,14,1,28
1/20/2017,9,0,5,8,22
1/21/2017,7,0,7,9,23
1/22/2017,5,0,13,10,28
1/23/2017,8,0,15,7,30
1/24/2017,8,0,10,4,22
1/25/2017,10,0,9,5,24
1/26/2017,15,0,13,8,36
1/27/2017,11,0,12,8,31
1/28/2017,13,0,6,11,30
1/29/2017,11,0,4,12,27
1/30/2017,12,0,9,1,22
1/31/2017,10,0,5,13,28
2/1/2017,6,0,13,12,31
2/2/2017,6,0,10,6,22
2/3/2017,11,0,16,13,40
2/4/2017,13,0,8,9,30
2/5/2017,5,0,15,12,32
2/6/2017,16,0,12,1,29
2/7/2017,14,0,12,12,38
2/8/2017,16,0,8,13,37
2/9/2017,16,0,16,13,45
2/10/2017,7,0,11,14,32
2/11/2017,12,0,5,15,32
2/12/2017,13,0,10,12,35
2/13/2017,12,0,6,1,19
2/14/2017,8,0,9,1,18
2/15/2017,7,0,7,4,18
2/16/2017,14,0,4,6,24
2/17/2017,5,0,7,10,22
2/18/2017,10,0,3,9,22
2/19/2017,13,0,8,8,29
2/20/2017,7,0,9,3,19
2/21/2017,11,0,4,7,22
2/22/2017,8,0,11,0,19
2/23/2017,7,0,15,12,34
2/24/2017,16,0,12,2,30
2/25/2017,16,0,8,8,32
2/26/2017,7,0,9,12,28
2/27/2017,5,0,5,14,24
2/28/2017,13,0,7,13,33
3/1/2017,14,0,12,5,31
3/2/2017,11,0,8,5,24
3/3/2017,11,0,15,12,38
3/4/2017,6,0,14,13,33
3/5/2017,11,0,16,11,38
3/6/2017,11,0,7,3,21
3/7/2017,5,0,6,13,24
3/8/2017,16,0,3,10,29
3/9/2017,6,0,11,11,28
3/10/2017,14,0,6,16,36
3/11/2017,7,0,14,3,24
3/12/2017,5,0,16,3,24
3/13/2017,6,0,12,14,32
3/14/2017,9,0,4,10,23
3/15/2017,11,0,9,0,20
3/16/2017,6,0,16,4,26
3/17/2017,10,0,16,0,26
3/18/2017,8,0,14,7,29
3/19/2017,10,0,3,7,20
3/20/2017,10,0,7,11,28
3/21/2017,6,0,15,12,33
3/22/2017,5,0,16,6,27
3/23/2017,9,0,11,10,30
3/24/2017,13,0,10,2,25
3/25/2017,4,0,4,1,9
3/26/2017,15,0,10,1,26
3/27/2017,7,0,8,4,19
3/28/2017,16,0,15,2,33
3/29/2017,16,0,14,3,33
3/30/2017,6,0,3,3,12
3/31/2017,5,0,11,1,17
4/1/2017,8,0,13,16,37
4/2/2017,15,0,5,16,36
4/3/2017,7,0,7,4,18
4/4/2017,15,0,12,13,40
4/5/2017,14,0,13,2,29
4/6/2017,7,0,11,5,23
4/7/2017,8,0,14,2,24
4/8/2017,15,0,8,10,33
4/9/2017,6,0,14,1,21
4/10/2017,7,0,15,9,31
4/11/2017,12,0,11,15,38
4/12/2017,8,0,13,14,35
4/13/2017,14,0,15,14,43
4/14/2017,6,0,14,6,26
4/15/2017,14,0,8,11,33
4/16/2017,12,0,2,9,23
4/17/2017,14,0,14,1,29
4/18/2017,4,0,8,11,23
4/19/2017,14,0,6,9,29
4/20/2017,11,0,10,1,22
4/21/2017,6,0,6,16,28
4/22/2017,14,0,12,16,42
4/23/2017,13,0,15,16,44
4/24/2017,6,0,3,13,22
4/25/2017,5,0,3,8,16
4/26/2017,8,0,5,10,23
4/27/2017,12,0,11,1,24
4/28/2017,6,0,4,1,11
4/29/2017,13,0,14,1,28
4/30/2017,15,0,3,5,23
5/1/2017,11,0,15,9,35
5/2/2017,11,0,3,11,25
5/3/2017,15,0,16,1,32
5/4/2017,7,0,11,15,33
5/5/2017,13,0,2,9,24
5/6/2017,14,0,4,12,30
5/7/2017,12,0,8,11,31
5/8/2017,12,0,5,5,22
5/9/2017,6,0,13,7,26
5/10/2017,16,0,6,1,23
5/11/2017,13,0,13,8,34
5/12/2017,14,0,11,11,36
5/13/2017,16,0,12,6,34
5/14/2017,13,0,4,8,25
5/15/2017,16,0,11,14,41
5/16/2017,6,0,16,7,29
5/17/2017,6,0,12,2,20
5/18/2017,14,0,9,9,32
5/19/2017,6,0,13,12,31
5/20/2017,4,0,12,1,17
5/21/2017,16,0,7,15,38
5/22/2017,7,0,10,5,22
5/23/2017,4,0,6,6,16
5/24/2017,12,0,15,4,31
5/25/2017,9,0,15,2,26
5/26/2017,15,0,7,13,35
5/27/2017,16,0,11,6,33
5/28/2017,10,0,6,3,19
5/29/2017,11,0,15,6,32
5/30/2017,5,0,16,14,35
5/31/2017,15,0,4,9,28
6/1/2017,16,0,4,9,29
6/2/2017,4,0,11,5,20
6/3/2017,5,0,2,6,13
6/4/2017,15,0,9,7,31
6/5/2017,9,0,4,6,19
6/6/2017,5,0,10,11,26
6/7/2017,4,0,7,10,21
6/8/2017,8,0,5,1,14
6/9/2017,10,0,5,5,20
6/10/2017,15,0,2,4,21
6/11/2017,4,0,16,13,33
6/12/2017,8,0,16,6,30
6/13/2017,9,0,4,15,28
6/14/2017,14,0,9,5,28
6/15/2017,12,0,12,16,40
6/16/2017,10,0,11,2,23
6/17/2017,10,0,7,6,23
6/18/2017,4,0,9,10,23
6/19/2017,6,0,5,6,17
6/20/2017,12,0,7,13,32
6/21/2017,13,0,7,14,34
6/22/2017,7,0,15,15,37
6/23/2017,11,0,4,15,30
6/24/2017,12,0,4,16,32
6/25/2017,16,0,8,14,38
6/26/2017,12,0,6,7,25
6/27/2017,7,0,16,0,23
6/28/2017,9,0,5,4,18
6/29/2017,12,0,14,15,41
6/30/2017,14,0,16,0,30
7/1/2017,8,0,16,2,26
7/2/2017,6,0,7,2,15
7/3/2017,9,0,13,10,32
7/4/2017,13,0,9,0,22
7/5/2017,16,0,6,13,35
7/6/2017,11,0,5,1,17
7/7/2017,6,0,7,12,25
7/8/2017,5,0,8,12,25
7/9/2017,14,0,5,6,25
7/10/2017,11,0,10,15,36
7/11/2017,16,0,7,9,32
7/12/2017,13,0,14,2,29
7/13/2017,15,0,2,4,21
7/14/2017,7,0,5,12,24
7/15/2017,4,0,14,10,28
7/16/2017,11,0,7,10,28
7/17/2017,11,0,16,12,39
7/18/2017,16,0,9,14,39
7/19/2017,12,0,5,0,17
7/20/2017,7,0,13,9,29
7/21/2017,4,0,9,9,22
7/22/2017,11,0,2,8,21
7/23/2017,14,0,11,16,41
7/24/2017,7,0,14,5,26
7/25/2017,9,0,16,1,26
7/26/2017,14,0,13,13,40
7/27/2017,8,0,12,11,31
7/28/2017,14,0,7,16,37
7/29/2017,13,0,3,6,22
7/30/2017,12,0,16,11,39
7/31/2017,11,0,16,0,27
8/1/2017,11,0,15,9,35
8/2/2017,13,0,3,10,26
8/3/2017,12,0,14,13,39
8/4/2017,7,0,10,0,17
8/5/2017,10,0,3,8,21
8/6/2017,12,0,2,1,15
8/7/2017,9,0,13,14,36
8/8/2017,12,0,4,7,23
8/9/2017,4,0,3,16,23
8/10/2017,13,0,16,16,45
8/11/2017,5,0,6,5,16
8/12/2017,16,0,14,10,40
8/13/2017,16,0,11,10,37
8/14/2017,7,0,3,7,17
8/15/2017,10,0,5,13,28
8/16/2017,14,0,4,6,24
8/17/2017,8,0,3,3,14
8/18/2017,15,0,12,5,32
8/19/2017,8,0,9,5,22
8/20/2017,11,0,15,4,30
8/21/2017,7,0,2,13,22
8/22/2017,15,0,13,12,40
8/23/2017,14,0,13,5,32
8/24/2017,15,0,15,0,30
8/25/2017,14,0,15,8,37
8/26/2017,6,0,16,8,30
8/27/2017,10,0,7,6,23
8/28/2017,15,0,6,10,31
8/29/2017,10,0,15,3,28
8/30/2017,9,0,4,13,26
8/31/2017,9,0,12,5,26
9/1/2017,10,0,6,13,29
9/2/2017,13,0,10,16,39
9/3/2017,16,0,2,11,29
9/4/2017,10,0,8,7,25
9/5/2017,15,0,5,9,29
9/6/2017,14,0,6,10,30
9/7/2017,14,0,3,8,25
9/8/2017,12,0,10,15,37
9/9/2017,15,0,12,6,33
9/10/2017,11,0,5,9,25
9/11/2017,7,0,8,2,17
9/12/2017,8,0,13,9,30
9/13/2017,8,0,5,13,26
9/14/2017,5,0,5,14,24
9/15/2017,14,0,15,11,40
9/16/2017,5,0,15,10,30
9/17/2017,11,0,3,14,28
9/18/2017,10,0,5,10,25
9/19/2017,8,0,6,3,17
9/20/2017,16,0,15,2,33
9/21/2017,10,0,2,10,22
9/22/2017,5,0,3,15,23
9/23/2017,7,0,15,8,30
9/24/2017,11,0,8,7,26
9/25/2017,9,0,3,1,13
9/26/2017,10,0,13,14,37
9/27/2017,5,0,14,12,31
9/28/2017,14,0,15,3,32
9/29/2017,9,0,5,15,29
9/30/2017,13,0,5,13,31
10/1/2017,13,0,15,3,31
10/2/2017,7,0,3,0,10
10/3/2017,14,0,13,16,43
10/4/2017,6,0,2,5,13
10/5/2017,15,0,5,2,22
10/6/2017,14,0,6,2,22
10/7/2017,16,0,16,1,33
10/8/2017,14,0,4,4,22
10/9/2017,11,0,11,13,35
10/10/2017,5,0,12,12,29
10/11/2017,4,0,15,16,35
10/12/2017,16,0,2,15,33
10/13/2017,5,0,3,16,24
10/14/2017,13,0,14,11,38
10/15/2017,12,0,8,1,21
10/16/2017,6,0,7,3,16
10/17/2017,5,0,14,8,27
10/18/2017,5,0,12,10,27
10/19/2017,15,0,4,4,23
10/20/2017,4,0,15,11,30
10/21/2017,6,0,7,3,16
10/22/2017,10,0,4,1,15
10/23/2017,12,0,15,11,38
10/24/2017,7,0,12,15,34
10/25/2017,15,0,14,6,35
10/26/2017,4,0,15,15,34
10/27/2017,6,0,12,3,21
10/28/2017,14,0,4,11,29
10/29/2017,6,0,4,12,22
10/30/2017,10,0,4,9,23
10/31/2017,11,0,12,6,29
11/1/2017,14,0,10,2,26
11/2/2017,10,0,10,2,22
11/3/2017,9,0,7,5,21
11/4/2017,11,0,15,2,28
11/5/2017,13,0,12,4,29
11/6/2017,7,0,6,9,22
11/7/2017,16,0,6,13,35
11/8/2017,7,0,8,7,22
11/9/2017,15,0,5,16,36
11/10/2017,13,0,11,6,30
11/11/2017,7,0,14,8,29
11/12/2017,9,0,8,9,26
11/13/2017,7,0,8,9,24
11/14/2017,15,0,9,3,27
11/15/2017,7,0,2,9,18
11/16/2017,6,0,12,2,20
11/17/2017,5,0,14,4,23
11/18/2017,9,0,5,5,19
11/19/2017,10,0,13,10,33
11/20/2017,13,0,2,2,17
11/21/2017,6,0,15,9,30
11/22/2017,9,0,5,4,18
11/23/2017,8,0,9,1,18
11/24/2017,5,0,5,6,16
11/25/2017,11,0,4,2,17
11/26/2017,5,0,6,16,27
11/27/2017,9,0,2,11,22
11/28/2017,10,0,14,9,33
11/29/2017,11,0,16,3,30
11/30/2017,10,0,8,5,23
12/1/2017,10,0,2,5,17
12/2/2017,13,0,12,9,34
12/3/2017,8,0,6,10,24
12/4/2017,14,0,14,11,39
12/5/2017,5,0,7,6,18
12/6/2017,6,0,2,3,11
12/7/2017,9,0,16,5,30
12/8/2017,9,0,7,1,17
12/9/2017,9,0,6,12,27
12/10/2017,14,0,12,3,29
12/11/2017,12,0,14,7,33
12/12/2017,14,0,4,10,28
12/13/2017,12,0,15,2,29
12/14/2017,8,0,15,10,33
12/15/2017,8,0,11,13,32
12/16/2017,15,0,3,13,31
12/17/2017,8,0,9,2,19
12/18/2017,6,0,14,3,23
12/19/2017,9,0,4,2,15
12/20/2017,14,0,13,14,41
12/21/2017,16,0,5,5,26
12/22/2017,8,0,3,6,17
12/23/2017,5,0,14,8,27
12/24/2017,6,0,14,12,32
12/25/2017,10,0,3,5,18
12/26/2017,14,0,8,12,34
12/27/2017,11,0,11,0,22
12/28/2017,8,0,16,3,27
12/29/2017,4,0,15,0,19
12/30/2017,10,0,4,12,26
12/31/2017,5,0,7,8,20
1/1/2018,15,0,7,16,38
1/2/2018,15,0,12,13,40
1/3/2018,10,0,7,3,20
1/4/2018,4,0,14,4,22
1/5/2018,8,0,13,7,28
1/6/2018,4,0,14,0,18
1/7/2018,8,0,14,0,22
1/8/2018,5,0,4,4,13
1/9/2018,14,0,7,16,37
1/10/2018,14,0,8,5,27
1/11/2018,9,0,12,3,24
1/12/2018,7,0,2,9,18
1/13/2018,10,0,5,0,15
1/14/2018,13,0,10,5,28
1/15/2018,15,0,12,2,29
1/16/2018,16,0,14,12,42
1/17/2018,8,0,9,0,17
1/18/2018,9,0,16,7,32
1/19/2018,13,0,15,4,32
1/20/2018,16,0,15,3,34
1/21/2018,16,0,5,15,36
1/22/2018,16,0,16,14,46
1/23/2018,6,0,2,11,19
1/24/2018,13,0,3,15,31
1/25/2018,12,0,2,8,22
1/26/2018,4,0,10,13,27
1/27/2018,6,0,14,7,27
1/28/2018,8,0,3,16,27
1/29/2018,4,0,13,13,30
1/30/2018,16,0,3,8,27
1/31/2018,7,0,9,6,22
2/1/2018,11,0,11,16,38
2/2/2018,11,0,4,2,17
2/3/2018,16,0,7,12,35
2/4/2018,5,0,4,10,19
2/5/2018,12,0,15,14,41
2/6/2018,8,0,14,5,27
2/7/2018,10,0,2,12,24
2/8/2018,7,0,8,15,30
2/9/2018,7,0,10,8,25
2/10/2018,4,0,5,3,12
2/11/2018,16,0,2,0,18
2/12/2018,8,0,16,1,25
2/13/2018,15,0,8,16,39
2/14/2018,10,0,9,14,33
2/15/2018,16,0,2,16,34
2/16/2018,16,0,11,4,31
2/17/2018,7,0,11,10,28
2/18/2018,5,0,4,13,22
2/19/2018,11,0,12,13,36
2/20/2018,13,0,5,4,22
2/21/2018,8,0,3,14,25
2/22/2018,4,0,3,1,8
2/23/2018,10,0,8,12,30
2/24/2018,9,0,3,8,20
2/25/2018,11,0,14,1,26
2/26/2018,10,0,2,2,14
2/27/2018,4,0,9,6,19
2/28/2018,6,0,13,2,21
3/1/2018,5,0,14,6,25
3/2/2018,7,0,6,10,23
3/3/2018,4,0,16,6,26
3/4/2018,10,0,12,11,33
3/5/2018,11,0,9,9,29
3/6/2018,16,0,11,10,37
3/7/2018,10,0,14,2,26
3/8/2018,12,0,4,3,19
3/9/2018,10,0,8,2,20
3/10/2018,8,0,4,11,23
3/11/2018,14,0,13,0,27
3/12/2018,8,0,7,8,23
3/13/2018,10,0,9,10,29
3/14/2018,4,0,7,8,19
3/15/2018,9,0,14,15,38
3/16/2018,11,0,10,6,27
3/17/2018,16,0,15,8,39
3/18/2018,10,0,3,10,23
3/19/2018,12,0,14,9,35
3/20/2018,5,0,11,8,24
3/21/2018,15,0,3,8,26
3/22/2018,5,0,3,13,21
3/23/2018,12,0,6,3,21
3/24/2018,15,0,11,10,36
3/25/2018,15,0,9,15,39
3/26/2018,9,0,6,9,24
3/27/2018,14,0,5,15,34
3/28/2018,11,0,5,1,17
3/29/2018,9,0,3,8,20
3/30/2018,5,0,13,8,26
3/31/2018,5,0,11,0,16
4/1/2018,9,0,15,6,30
4/2/2018,7,0,12,10,29
4/3/2018,10,0,6,16,32
4/4/2018,12,0,4,12,28
4/5/2018,11,0,5,7,23
4/6/2018,10,0,2,16,28
4/7/2018,16,0,11,0,27
4/8/2018,10,0,16,9,35
4/9/2018,16,0,11,5,32
4/10/2018,6,0,16,8,30
4/11/2018,14,0,9,14,37
4/12/2018,10,0,5,8,23
4/13/2018,8,0,16,1,25
4/14/2018,10,0,9,5,24
4/15/2018,10,0,12,5,27
4/16/2018,6,0,2,6,14
4/17/2018,8,0,9,13,30
4/18/2018,16,0,13,11,40
4/19/2018,4,0,13,14,31
4/20/2018,15,0,12,4,31
4/21/2018,5,0,11,0,16
4/22/2018,14,0,15,8,37
4/23/2018,13,0,8,16,37
4/24/2018,15,0,12,15,42
4/25/2018,10,0,10,2,22
4/26/2018,7,0,14,16,37
4/27/2018,8,0,4,12,24
4/28/2018,6,0,10,13,29
4/29/2018,4,0,16,12,32
4/30/2018,5,0,5,1,11
5/1/2018,13,0,16,2,31
5/2/2018,11,0,11,16,38
5/3/2018,10,0,10,6,26
5/4/2018,12,0,7,14,33
5/5/2018,4,0,6,12,22
5/6/2018,13,0,8,3,24
5/7/2018,5,0,14,0,19
5/8/2018,9,0,2,15,26
5/9/2018,13,0,11,10,34
5/10/2018,12,0,16,15,43
5/11/2018,15,0,12,4,31
5/12/2018,4,0,10,8,22
5/13/2018,16,0,14,14,44
5/14/2018,13,0,16,6,35
5/15/2018,10,0,8,11,29
5/16/2018,6,0,10,6,22
5/17/2018,14,0,12,7,33
5/18/2018,8,0,14,7,29
5/19/2018,15,0,14,3,32
5/20/2018,12,0,12,2,26
5/21/2018,16,0,15,5,36
5/22/2018,11,0,11,14,36
5/23/2018,4,0,5,5,14
5/24/2018,10,0,4,14,28
5/25/2018,10,0,2,7,19
5/26/2018,15,0,6,12,33
5/27/2018,9,0,3,13,25
5/28/2018,4,0,14,3,21
5/29/2018,4,0,14,7,25
5/30/2018,15,0,2,5,22
5/31/2018,7,0,11,1,19
6/1/2018,10,0,9,7,26
6/2/2018,4,0,6,16,26
6/3/2018,9,0,8,13,30
6/4/2018,8,0,9,8,25
6/5/2018,8,0,6,15,29
6/6/2018,10,0,4,5,19
6/7/2018,6,0,4,7,17
6/8/2018,14,0,13,12,39
6/9/2018,4,0,7,15,26
6/10/2018,8,0,3,14,25
6/11/2018,4,0,12,16,32
6/12/2018,11,0,3,7,21
6/13/2018,14,0,12,6,32
6/14/2018,8,0,14,0,22
6/15/2018,10,0,14,3,27
6/16/2018,8,0,12,2,22
6/17/2018,11,0,2,12,25
6/18/2018,15,0,2,5,22
6/19/2018,5,0,9,15,29
6/20/2018,16,0,14,13,43
6/21/2018,4,0,11,13,28
6/22/2018,14,0,10,14,38
6/23/2018,4,0,14,15,33
6/24/2018,10,0,11,0,21
6/25/2018,13,0,10,5,28
6/26/2018,13,0,14,12,39
6/27/2018,9,0,8,2,19
6/28/2018,4,0,13,9,26
6/29/2018,9,0,16,15,40
6/30/2018,4,0,2,7,13
7/1/2018,14,0,12,1,27
7/2/2018,5,0,14,10,29
7/3/2018,11,0,14,7,32
7/4/2018,14,0,13,12,39
7/5/2018,13,0,5,4,22
7/6/2018,5,0,2,5,12
7/7/2018,14,0,2,5,21
7/8/2018,14,0,9,3,26
7/9/2018,10,0,9,9,28
7/10/2018,6,0,14,9,29
7/11/2018,14,0,5,5,24
7/12/2018,8,0,15,12,35
7/13/2018,7,0,13,3,23
7/14/2018,7,0,14,12,33
7/15/2018,13,0,11,5,29
7/16/2018,10,0,4,4,18
7/17/2018,12,0,7,12,31
7/18/2018,9,0,12,2,23
7/19/2018,11,0,7,12,30
7/20/2018,11,0,12,13,36
7/21/2018,10,0,3,6,19
7/22/2018,9,0,2,15,26
7/23/2018,9,0,7,0,16
7/24/2018,13,0,12,14,39
7/25/2018,15,0,4,6,25
7/26/2018,9,0,12,2,23
7/27/2018,6,0,9,14,29
7/28/2018,13,0,12,5,30
7/29/2018,11,0,5,9,25
7/30/2018,7,0,14,6,27
7/31/2018,11,0,8,1,20
8/1/2018,9,0,3,5,17
8/2/2018,5,0,2,2,9
8/3/2018,9,0,11,0,20
8/4/2018,16,0,15,9,40
8/5/2018,10,0,8,4,22
8/6/2018,6,0,13,2,21
8/7/2018,7,0,4,14,25
8/8/2018,13,0,2,7,22
8/9/2018,15,0,16,3,34
8/10/2018,10,0,13,0,23
8/11/2018,12,0,2,11,25
8/12/2018,9,0,15,1,25
8/13/2018,7,0,11,4,22
8/14/2018,16,0,9,7,32
8/15/2018,13,0,12,12,37
8/16/2018,9,0,15,2,26
8/17/2018,4,0,6,15,25
8/18/2018,6,0,14,13,33
8/19/2018,12,0,3,3,18
8/20/2018,10,0,13,13,36
8/21/2018,14,0,2,15,31
8/22/2018,8,0,7,0,15
8/23/2018,16,0,3,3,22
8/24/2018,8,0,9,0,17
8/25/2018,10,0,16,12,38
8/26/2018,4,0,11,1,16
8/27/2018,13,0,11,5,29
8/28/2018,7,0,2,2,11
8/29/2018,5,0,7,12,24
8/30/2018,10,0,11,12,33
8/31/2018,7,0,6,8,21
9/1/2018,16,0,6,6,28
9/2/2018,8,0,14,6,28
9/3/2018,15,0,6,10,31
9/4/2018,12,0,9,9,30
9/5/2018,9,0,10,6,25
9/6/2018,9,0,2,15,26
9/7/2018,6,0,6,12,24
9/8/2018,8,0,7,3,18
9/9/2018,12,0,12,8,32
9/10/2018,4,0,9,12,25
9/11/2018,4,0,7,13,24
9/12/2018,10,0,8,10,28
9/13/2018,5,0,3,5,13
9/14/2018,13,0,2,13,28
9/15/2018,13,0,12,14,39
9/16/2018,12,0,4,1,17
9/17/2018,4,0,11,10,25
9/18/2018,7,0,2,1,10
9/19/2018,4,0,12,12,28
9/20/2018,5,0,13,5,23
9/21/2018,4,0,8,7,19
9/22/2018,4,0,3,4,11
9/23/2018,14,0,2,8,24
9/24/2018,5,0,14,12,31
9/25/2018,8,0,9,16,33
9/26/2018,5,0,16,3,24
9/27/2018,9,0,7,0,16
9/28/2018,12,0,2,4,18
9/29/2018,15,0,10,5,30
9/30/2018,11,0,16,10,37
10/1/2018,6,0,9,5,20
10/2/2018,9,0,5,5,19
10/3/2018,14,0,5,4,23
10/4/2018,11,0,4,8,23
10/5/2018,10,0,13,12,35
10/6/2018,14,0,7,2,23
10/7/2018,15,0,16,7,38
10/8/2018,16,0,14,16,46
10/9/2018,9,0,9,9,27
10/10/2018,9,0,3,1,13
10/11/2018,7,0,4,14,25
10/12/2018,16,0,8,8,32
10/13/2018,8,0,7,9,24
10/14/2018,15,0,6,5,26
10/15/2018,12,0,9,0,21
10/16/2018,6,0,2,3,11
10/17/2018,13,0,12,11,36
10/18/2018,15,0,6,9,30
10/19/2018,7,0,9,6,22
10/20/2018,9,0,5,14,28
10/21/2018,6,0,10,7,23
10/22/2018,14,0,9,14,37
10/23/2018,12,0,2,10,24
10/24/2018,5,0,12,10,27
10/25/2018,4,0,13,5,22
10/26/2018,10,0,13,13,36
10/27/2018,16,0,10,2,28
10/28/2018,8,0,14,14,36
10/29/2018,13,0,10,10,33
10/30/2018,11,0,5,8,24
10/31/2018,8,0,15,2,25
11/1/2018,13,0,2,13,28
11/2/2018,13,0,16,2,31
11/3/2018,6,0,11,10,27
11/4/2018,14,0,10,1,25
11/5/2018,8,0,6,6,20
11/6/2018,8,0,12,7,27
11/7/2018,6,0,10,2,18
11/8/2018,9,0,4,14,27
11/9/2018,7,0,9,8,24
11/10/2018,14,0,13,15,42
11/11/2018,11,0,8,16,35
11/12/2018,7,0,3,9,19
11/13/2018,7,0,2,15,24
11/14/2018,7,0,9,1,17
11/15/2018,11,0,6,11,28
11/16/2018,6,0,3,13,22
11/17/2018,15,0,13,5,33
11/18/2018,8,0,5,6,19
11/19/2018,4,0,12,13,29
11/20/2018,4,0,3,2,9
11/21/2018,10,0,3,1,14
11/22/2018,11,0,13,5,29
11/23/2018,13,0,3,13,29
11/24/2018,4,0,3,6,13
11/25/2018,4,0,16,14,34
11/26/2018,16,0,10,13,39
11/27/2018,6,0,16,2,24
11/28/2018,16,0,8,11,35
11/29/2018,10,0,2,9,21
11/30/2018,5,0,4,15,24
12/1/2018,13,0,4,4,21
12/2/2018,6,0,8,3,17
12/3/2018,13,0,5,11,29
12/4/2018,12,0,7,15,34
12/5/2018,14,0,12,8,34
12/6/2018,7,0,9,8,24
12/7/2018,15,0,6,4,25
12/8/2018,4,0,14,1,19
12/9/2018,12,0,15,12,39
12/10/2018,16,0,15,13,44
12/11/2018,4,0,14,7,25
12/12/2018,11,0,5,11,27
12/13/2018,14,0,5,11,30
12/14/2018,14,0,9,15,38
12/15/2018,16,0,10,12,38
12/16/2018,10,0,12,14,36
12/17/2018,13,0,8,8,29
12/18/2018,4,0,11,4,19
12/19/2018,10,0,16,9,35
12/20/2018,4,0,9,10,23
12/21/2018,9,0,4,5,18
12/22/2018,10,0,9,1,20
12/23/2018,7,0,14,6,27
12/24/2018,16,0,4,8,28
12/25/2018,11,0,6,13,30
12/26/2018,8,0,4,3,15
12/27/2018,13,0,15,7,35
12/28/2018,4,0,5,15,24
12/29/2018,5,0,3,10,18
12/30/2018,6,0,14,12,32
12/31/2018,4,0,12,12,28
1/1/2019,14,0,15,4,33
1/2/2019,15,0,8,9,32
1/3/2019,9,0,3,8,20
1/4/2019,6,0,11,0,17
1/5/2019,7,0,2,9,18
1/6/2019,12,0,8,7,27
1/7/2019,4,0,11,4,19
1/8/2019,8,0,9,1,18
1/9/2019,15,0,13,3,31
1/10/2019,6,0,5,6,17
1/11/2019,6,0,12,2,20
1/12/2019,11,0,9,12,32
1/13/2019,7,0,10,1,18
1/14/2019,9,0,10,2,21
1/15/2019,8,0,6,14,28
1/16/2019,15,0,13,6,34
1/17/2019,5,0,14,0,19
1/18/2019,11,0,3,3,17
1/19/2019,12,0,3,6,21
1/20/2019,16,0,8,7,31
1/21/2019,16,0,9,13,38
1/22/2019,15,0,12,5,32
1/23/2019,11,0,4,14,29
1/24/2019,16,0,16,0,32
1/25/2019,9,0,11,6,26
1/26/2019,8,0,13,0,21
1/27/2019,6,0,10,16,32
1/28/2019,6,0,13,4,23
1/29/2019,11,0,16,7,34
1/30/2019,15,0,3,5,23
1/31/2019,5,0,13,8,26
2/1/2019,13,0,15,0,28
2/2/2019,15,0,10,3,28
2/3/2019,9,0,10,1,20
2/4/2019,10,0,12,4,26
2/5/2019,11,0,3,14,28
2/6/2019,13,0,5,15,33
2/7/2019,9,0,13,5,27
2/8/2019,12,0,14,3,29
2/9/2019,10,0,13,16,39
2/10/2019,16,0,14,1,31
2/11/2019,14,0,5,15,34
2/12/2019,11,0,16,8,35
2/13/2019,14,0,8,10,32
2/14/2019,5,0,4,8,17
2/15/2019,10,0,6,16,32
2/16/2019,16,0,15,8,39
2/17/2019,8,0,16,11,35
2/18/2019,14,0,14,0,28
2/19/2019,6,0,4,12,22
2/20/2019,7,0,12,4,23
2/21/2019,13,0,3,13,29
2/22/2019,13,0,15,0,28
2/23/2019,5,0,9,0,14
2/24/2019,6,0,6,3,15
2/25/2019,11,0,12,0,23
2/26/2019,15,0,15,2,32
2/27/2019,13,0,3,2,18
2/28/2019,6,0,12,7,25
3/1/2019,10,0,3,2,15
3/2/2019,13,0,7,15,35
3/3/2019,6,0,13,13,32
3/4/2019,6,0,8,12,26
3/5/2019,6,0,8,10,24
3/6/2019,11,0,12,1,24
3/7/2019,16,0,16,4,36
3/8/2019,4,0,4,13,21
3/9/2019,12,0,8,2,22
3/10/2019,5,0,13,7,25
3/11/2019,7,0,6,11,24
3/12/2019,10,0,13,10,33
3/13/2019,9,0,14,14,37
3/14/2019,9,0,6,7,22
3/15/2019,5,0,4,9,18
3/16/2019,7,0,3,15,25
3/17/2019,7,0,10,8,25
3/18/2019,10,0,12,9,31
3/19/2019,4,0,9,14,27
3/20/2019,14,0,16,1,31
3/21/2019,5,0,16,13,34
3/22/2019,6,0,6,0,12
3/23/2019,4,0,15,4,23
3/24/2019,12,0,15,13,40
3/25/2019,6,0,16,1,23
3/26/2019,11,0,14,0,25
3/27/2019,9,0,13,6,28
3/28/2019,13,0,9,13,35
3/29/2019,8,0,14,16,38
3/30/2019,15,0,14,7,36
3/31/2019,4,0,10,14,28
4/1/2019,5,0,6,6,17
4/2/2019,12,0,13,10,35
4/3/2019,8,0,14,8,30
4/4/2019,4,0,11,1,16
4/5/2019,13,0,3,1,17
4/6/2019,4,0,7,0,11
4/7/2019,10,0,2,0,12
4/8/2019,6,0,11,0,17
4/9/2019,4,0,3,0,7
4/10/2019,5,0,13,6,24
4/11/2019,6,0,6,16,28
4/12/2019,6,0,15,16,37
4/13/2019,12,0,2,0,14
4/14/2019,5,0,14,16,35
4/15/2019,8,0,11,15,34
4/16/2019,5,0,2,0,7
4/17/2019,5,0,7,4,16
4/18/2019,8,0,11,9,28
4/19/2019,12,0,5,11,28
4/20/2019,4,0,4,5,13
4/21/2019,16,0,9,8,33
4/22/2019,5,0,13,10,28
4/23/2019,12,0,16,9,37
4/24/2019,15,0,10,11,36
4/25/2019,12,0,4,14,30
4/26/2019,16,0,11,5,32
4/27/2019,15,0,9,2,26
4/28/2019,4,0,10,4,18
4/29/2019,5,0,4,16,25
4/30/2019,6,0,2,0,8
5/1/2019,11,0,8,10,29
5/2/2019,4,0,15,8,27
5/3/2019,14,0,16,16,46
5/4/2019,11,0,16,2,29
5/5/2019,12,0,16,2,30
5/6/2019,6,0,4,14,24
5/7/2019,9,0,3,8,20
5/8/2019,6,0,9,9,24
5/9/2019,11,0,15,7,33
5/10/2019,11,0,6,7,24
5/11/2019,11,0,11,4,26
5/12/2019,5,0,14,4,23
5/13/2019,6,0,12,14,32
5/14/2019,9,0,10,15,34
5/15/2019,12,0,9,3,24
5/16/2019,4,0,16,11,31
5/17/2019,9,0,14,4,27
5/18/2019,8,0,5,6,19
5/19/2019,13,0,14,1,28
5/20/2019,5,0,6,11,22
5/21/2019,16,0,16,6,38
5/22/2019,10,0,3,9,22
5/23/2019,12,0,10,2,24
5/24/2019,10,0,14,11,35
5/25/2019,16,0,4,16,36
5/26/2019,12,0,3,16,31
5/27/2019,8,0,16,7,31
5/28/2019,10,0,10,4,24
5/29/2019,4,0,10,13,27
5/30/2019,6,0,12,15,33
5/31/2019,12,0,14,15,41
6/1/2019,8,0,4,15,27
6/2/2019,16,0,8,0,24
6/3/2019,5,0,9,4,18
6/4/2019,14,0,14,7,35
6/5/2019,8,0,4,12,24
6/6/2019,16,0,11,6,33
6/7/2019,10,0,14,9,33
6/8/2019,5,0,12,4,21
6/9/2019,8,0,10,1,19
6/10/2019,6,0,5,0,11
6/11/2019,10,0,12,4,26
6/12/2019,10,0,5,1,16
6/13/2019,4,0,6,11,21
6/14/2019,9,0,10,3,22
6/15/2019,13,0,7,3,23
6/16/2019,9,0,5,6,20
6/17/2019,14,0,8,1,23
6/18/2019,12,0,14,0,26
6/19/2019,12,0,13,5,30
6/20/2019,5,0,4,6,15
6/21/2019,16,0,14,15,45
6/22/2019,4,0,16,3,23
6/23/2019,9,0,8,14,31
6/24/2019,11,0,7,2,20
6/25/2019,13,0,9,15,37
6/26/2019,12,0,13,5,30
6/27/2019,13,0,7,1,21
6/28/2019,14,0,9,16,39
6/29/2019,14,0,11,6,31
6/30/2019,12,0,13,7,32
7/1/2019,5,0,4,13,22
7/2/2019,4,0,6,7,17
7/3/2019,11,0,14,6,31
7/4/2019,6,0,11,12,29
7/5/2019,12,0,2,3,17
7/6/2019,4,0,5,1,10
7/7/2019,14,0,6,8,28
7/8/2019,8,0,16,8,32
7/9/2019,16,0,8,13,37
7/10/2019,4,0,11,10,25
7/11/2019,14,0,12,7,33
7/12/2019,13,0,13,2,28
7/13/2019,10,0,5,13,28
7/14/2019,10,0,13,14,37
7/15/2019,10,0,4,7,21
7/16/2019,12,0,14,13,39
7/17/2019,11,0,9,13,33
7/18/2019,15,0,13,15,43
7/19/2019,15,0,14,14,43
7/20/2019,9,0,2,9,20
7/21/2019,4,0,9,10,23
7/22/2019,8,0,11,10,29
7/23/2019,4,0,15,2,21
7/24/2019,5,0,6,6,17
7/25/2019,4,0,13,4,21
7/26/2019,16,0,9,9,34
7/27/2019,6,0,6,10,22
7/28/2019,12,0,10,7,29
7/29/2019,8,0,12,12,32
7/30/2019,13,0,14,5,32
7/31/2019,7,0,9,16,32
8/1/2019,7,0,4,3,14
8/2/2019,16,0,9,5,30
8/3/2019,10,0,5,7,22
8/4/2019,9,0,7,15,31
8/5/2019,5,0,8,4,17
8/6/2019,8,0,10,10,28
8/7/2019,6,0,15,1,22
8/8/2019,16,0,5,8,29
8/9/2019,8,0,3,5,16
8/10/2019,7,0,12,4,23
8/11/2019,12,0,16,4,32
8/12/2019,4,0,16,5,25
8/13/2019,5,0,2,15,22
8/14/2019,14,0,16,14,44
8/15/2019,12,0,15,5,32
8/16/2019,8,0,8,8,24
8/17/2019,16,0,5,10,31
8/18/2019,5,0,14,7,26
8/19/2019,15,0,8,9,32
8/20/2019,13,0,15,7,35
8/21/2019,10,0,14,9,33
8/22/2019,15,0,3,0,18
8/23/2019,9,0,4,15,28
8/24/2019,11,0,5,15,31
8/25/2019,10,0,11,10,31
8/26/2019,5,0,6,1,12
8/27/2019,5,0,2,4,11
8/28/2019,8,0,9,15,32
8/29/2019,11,0,8,3,22
8/30/2019,16,0,6,14,36
8/31/2019,12,0,3,1,16
9/1/2019,16,0,10,0,26
9/2/2019,10,0,2,9,21
9/3/2019,12,0,8,6,26
9/4/2019,4,0,2,7,13
9/5/2019,13,0,4,2,19
9/6/2019,8,0,10,10,28
9/7/2019,12,0,14,8,34
9/8/2019,7,0,2,5,14
9/9/2019,9,0,13,6,28
9/10/2019,16,0,11,14,41
9/11/2019,15,0,12,6,33
9/12/2019,4,0,13,6,23
9/13/2019,15,0,12,0,27
9/14/2019,16,0,13,0,29
9/15/2019,9,0,12,2,23
9/16/2019,6,0,13,2,21
9/17/2019,6,0,14,15,35
9/18/2019,11,0,6,12,29
9/19/2019,4,0,2,13,19
9/20/2019,8,0,8,11,27
9/21/2019,9,0,6,3,18
9/22/2019,7,0,10,13,30
9/23/2019,13,0,11,7,31
9/24/2019,5,0,12,15,32
9/25/2019,9,0,5,2,16
9/26/2019,12,0,5,0,17
9/27/2019,6,0,5,7,18
9/28/2019,5,0,11,3,19
9/29/2019,8,0,16,0,24
9/30/2019,8,0,10,3,21
10/1/2019,16,0,16,2,34
10/2/2019,10,0,9,0,19
10/3/2019,5,0,3,14,22
10/4/2019,6,0,2,0,8
10/5/2019,10,0,7,10,27
10/6/2019,8,0,8,6,22
10/7/2019,7,0,2,15,24
10/8/2019,14,0,4,13,31
10/9/2019,15,0,9,13,37
10/10/2019,11,0,3,2,16
10/11/2019,6,0,12,12,30
10/12/2019,9,0,16,15,40
10/13/2019,5,0,11,4,20
10/14/2019,10,0,14,9,33
10/15/2019,15,0,8,14,37
10/16/2019,16,0,9,3,28
10/17/2019,15,0,5,12,32
10/18/2019,11,0,3,7,21
10/19/2019,10,0,10,11,31
10/20/2019,14,0,5,16,35
10/21/2019,12,0,10,9,31
10/22/2019,7,0,11,4,22
10/23/2019,13,0,16,10,39
10/24/2019,7,0,2,0,9
10/25/2019,4,0,7,0,11
10/26/2019,6,0,7,15,28
10/27/2019,6,0,10,7,23
10/28/2019,5,0,2,6,13
10/29/2019,10,0,8,10,28
10/30/2019,5,0,12,11,28
10/31/2019,8,0,13,6,27
11/1/2019,7,0,7,4,18
11/2/2019,5,0,10,16,31
11/3/2019,9,0,12,2,23
11/4/2019,4,0,12,0,16
11/5/2019,11,0,4,2,17
11/6/2019,4,0,5,4,13
11/7/2019,16,0,16,14,46
11/8/2019,4,0,16,3,23
11/9/2019,16,0,3,6,25
11/10/2019,15,0,5,2,22
11/11/2019,10,0,3,14,27
11/12/2019,10,0,2,15,27
11/13/2019,16,0,3,7,26
11/14/2019,4,0,15,8,27
11/15/2019,5,0,3,14,22
11/16/2019,5,0,15,8,28
11/17/2019,7,0,3,5,15
11/18/2019,12,0,16,9,37
11/19/2019,9,0,5,1,15
11/20/2019,5,0,12,2,19
11/21/2019,4,0,15,4,23
11/22/2019,15,0,8,4,27
11/23/2019,14,0,16,10,40
11/24/2019,15,0,3,9,27
11/25/2019,8,0,13,10,31
11/26/2019,12,0,9,6,27
11/27/2019,5,0,9,2,16
11/28/2019,11,0,3,7,21
11/29/2019,11,0,4,1,16
11/30/2019,7,0,12,13,32
12/1/2019,9,0,3,15,27
12/2/2019,14,0,9,9,32
12/3/2019,8,0,6,0,14
12/4/2019,16,0,14,16,46
12/5/2019,13,0,15,13,41
12/6/2019,11,0,9,4,24
12/7/2019,16,0,13,6,35
12/8/2019,11,0,5,5,21
12/9/2019,14,0,9,8,31
12/10/2019,13,0,6,1,20
12/11/2019,11,0,13,11,35
12/12/2019,4,0,8,12,24
12/13/2019,14,0,5,5,24
12/14/2019,10,0,14,12,36
12/15/2019,8,0,11,8,27
12/16/2019,5,0,15,7,27
12/17/2019,6,0,15,0,21
12/18/2019,8,0,4,16,28
12/19/2019,13,0,16,3,32
12/20/2019,13,0,7,13,33
12/21/2019,9,0,7,10,26
12/22/2019,8,0,5,4,17
12/23/2019,11,0,2,12,25
12/24/2019,16,0,15,7,38
12/25/2019,4,0,13,11,28
12/26/2019,9,0,15,12,36
12/27/2019,4,0,5,3,12
12/28/2019,7,0,4,9,20
12/29/2019,12,0,12,2,26
12/30/2019,15,0,12,15,42
12/31/2019,15,0,13,12,40
1/1/2020,4,0,8,6,18
1/2/2020,8,0,5,13,26
1/3/2020,7,0,12,16,35
1/4/2020,8,0,8,3,19
1/5/2020,6,0,3,0,9
1/6/2020,16,0,3,14,33
1/7/2020,11,0,16,14,41
1/8/2020,6,0,9,6,21
1/9/2020,12,0,13,3,28
1/10/2020,13,0,15,2,30
1/11/2020,12,0,15,8,35
1/12/2020,11,0,7,14,32
1/13/2020,7,0,10,11,28
1/14/2020,10,0,13,1,24
1/15/2020,10,0,8,11,29
1/16/2020,11,0,13,14,38
1/17/2020,8,0,10,13,31
1/18/2020,7,0,4,9,20
1/19/2020,5,0,5,9,19
1/20/2020,10,0,12,3,25
1/21/2020,13,0,2,1,16
1/22/2020,4,0,6,14,24
1/23/2020,14,0,12,4,30
1/24/2020,14,0,8,10,32
1/25/2020,8,0,5,7,20
1/26/2020,10,0,5,0,15
1/27/2020,5,0,5,6,16
1/28/2020,5,0,13,10,28
1/29/2020,6,0,5,13,24
1/30/2020,13,0,13,14,40
1/31/2020,12,0,13,16,41
2/1/2020,13,0,15,4,32
2/2/2020,9,0,3,1,13
2/3/2020,6,0,3,12,21
2/4/2020,7,0,12,16,35
2/5/2020,15,0,13,8,36
2/6/2020,9,0,14,7,30
2/7/2020,7,0,16,9,32
2/8/2020,8,0,3,8,19
2/9/2020,5,0,6,13,24
2/10/2020,11,0,9,15,35
2/11/2020,9,0,2,2,13
2/12/2020,16,0,13,1,30
2/13/2020,7,0,10,6,23
2/14/2020,13,0,11,14,38
2/15/2020,15,0,4,0,19
2/16/2020,4,0,12,0,16
2/17/2020,16,0,3,5,24
2/18/2020,15,0,8,9,32
2/19/2020,8,0,7,8,23
2/20/2020,14,0,5,1,20
2/21/2020,10,0,8,14,32
2/22/2020,14,0,2,14,30
2/23/2020,12,0,5,10,27
2/24/2020,9,0,3,4,16
2/25/2020,12,0,8,16,36
2/26/2020,14,0,4,12,30
2/27/2020,14,0,9,15,38
2/28/2020,8,0,13,7,28
2/29/2020,5,0,6,10,21
3/1/2020,6,9,8,1,24
3/2/2020,8,9,12,15,44
3/3/2020,13,7,3,13,36
3/4/2020,11,5,11,3,30
3/5/2020,12,1,12,7,32
3/6/2020,6,4,10,5,25
3/7/2020,8,5,7,4,24
3/8/2020,13,3,16,10,42
3/9/2020,5,5,8,10,28
3/10/2020,15,0,11,4,30
3/11/2020,8,8,4,8,28
3/12/2020,8,4,11,16,39
3/13/2020,4,5,14,12,35
3/14/2020,4,9,4,8,25
3/15/2020,8,7,15,2,32
3/16/2020,7,5,12,10,34
3/17/2020,4,7,13,3,27
3/18/2020,16,4,12,15,47
3/19/2020,8,5,5,4,22
3/20/2020,13,8,5,2,28
3/21/2020,12,0,5,13,30
3/22/2020,16,3,8,0,27
3/23/2020,15,8,6,13,42
3/24/2020,15,5,11,11,42
3/25/2020,8,0,2,4,14
3/26/2020,7,1,14,6,28
3/27/2020,5,8,4,4,21
3/28/2020,12,8,10,4,34
3/29/2020,11,7,13,12,43
3/30/2020,16,2,9,7,34
3/31/2020,14,9,8,10,41
4/1/2020,6,10,15,14,45
4/2/2020,7,5,6,8,26
4/3/2020,14,6,12,12,44
4/4/2020,12,6,6,1,25
4/5/2020,14,1,14,10,39
4/6/2020,7,2,12,0,21
4/7/2020,10,1,2,14,27
4/8/2020,5,9,16,7,37
4/9/2020,5,8,12,15,40
4/10/2020,4,8,13,12,37
4/11/2020,7,6,14,13,40
4/12/2020,13,1,5,7,26
4/13/2020,16,4,16,4,40
4/14/2020,10,10,6,9,35
4/15/2020,12,10,16,10,48
4/16/2020,13,3,4,0,20
4/17/2020,14,7,10,1,32
4/18/2020,14,6,15,2,37
4/19/2020,5,2,9,9,25
4/20/2020,4,7,10,13,34
4/21/2020,7,2,9,2,20
4/22/2020,12,2,13,1,28
4/23/2020,6,2,4,9,21
4/24/2020,5,8,3,9,25
4/25/2020,7,7,15,12,41
4/26/2020,7,3,5,1,16
4/27/2020,7,7,2,4,20
4/28/2020,14,8,6,15,43
4/29/2020,15,1,3,5,24
4/30/2020,11,10,9,8,38
5/1/2020,9,33,12,11,65
5/2/2020,14,34,2,5,55
5/3/2020,15,49,14,8,86
5/4/2020,7,42,16,15,80
5/5/2020,4,25,13,6,48
5/6/2020,6,40,7,7,60
5/7/2020,8,32,9,7,56
5/8/2020,9,52,6,2,69
5/9/2020,14,32,11,9,66
5/10/2020,14,34,2,13,63
5/11/2020,4,39,8,6,57
5/12/2020,8,52,4,5,69
5/13/2020,6,33,13,0,52
5/14/2020,10,32,6,11,59
5/15/2020,7,50,11,15,83
5/16/2020,13,53,4,10,80
5/17/2020,6,34,8,12,60
5/18/2020,6,43,14,11,74
5/19/2020,13,35,12,14,74
5/20/2020,6,53,10,10,79
5/21/2020,12,29,12,11,64
5/22/2020,13,50,13,10,86
5/23/2020,4,51,7,15,77
5/24/2020,10,54,16,10,90
5/25/2020,8,25,5,9,47
5/26/2020,14,51,2,4,71
5/27/2020,5,36,6,0,47
5/28/2020,15,39,15,14,83
5/29/2020,11,32,10,5,58
5/30/2020,4,27,16,10,57
5/31/2020,10,29,4,9,52
6/1/2020,9,53,6,9,77
6/2/2020,10,47,15,14,86
6/3/2020,8,43,2,2,55
6/4/2020,15,42,15,3,75
6/5/2020,7,43,7,6,63
6/6/2020,4,55,5,4,68
6/7/2020,11,38,2,1,52
6/8/2020,5,25,3,11,44
6/9/2020,15,54,10,9,88
6/10/2020,10,28,12,15,65
6/11/2020,10,55,5,0,70
6/12/2020,4,53,16,5,78
6/13/2020,10,36,4,2,52
6/14/2020,15,47,5,5,72
6/15/2020,7,25,2,2,36
6/16/2020,9,42,5,12,68
6/17/2020,5,46,5,6,62
6/18/2020,5,40,7,6,58
6/19/2020,15,48,12,3,78
6/20/2020,7,45,11,16,79
6/21/2020,6,25,14,13,58
6/22/2020,15,55,13,0,83
6/23/2020,7,25,2,11,45
6/24/2020,8,43,13,1,65
6/25/2020,4,49,16,15,84
6/26/2020,15,32,3,12,62
6/27/2020,5,31,9,9,54
6/28/2020,6,53,16,2,77
6/29/2020,9,53,12,13,87
6/30/2020,15,47,13,8,83
7/1/2020,11,61,12,15,99
7/2/2020,13,79,16,1,109
7/3/2020,16,75,16,13,120
7/4/2020,14,77,12,3,106
7/5/2020,12,70,4,5,91
7/6/2020,16,73,7,8,104
7/7/2020,16,67,4,13,100
7/8/2020,4,60,4,15,83
7/9/2020,5,75,15,7,102
7/10/2020,15,69,7,10,101
7/11/2020,15,60,9,12,96
7/12/2020,15,68,10,0,93
7/13/2020,8,67,15,8,98
7/14/2020,16,64,3,9,92
7/15/2020,14,57,9,10,90
7/16/2020,10,68,14,6,98
7/17/2020,12,78,14,7,111
7/18/2020,12,60,16,5,93
7/19/2020,11,70,10,3,94
7/20/2020,14,74,15,1,104
7/21/2020,7,55,15,16,93
7/22/2020,7,80,16,11,114
7/23/2020,12,62,7,7,88
7/24/2020,12,66,4,11,93
7/25/2020,8,75,12,11,106
7/26/2020,11,70,4,8,93
7/27/2020,15,70,7,8,100
7/28/2020,13,69,6,0,88
7/29/2020,7,78,4,15,104
7/30/2020,12,57,3,6,78
7/31/2020,4,69,7,15,95
8/1/2020,6,62,12,11,91
8/2/2020,15,67,2,15,99
8/3/2020,4,56,2,14,76
8/4/2020,14,77,14,7,112
8/5/2020,12,59,16,0,87
8/6/2020,13,70,12,16,111
8/7/2020,7,69,5,3,84
8/8/2020,16,62,13,6,97
8/9/2020,8,57,13,13,91
8/10/2020,16,70,14,16,116
8/11/2020,11,74,13,2,100
8/12/2020,15,59,3,11,88
8/13/2020,10,67,10,3,90
8/14/2020,14,73,4,9,100
8/15/2020,7,77,5,7,96
8/16/2020,13,68,5,16,102
8/17/2020,4,60,7,7,78
8/18/2020,8,65,6,5,84
8/19/2020,10,62,10,9,91
8/20/2020,8,65,6,15,94
8/21/2020,7,74,11,3,95
8/22/2020,14,74,5,14,107
8/23/2020,6,76,16,9,107
8/24/2020,7,65,11,8,91
8/25/2020,15,74,4,12,105
8/26/2020,8,61,2,5,76
8/27/2020,8,55,15,7,85
8/28/2020,14,64,3,13,94
8/29/2020,14,76,6,14,110
8/30/2020,15,74,6,13,108
8/31/2020,16,79,9,13,117
9/1/2020,9,185,7,8,209
9/2/2020,5,194,14,9,222
9/3/2020,13,123,9,9,154
9/4/2020,4,245,14,7,270
9/5/2020,4,108,13,14,139
9/6/2020,16,208,16,6,246
9/7/2020,14,203,5,11,233
9/8/2020,15,220,14,11,260
9/9/2020,15,136,7,0,158
9/10/2020,10,175,10,9,204
9/11/2020,16,202,13,12,243
9/12/2020,9,226,4,4,243
9/13/2020,14,232,4,2,252
9/14/2020,8,233,14,11,266
9/15/2020,14,193,3,6,216
9/16/2020,10,148,4,8,170
9/17/2020,4,116,4,9,133
9/18/2020,9,151,10,14,184
9/19/2020,6,254,7,12,279
9/20/2020,12,235,11,4,262
9/21/2020,8,242,3,8,261
9/22/2020,10,104,16,16,146
9/23/2020,5,170,13,0,188
9/24/2020,13,112,8,15,148
9/25/2020,11,251,14,6,282
9/26/2020,16,251,3,4,274
9/27/2020,7,189,5,0,201
9/28/2020,14,250,13,13,290
9/29/2020,13,139,4,4,160
9/30/2020,13,157,13,9,192
10/1/2020,11,133,10,8,162
10/2/2020,7,255,11,7,280
10/3/2020,15,201,13,2,231
10/4/2020,4,163,3,1,171
10/5/2020,4,250,6,12,272
10/6/2020,4,197,3,10,214
10/7/2020,5,138,14,14,171
10/8/2020,6,119,7,6,138
10/9/2020,4,241,6,9,260
10/10/2020,15,166,10,13,204
10/11/2020,16,168,13,13,210
10/12/2020,14,238,5,11,268
10/13/2020,16,191,2,10,219
10/14/2020,6,178,6,15,205
10/15/2020,9,246,13,16,284
10/16/2020,9,196,3,3,211
10/17/2020,6,240,5,16,267
10/18/2020,4,126,16,9,155
10/19/2020,11,137,14,8,170
10/20/2020,12,100,7,10,129
10/21/2020,15,180,14,1,210
10/22/2020,13,223,14,3,253
10/23/2020,4,216,3,8,231
10/24/2020,10,166,13,4,193
10/25/2020,16,175,16,1,208
10/26/2020,15,237,10,13,275
10/27/2020,5,196,14,2,217
10/28/2020,10,211,10,10,241
10/29/2020,16,230,14,0,260
10/30/2020,11,145,8,2,166
10/31/2020,5,187,14,0,206
11/1/2020,14,109,3,8,134
11/2/2020,13,249,16,5,283
11/3/2020,15,135,11,3,164
11/4/2020,11,187,11,0,209
11/5/2020,16,121,3,10,150
11/6/2020,16,206,8,14,244
11/7/2020,11,207,12,9,239
11/8/2020,11,233,11,13,268
11/9/2020,15,223,13,9,260
11/10/2020,7,143,2,4,156
11/11/2020,9,250,11,3,273
11/12/2020,16,235,10,7,268
11/13/2020,13,170,12,1,196
11/14/2020,10,135,13,6,164
11/15/2020,6,214,13,4,237
11/16/2020,5,249,14,15,283
11/17/2020,14,213,7,4,238
11/18/2020,13,164,15,6,198
11/19/2020,14,148,2,15,179
11/20/2020,12,243,9,1,265
11/21/2020,5,192,13,13,223
11/22/2020,4,200,11,16,231
11/23/2020,4,213,2,15,234
11/24/2020,6,196,14,12,228
11/25/2020,6,250,4,10,270
11/26/2020,13,237,7,12,269
11/27/2020,14,240,13,0,267
11/28/2020,11,112,8,7,138
11/29/2020,8,206,9,13,236
11/30/2020,12,161,7,11,191
12/1/2020,15,127,3,0,145
12/2/2020,15,103,11,6,135
12/3/2020,15,112,7,1,135
12/4/2020,11,172,5,1,189
12/5/2020,5,222,8,8,243
12/6/2020,7,198,11,12,228
12/7/2020,14,135,12,9,170
12/8/2020,9,221,7,16,253
12/9/2020,4,151,15,2,172
12/10/2020,15,254,10,4,283
12/11/2020,13,152,12,7,184
12/12/2020,10,247,12,16,285
12/13/2020,13,247,6,15,281
12/14/2020,14,245,9,0,268
12/15/2020,12,178,4,0,194
12/16/2020,13,217,11,11,252
12/17/2020,11,120,10,11,152
12/18/2020,7,139,11,4,161
12/19/2020,12,193,5,3,213
12/20/2020,14,231,7,5,257
12/21/2020,11,234,11,1,257
12/22/2020,10,251,11,11,283
12/23/2020,12,117,11,10,150
12/24/2020,8,206,4,5,223
12/25/2020,16,223,3,15,257
12/26/2020,12,128,13,16,169
12/27/2020,15,255,6,5,281
12/28/2020,7,137,4,0,148
12/29/2020,8,165,14,9,196
12/30/2020,11,167,13,12,203
12/31/2020,15,128,7,8,158
1/1/2021,4,130,9,11,154
1/2/2021,4,164,9,16,193
1/3/2021,12,198,8,10,228
1/4/2021,8,222,8,8,246
1/5/2021,13,225,14,2,254
1/6/2021,16,176,11,7,210
1/7/2021,11,124,6,16,157
1/8/2021,9,222,8,4,243
1/9/2021,6,122,3,4,135
1/10/2021,15,186,10,14,225
1/11/2021,11,120,11,7,149
1/12/2021,5,232,2,7,246
1/13/2021,10,226,8,16,260
1/14/2021,9,169,15,8,201
1/15/2021,12,205,16,9,242
1/16/2021,12,250,14,11,287
1/17/2021,7,171,9,6,193
1/18/2021,9,107,6,9,131
1/19/2021,6,219,16,12,253
1/20/2021,9,182,13,6,210
1/21/2021,15,202,13,12,242
1/22/2021,12,149,2,9,172
1/23/2021,6,208,10,13,237
1/24/2021,6,163,12,3,184
1/25/2021,14,230,5,12,261
1/26/2021,9,245,15,10,279
1/27/2021,7,169,15,9,200
1/28/2021,7,187,3,2,199
1/29/2021,15,243,11,8,277
1/30/2021,5,237,8,7,257
1/31/2021,12,121,3,7,143
2/1/2021,7,220,5,8,240
2/2/2021,9,241,13,8,271
2/3/2021,11,153,4,3,171
2/4/2021,12,136,8,2,158
2/5/2021,14,110,11,12,147
2/6/2021,6,188,2,13,209
2/7/2021,12,104,12,10,138
2/8/2021,9,204,10,15,238
2/9/2021,9,136,11,0,156
2/10/2021,14,227,11,4,256
2/11/2021,12,173,3,3,191
2/12/2021,16,170,16,1,203
2/13/2021,9,106,15,0,130
2/14/2021,13,204,12,12,241
2/15/2021,11,117,8,10,146
2/16/2021,6,166,15,2,189
2/17/2021,9,239,11,14,273
2/18/2021,4,107,5,12,128
2/19/2021,14,192,11,0,217
2/20/2021,11,235,7,11,264
2/21/2021,12,145,5,11,173
2/22/2021,6,200,4,7,217
2/23/2021,11,233,14,12,270
2/24/2021,14,191,13,1,219
2/25/2021,10,149,8,4,171
2/26/2021,6,123,13,12,154
2/27/2021,16,227,12,6,261
2/28/2021,9,184,5,11,209
3/1/2021,10,130,16,7,163
3/2/2021,16,115,15,13,159
3/3/2021,4,157,3,8,172
3/4/2021,4,254,6,10,274
3/5/2021,9,126,3,14,152
3/6/2021,10,213,14,10,247
3/7/2021,13,216,16,11,256
3/8/2021,12,128,3,14,157
3/9/2021,11,142,8,6,167
3/10/2021,15,132,9,14,170
3/11/2021,10,150,10,10,180
3/12/2021,8,130,14,12,164
3/13/2021,7,238,12,12,269
3/14/2021,10,169,8,15,202
3/15/2021,6,183,11,13,213
3/16/2021,6,154,15,10,185
3/17/2021,4,150,7,4,165
3/18/2021,10,145,12,3,170
3/19/2021,10,211,2,6,229
3/20/2021,13,139,16,7,175
3/21/2021,8,176,6,3,193
3/22/2021,14,238,10,7,269
3/23/2021,6,103,3,16,128
3/24/2021,4,105,14,15,138
3/25/2021,9,148,12,8,177
3/26/2021,12,223,4,9,248
3/27/2021,12,164,16,1,193
3/28/2021,14,137,6,2,159
3/29/2021,11,164,14,11,200
3/30/2021,12,216,9,16,253
3/31/2021,14,174,6,16,210
4/1/2021,8,238,10,12,268
4/2/2021,11,145,13,0,169
4/3/2021,8,227,12,2,249
4/4/2021,6,113,4,2,125
4/5/2021,4,223,8,9,244
4/6/2021,5,186,14,0,205
4/7/2021,11,134,6,2,153
4/8/2021,7,166,3,13,189
4/9/2021,4,225,12,7,248
4/10/2021,8,176,9,8,201
4/11/2021,15,125,9,5,154
4/12/2021,16,217,8,10,251
4/13/2021,14,219,10,8,251
4/14/2021,9,250,10,0,269
4/15/2021,11,170,3,0,184
4/16/2021,11,140,12,5,168
4/17/2021,13,172,15,4,204
4/18/2021,6,246,3,1,256
4/19/2021,15,105,13,3,136
4/20/2021,4,252,10,5,271
4/21/2021,12,161,8,0,181
4/22/2021,16,154,8,13,191
4/23/2021,13,204,11,10,238
4/24/2021,10,207,12,3,232
4/25/2021,10,210,3,10,233
4/26/2021,4,199,6,12,221
4/27/2021,6,135,6,3,150
4/28/2021,14,147,13,7,181
4/29/2021,7,105,5,15,132
4/30/2021,13,117,13,0,143
5/1/2021,7,202,14,12,235
5/2/2021,12,229,10,13,264
5/3/2021,13,101,2,12,128
5/4/2021,9,210,5,13,237
5/5/2021,4,230,15,13,262
5/6/2021,10,141,7,13,171
5/7/2021,10,232,13,11,266
5/8/2021,7,116,3,6,132
5/9/2021,13,200,7,8,228
5/10/2021,4,230,7,9,250
5/11/2021,11,223,14,9,257
5/12/2021,13,200,7,11,231
5/13/2021,14,114,4,6,138
5/14/2021,10,217,11,11,249
5/15/2021,5,121,12,1,139
5/16/2021,6,110,16,0,132
5/17/2021,11,179,9,16,215
5/18/2021,14,189,4,4,211
5/19/2021,6,250,15,1,272
5/20/2021,14,199,6,9,228
5/21/2021,15,197,16,4,232
5/22/2021,13,105,8,6,132
5/23/2021,16,153,12,2,183
5/24/2021,10,233,9,16,268
5/25/2021,9,247,14,6,276
5/26/2021,4,201,12,12,229
5/27/2021,16,148,10,13,187
5/28/2021,16,252,11,8,287
5/29/2021,9,126,11,3,149
5/30/2021,8,194,3,14,219
5/31/2021,5,156,10,5,176
6/1/2021,10,110,8,8,136
6/2/2021,7,126,6,0,139
6/3/2021,7,123,3,4,137
6/4/2021,16,137,11,5,169
6/5/2021,9,112,4,13,138
6/6/2021,10,137,4,13,164
6/7/2021,6,139,14,16,175
6/8/2021,8,228,15,0,251
6/9/2021,14,180,9,0,203
6/10/2021,13,176,11,15,215
6/11/2021,12,204,3,9,228
6/12/2021,15,123,5,0,143
6/13/2021,9,233,7,10,259
6/14/2021,11,121,9,5,146
6/15/2021,7,195,5,8,215
6/16/2021,6,228,10,12,256
6/17/2021,8,230,12,15,265
6/18/2021,9,235,8,12,264
6/19/2021,4,226,15,16,261
6/20/2021,10,172,8,11,201
6/21/2021,15,253,3,6,277
6/22/2021,6,235,9,7,257
6/23/2021,10,132,10,3,155
6/24/2021,4,101,11,2,118
6/25/2021,5,125,11,3,144
6/26/2021,16,175,12,2,205
6/27/2021,11,169,4,0,184
6/28/2021,11,149,16,11,187
6/29/2021,9,118,11,7,145
6/30/2021,15,246,13,5,279
7/1/2021,9,164,14,10,197
7/2/2021,14,180,12,9,215
7/3/2021,5,145,13,1,164
7/4/2021,7,203,5,2,217
7/5/2021,14,208,10,13,245
7/6/2021,6,109,8,10,133
7/7/2021,4,174,5,2,185
7/8/2021,13,198,7,13,231
7/9/2021,7,142,4,15,168
7/10/2021,16,137,12,1,166
7/11/2021,16,103,16,5,140
7/12/2021,9,205,4,6,224
7/13/2021,5,215,9,8,237
7/14/2021,14,167,16,16,213
7/15/2021,9,152,13,6,180
7/16/2021,7,164,15,0,186
7/17/2021,14,149,14,11,188
7/18/2021,5,252,6,16,279
7/19/2021,4,215,8,14,241
7/20/2021,12,102,8,15,137
7/21/2021,6,138,16,8,168
7/22/2021,6,145,12,5,168
7/23/2021,10,148,2,10,170
7/24/2021,13,237,16,2,268
7/25/2021,10,162,16,9,197
7/26/2021,12,194,15,10,231
7/27/2021,8,204,4,15,231
7/28/2021,15,251,5,5,276
7/29/2021,7,163,13,15,198
7/30/2021,12,206,4,10,232
7/31/2021,14,106,16,6,142
8/1/2021,12,251,5,16,284
8/2/2021,15,140,15,9,179
8/3/2021,16,220,4,0,240
8/4/2021,5,194,4,6,209
8/5/2021,16,208,6,8,238
8/6/2021,15,251,10,12,288
8/7/2021,11,194,5,6,216
8/8/2021,15,213,15,2,245
8/9/2021,4,114,16,16,150
8/10/2021,11,147,7,9,174
8/11/2021,5,172,3,16,196
8/12/2021,10,169,11,10,200
8/13/2021,6,116,16,6,144
8/14/2021,7,227,7,0,241
8/15/2021,7,105,5,12,129
8/16/2021,10,226,9,11,256
8/17/2021,14,144,8,5,171
8/18/2021,14,226,16,9,265
8/19/2021,6,199,7,11,223
8/20/2021,10,102,9,8,129
8/21/2021,7,250,13,3,273
8/22/2021,7,138,7,7,159
8/23/2021,10,186,7,16,219
8/24/2021,12,100,12,13,137
8/25/2021,9,116,10,15,150
8/26/2021,5,133,10,16,164
8/27/2021,4,222,10,14,250
8/28/2021,16,247,9,1,273
8/29/2021,8,200,3,15,226
8/30/2021,10,203,14,15,242
8/31/2021,12,158,8,8,186
9/1/2021,4,116,3,6,129
9/2/2021,8,103,11,9,131
9/3/2021,13,208,9,12,242
9/4/2021,9,248,5,4,266
9/5/2021,12,221,6,6,245
9/6/2021,8,164,4,7,183
9/7/2021,8,107,10,11,136
9/8/2021,11,179,14,5,209
9/9/2021,15,242,11,10,278
9/10/2021,4,143,7,0,154
9/11/2021,4,197,15,4,220
9/12/2021,4,110,10,11,135
9/13/2021,14,135,9,9,167
9/14/2021,12,182,15,1,210
9/15/2021,8,146,14,5,173
9/16/2021,8,171,7,12,198
9/17/2021,16,114,6,3,139
9/18/2021,9,242,16,4,271
9/19/2021,8,168,14,3,193
9/20/2021,14,247,8,0,269
9/21/2021,13,128,3,13,157
9/22/2021,7,194,9,4,214
9/23/2021,10,186,3,11,210
9/24/2021,10,159,9,1,179
9/25/2021,4,244,15,11,274
9/26/2021,12,190,7,1,210
9/27/2021,9,155,5,6,175
9/28/2021,13,130,13,9,165
9/29/2021,13,160,7,10,190
9/30/2021,6,172,5,11,194
10/1/2021,9,100,4,8,121
10/2/2021,9,137,10,16,172
10/3/2021,11,148,10,5,174
10/4/2021,13,198,11,4,226
10/5/2021,13,138,6,8,165
10/6/2021,7,176,5,3,191
10/7/2021,12,243,12,0,267
10/8/2021,11,217,9,5,242
10/9/2021,11,142,16,15,184
10/10/2021,14,124,12,13,163
10/11/2021,5,142,13,12,172
10/12/2021,12,225,4,2,243
10/13/2021,13,104,5,15,137
10/14/2021,7,155,5,10,177
10/15/2021,7,234,8,0,249
10/16/2021,16,141,12,1,170
10/17/2021,9,199,7,15,230
10/18/2021,7,178,8,14,207
10/19/2021,4,240,15,1,260
10/20/2021,7,213,16,0,236
10/21/2021,5,143,10,14,172
10/22/2021,10,193,16,7,226
10/23/2021,7,112,2,15,136
10/24/2021,16,201,6,8,231
10/25/2021,9,245,4,13,271
10/26/2021,9,110,4,10,133
10/27/2021,11,198,11,2,222
10/28/2021,16,239,4,1,260
10/29/2021,16,128,15,3,162
10/30/2021,5,122,2,9,138
10/31/2021,14,224,4,11,253
11/1/2021,14,155,4,14,187
11/2/2021,13,234,3,1,251
11/3/2021,13,216,9,12,250
11/4/2021,10,133,7,0,150
11/5/2021,7,170,12,9,198
11/6/2021,15,244,10,9,278
11/7/2021,16,185,4,9,214
11/8/2021,14,184,10,3,211
11/9/2021,16,202,9,14,241
11/10/2021,4,181,5,5,195
11/11/2021,6,128,2,12,148
11/12/2021,15,224,13,2,254
11/13/2021,4,137,6,6,153
11/14/2021,13,203,6,11,233
11/15/2021,9,120,3,3,135
11/16/2021,10,162,13,0,185
11/17/2021,11,236,9,16,272
11/18/2021,10,220,5,16,251
11/19/2021,4,196,6,4,210
11/20/2021,5,148,15,1,169
11/21/2021,15,140,4,16,175
11/22/2021,7,174,12,5,198
11/23/2021,16,158,4,0,178
11/24/2021,10,111,14,0,135
11/25/2021,13,126,14,6,159
11/26/2021,4,214,13,16,247
11/27/2021,8,234,10,1,253
11/28/2021,14,149,4,1,168
11/29/2021,5,188,13,15,221
11/30/2021,9,139,11,3,162
12/1/2021,15,164,10,13,202
12/2/2021,13,232,4,14,263
12/3/2021,8,177,12,11,208
12/4/2021,4,220,10,4,238
12/5/2021,12,229,12,4,257
12/6/2021,12,174,11,9,206
12/7/2021,6,244,6,3,259
12/8/2021,7,121,15,16,159
12/9/2021,8,169,9,16,202
12/10/2021,8,128,8,8,152
12/11/2021,13,168,14,15,210
12/12/2021,14,194,6,13,227
12/13/2021,11,170,8,11,200
12/14/2021,14,225,8,1,248
12/15/2021,11,192,3,5,211
12/16/2021,6,197,14,8,225
12/17/2021,5,226,4,12,247
12/18/2021,7,222,12,3,244
12/19/2021,4,231,4,1,240
12/20/2021,12,240,2,13,267
12/21/2021,5,200,2,1,208
12/22/2021,14,199,3,0,216
12/23/2021,6,110,9,12,137
12/24/2021,14,120,9,15,158
12/25/2021,8,209,7,16,240
12/26/2021,9,144,15,15,183
12/27/2021,8,109,3,0,120
12/28/2021,8,148,7,9,172
12/29/2021,15,238,11,0,264
12/30/2021,9,131,10,9,159
12/31/2021,4,194,5,6,209
1/1/2022,14,114,6,7,141
1/2/2022,6,175,15,16,212
1/3/2022,11,223,9,2,245
1/4/2022,8,225,13,12,258
1/5/2022,12,230,5,10,257
1/6/2022,5,185,7,0,197
1/7/2022,9,228,15,12,264
1/8/2022,13,250,11,1,275
1/9/2022,7,128,16,0,151
1/10/2022,9,100,13,9,131
1/11/2022,14,226,15,0,255
1/12/2022,8,233,8,13,262
1/13/2022,15,152,13,9,189
1/14/2022,13,177,11,13,214
1/15/2022,5,200,4,2,211
1/16/2022,4,191,9,2,206
1/17/2022,12,196,11,1,220
1/18/2022,9,216,2,1,228
1/19/2022,4,240,7,11,262
1/20/2022,7,127,5,3,142
1/21/2022,4,230,16,6,256
1/22/2022,5,109,11,11,136
1/23/2022,14,167,7,16,204
1/24/2022,9,212,12,9,242
1/25/2022,5,171,14,4,194
1/26/2022,9,148,6,13,176
1/27/2022,15,132,9,6,162
1/28/2022,4,217,5,1,227
1/29/2022,13,133,11,9,166
1/30/2022,8,166,8,3,185
1/31/2022,6,171,5,3,185
2/1/2022,6,150,4,6,166
2/2/2022,8,240,2,14,264
2/3/2022,5,253,14,0,272
2/4/2022,8,248,7,16,279
2/5/2022,5,104,3,16,128
2/6/2022,6,179,8,7,200
2/7/2022,7,181,16,6,210
2/8/2022,5,250,7,1,263
2/9/2022,11,186,8,3,208
2/10/2022,4,130,4,4,142
2/11/2022,6,239,12,3,260
2/12/2022,10,191,11,3,215
2/13/2022,9,155,12,12,188
2/14/2022,7,201,7,7,222
2/15/2022,8,191,14,15,228
2/16/2022,14,142,13,15,184
2/17/2022,15,209,11,4,239
2/18/2022,6,193,8,0,207
2/19/2022,5,143,3,14,165
2/20/2022,5,222,15,3,245
2/21/2022,7,212,16,11,246
2/22/2022,7,190,6,1,204
2/23/2022,4,221,8,11,244
2/24/2022,16,127,12,0,155
2/25/2022,7,141,15,5,168
2/26/2022,13,103,8,2,126
2/27/2022,6,114,9,9,138
2/28/2022,14,195,8,3,220
3/1/2022,15,219,8,3,245
3/2/2022,10,149,9,14,182
3/3/2022,15,230,6,5,256
3/4/2022,8,139,9,11,167
3/5/2022,9,182,15,15,221
3/6/2022,12,219,3,1,235
3/7/2022,4,212,14,5,235
3/8/2022,6,199,11,14,230
3/9/2022,14,165,11,5,195
3/10/2022,5,197,5,6,213
3/11/2022,12,232,7,7,258
3/12/2022,7,156,12,10,185
3/13/2022,10,247,8,10,275
3/14/2022,10,154,8,7,179
3/15/2022,4,130,8,4,146
3/16/2022,4,128,10,1,143
3/17/2022,14,248,8,7,277
3/18/2022,8,213,9,6,236
3/19/2022,10,218,10,4,242
3/20/2022,13,211,7,4,235
3/21/2022,7,241,4,10,262
3/22/2022,14,188,4,16,222
3/23/2022,14,126,10,5,155
3/24/2022,12,180,5,6,203
3/25/2022,14,184,8,5,211
3/26/2022,15,145,8,14,182
3/27/2022,6,168,11,12,197
3/28/2022,12,180,11,0,203
3/29/2022,8,229,15,16,268
3/30/2022,8,153,11,1,173
3/31/2022,12,136,2,15,165
4/1/2022,12,145,11,7,175
4/2/2022,13,119,13,6,151
4/3/2022,4,249,6,5,264
4/4/2022,4,120,11,3,138
4/5/2022,9,158,14,10,191
4/6/2022,4,214,10,2,230
4/7/2022,11,219,9,6,245
4/8/2022,13,240,4,3,260
4/9/2022,5,223,3,10,241
4/10/2022,12,243,16,0,271
4/11/2022,5,226,6,0,237
4/12/2022,4,206,6,5,221
4/13/2022,9,110,14,0,133
4/14/2022,9,228,14,2,253
4/15/2022,7,253,13,6,279
4/16/2022,8,161,12,16,197
4/17/2022,16,180,16,0,212
4/18/2022,4,191,11,11,217
4/19/2022,15,102,11,7,135
4/20/2022,11,211,5,3,230
4/21/2022,5,188,5,1,199
4/22/2022,5,179,7,12,203
4/23/2022,15,254,8,6,283
4/24/2022,5,134,8,11,158
4/25/2022,10,168,8,13,199
4/26/2022,14,139,7,2,162
4/27/2022,14,241,4,7,266
4/28/2022,6,233,8,9,256
4/29/2022,4,228,12,9,253
4/30/2022,11,207,9,15,242
5/1/2022,15,107,7,8,137
5/2/2022,14,204,15,16,249
5/3/2022,11,221,4,14,250
5/4/2022,11,172,15,12,210
5/5/2022,14,245,9,6,274
5/6/2022,16,217,15,10,258
5/7/2022,7,230,3,13,253
5/8/2022,12,151,4,8,175
5/9/2022,4,200,10,11,225
5/10/2022,9,142,6,2,159
5/11/2022,9,173,13,7,202
5/12/2022,12,183,15,3,213
5/13/2022,10,183,8,3,204
5/14/2022,8,194,16,6,224
5/15/2022,11,185,3,11,210
5/16/2022,8,115,14,5,142
5/17/2022,8,213,13,11,245
5/18/2022,16,105,8,12,141
5/19/2022,14,165,8,5,192
5/20/2022,16,250,14,7,287
5/21/2022,14,198,10,16,238
5/22/2022,16,185,4,7,212
5/23/2022,6,110,8,9,133
5/24/2022,7,218,3,6,234
5/25/2022,12,148,7,8,175
5/26/2022,9,211,10,4,234
5/27/2022,10,170,7,10,197
5/28/2022,9,179,3,5,196
5/29/2022,11,224,10,11,256
5/30/2022,8,232,14,6,260
5/31/2022,5,103,2,12,122
6/1/2022,13,139,13,14,179
6/2/2022,4,117,12,14,147
6/3/2022,6,253,3,14,276
6/4/2022,10,249,8,7,274
6/5/2022,11,240,12,6,269
6/6/2022,13,213,5,2,233
6/7/2022,13,169,4,2,188
6/8/2022,8,252,15,15,290
6/9/2022,14,247,7,2,270
6/10/2022,5,118,3,12,138
6/11/2022,12,238,10,9,269
6/12/2022,5,170,2,11,188
6/13/2022,13,242,13,13,281
6/14/2022,13,168,2,0,183
6/15/2022,9,185,7,10,211
6/16/2022,15,188,12,12,227
6/17/2022,9,159,14,16,198
6/18/2022,14,244,10,8,276
6/19/2022,9,122,11,7,149
6/20/2022,15,145,11,8,179
6/21/2022,10,197,6,2,215
6/22/2022,12,108,7,5,132
6/23/2022,9,113,10,0,132
6/24/2022,11,253,11,7,282
6/25/2022,6,162,10,13,191
6/26/2022,9,107,12,12,140
6/27/2022,14,198,11,2,225
6/28/2022,6,255,5,11,277
6/29/2022,9,165,10,12,196
6/30/2022,11,237,12,10,270
7/1/2022,7,221,10,16,254
7/2/2022,9,117,16,14,156
7/3/2022,9,193,15,6,223
7/4/2022,7,206,15,7,235
7/5/2022,6,228,9,12,255
7/6/2022,8,165,6,1,180
7/7/2022,14,102,6,3,125
7/8/2022,10,246,13,15,284
7/9/2022,7,179,11,1,198
7/10/2022,9,174,7,16,206
7/11/2022,6,177,6,7,196
7/12/2022,7,203,11,4,225
7/13/2022,12,230,11,16,269
7/14/2022,15,200,13,5,233
7/15/2022,10,147,14,4,175
7/16/2022,10,176,16,1,203
7/17/2022,15,232,6,11,264
7/18/2022,11,172,5,9,197
7/19/2022,11,201,15,8,235
7/20/2022,6,155,8,14,183
7/21/2022,9,101,12,2,124
7/22/2022,8,143,15,15,181
7/23/2022,10,225,10,9,254
7/24/2022,13,126,2,8,149
7/25/2022,8,162,6,16,192
7/26/2022,14,244,12,13,283
7/27/2022,9,247,12,14,282
7/28/2022,5,108,9,7,129
7/29/2022,6,107,4,11,128
7/30/2022,16,192,10,12,230
7/31/2022,9,132,15,12,168
8/1/2022,13,158,11,6,188
8/2/2022,10,185,7,10,212
8/3/2022,15,235,12,3,265
8/4/2022,8,226,10,1,245
8/5/2022,8,171,5,11,195
8/6/2022,13,198,6,14,231
8/7/2022,11,142,7,10,170
8/8/2022,13,201,5,6,225
8/9/2022,7,195,2,1,205
8/10/2022,13,184,3,9,209
8/11/2022,4,124,11,14,153
8/12/2022,13,200,13,2,228
8/13/2022,4,150,9,12,175
8/14/2022,9,185,5,9,208
8/15/2022,7,159,16,14,196
8/16/2022,16,187,11,4,218
8/17/2022,16,217,3,13,249
8/18/2022,15,107,10,2,134
8/19/2022,6,178,11,12,207
8/20/2022,10,240,2,14,266
8/21/2022,7,172,3,10,192
8/22/2022,5,111,12,12,140
8/23/2022,15,189,10,7,221
8/24/2022,15,224,4,9,252
8/25/2022,7,125,8,9,149
8/26/2022,15,214,13,5,247
8/27/2022,6,236,9,7,258
8/28/2022,4,118,8,7,137
8/29/2022,6,174,5,6,191
8/30/2022,14,131,11,16,172
8/31/2022,11,152,7,11,181
9/1/2022,9,212,6,6,233
9/2/2022,8,205,4,14,231
9/3/2022,14,183,12,14,223
9/4/2022,4,210,6,12,232
9/5/2022,11,181,16,9,217
9/6/2022,13,117,13,7,150
9/7/2022,4,140,12,7,163
9/8/2022,8,208,6,12,234
9/9/2022,6,188,7,2,203
9/10/2022,12,199,13,15,239
9/11/2022,8,101,11,16,136
9/12/2022,11,201,8,7,227
9/13/2022,8,220,12,12,252
9/14/2022,10,137,10,11,168
9/15/2022,12,242,12,14,280
9/16/2022,5,205,3,9,222
9/17/2022,13,194,2,8,217
9/18/2022,7,182,13,14,216
9/19/2022,14,252,5,11,282
9/20/2022,15,243,11,13,282
9/21/2022,11,192,2,14,219
9/22/2022,8,125,14,1,148
9/23/2022,8,188,13,7,216
9/24/2022,9,232,9,13,263
9/25/2022,7,209,11,8,235
9/26/2022,4,214,8,3,229
9/27/2022,4,251,4,5,264
9/28/2022,12,238,12,13,275
9/29/2022,4,166,7,5,182
9/30/2022,10,133,15,12,170
10/1/2022,6,238,4,14,262
10/2/2022,5,180,16,14,215
10/3/2022,12,140,15,7,174
10/4/2022,12,162,9,5,188
10/5/2022,16,252,8,5,281
10/6/2022,9,174,5,7,195
10/7/2022,8,207,2,16,233
10/8/2022,11,187,15,15,228
10/9/2022,10,111,16,11,148
10/10/2022,14,197,2,16,229
10/11/2022,7,228,2,5,242
10/12/2022,10,205,13,16,244
10/13/2022,6,156,13,1,176
10/14/2022,4,238,6,7,255
10/15/2022,11,200,13,9,233
10/16/2022,12,206,11,3,232
10/17/2022,4,148,15,7,174
10/18/2022,16,218,4,6,244
10/19/2022,6,197,8,12,223
10/20/2022,12,157,5,13,187
10/21/2022,15,148,3,6,172
10/22/2022,5,113,3,5,126
10/23/2022,10,242,2,10,264
10/24/2022,7,240,16,11,274
10/25/2022,13,248,11,16,288
10/26/2022,10,176,11,2,199
10/27/2022,11,212,7,12,242
10/28/2022,15,180,8,12,215
10/29/2022,14,115,2,13,144
10/30/2022,5,234,12,8,259
10/31/2022,16,185,15,0,216
11/1/2022,16,126,2,7,151
11/2/2022,6,110,15,12,143
11/3/2022,15,205,2,8,230
11/4/2022,10,239,16,13,278
11/5/2022,4,220,15,8,247
11/6/2022,7,216,15,8,246
11/7/2022,11,206,14,13,244
11/8/2022,10,166,10,4,190
11/9/2022,14,172,8,13,207
11/10/2022,7,159,15,8,189
11/11/2022,4,124,12,16,156
11/12/2022,12,152,8,13,185
11/13/2022,12,204,10,1,227
11/14/2022,5,233,13,1,252
11/15/2022,9,147,5,15,176
11/16/2022,11,192,15,6,224
11/17/2022,7,181,4,1,193
11/18/2022,4,160,6,10,180
11/19/2022,5,178,11,10,204
11/20/2022,11,219,7,6,243
11/21/2022,11,245,14,4,274
11/22/2022,7,186,9,12,214
11/23/2022,6,191,5,9,211
11/24/2022,14,160,8,12,194
11/25/2022,14,188,15,2,219
11/26/2022,9,115,4,12,140
11/27/2022,5,127,7,12,151
11/28/2022,6,229,16,11,262
11/29/2022,5,159,14,7,185
11/30/2022,4,243,2,0,249
12/1/2022,12,227,9,3,251
12/2/2022,15,115,12,12,154
12/3/2022,15,218,9,16,258
12/4/2022,6,104,13,7,130
12/5/2022,6,136,15,15,172
12/6/2022,10,190,15,4,219
12/7/2022,6,224,9,5,244
12/8/2022,7,227,14,15,263
12/9/2022,8,139,14,14,175
12/10/2022,9,108,14,5,136
12/11/2022,13,169,5,13,200
12/12/2022,4,254,4,6,268
12/13/2022,14,127,15,14,170
12/14/2022,8,139,9,0,156
12/15/2022,4,127,14,2,147
12/16/2022,4,100,16,16,136
12/17/2022,6,180,12,5,203
12/18/2022,10,131,2,2,145
12/19/2022,13,181,4,11,209
12/20/2022,9,200,10,9,228
12/21/2022,13,151,6,9,179
12/22/2022,10,228,15,6,259
12/23/2022,16,203,14,14,247
12/24/2022,5,229,12,10,256
12/25/2022,14,103,16,4,137
12/26/2022,9,222,13,5,249
12/27/2022,14,248,9,3,274
12/28/2022,11,220,11,4,246
12/29/2022,15,140,15,13,183
12/30/2022,11,148,7,13,179
12/31/2022,8,127,7,0,142
