admit_date,flu,covid,malaria,others,tanjore_total_count
1/1/1970,7,0,6,13,26
1/2/1970,7,0,6,13,26
1/3/1970,6,0,7,3,16
1/4/1970,6,0,4,5,15
1/5/1970,7,0,3,0,10
1/6/1970,5,0,8,13,26
1/7/1970,8,0,8,8,24
1/8/1970,2,0,4,3,9
1/9/1970,8,0,7,10,25
1/10/1970,3,0,3,0,6
1/11/1970,4,0,7,6,17
1/12/1970,2,0,8,5,15
1/13/1970,6,0,2,1,9
1/14/1970,8,0,3,11,22
1/15/1970,8,0,4,12,24
1/16/1970,8,0,7,1,16
1/17/1970,2,0,7,7,16
1/18/1970,4,0,3,3,10
1/19/1970,7,0,3,13,23
1/20/1970,2,0,5,12,19
1/21/1970,3,0,8,4,15
1/22/1970,6,0,5,4,15
1/23/1970,2,0,5,13,20
1/24/1970,7,0,8,8,23
1/25/1970,3,0,8,1,12
1/26/1970,8,0,7,8,23
1/27/1970,2,0,8,6,16
1/28/1970,3,0,7,13,23
1/29/1970,5,0,4,13,22
1/30/1970,7,0,3,2,12
1/31/1970,2,0,4,3,9
2/1/1970,7,0,3,4,14
2/2/1970,4,0,3,1,8
2/3/1970,2,0,6,10,18
2/4/1970,6,0,6,1,13
2/5/1970,8,0,2,2,12
2/6/1970,6,0,8,0,14
2/7/1970,7,0,8,4,19
2/8/1970,3,0,6,7,16
2/9/1970,7,0,4,3,14
2/10/1970,2,0,2,6,10
2/11/1970,2,0,7,8,17
2/12/1970,6,0,7,13,26
2/13/1970,8,0,7,6,21
2/14/1970,7,0,2,8,17
2/15/1970,5,0,6,10,21
2/16/1970,3,0,4,3,10
2/17/1970,7,0,8,10,25
2/18/1970,6,0,5,7,18
2/19/1970,5,0,8,10,23
2/20/1970,2,0,5,6,13
2/21/1970,4,0,5,9,18
2/22/1970,6,0,6,1,13
2/23/1970,7,0,5,10,22
2/24/1970,6,0,2,4,12
2/25/1970,5,0,4,13,22
2/26/1970,3,0,6,2,11
2/27/1970,5,0,6,11,22
2/28/1970,8,0,5,6,19
3/1/1970,3,0,3,3,9
3/2/1970,8,0,4,6,18
3/3/1970,8,0,5,1,14
3/4/1970,6,0,2,10,18
3/5/1970,8,0,7,3,18
3/6/1970,8,0,8,13,29
3/7/1970,3,0,8,13,24
3/8/1970,6,0,5,5,16
3/9/1970,6,0,4,2,12
3/10/1970,8,0,6,0,14
3/11/1970,4,0,2,2,8
3/12/1970,8,0,7,11,26
3/13/1970,5,0,6,6,17
3/14/1970,7,0,3,9,19
3/15/1970,4,0,7,13,24
3/16/1970,8,0,6,11,25
3/17/1970,4,0,4,9,17
3/18/1970,2,0,5,8,15
3/19/1970,8,0,4,5,17
3/20/1970,6,0,2,0,8
3/21/1970,3,0,7,0,10
3/22/1970,8,0,4,9,21
3/23/1970,8,0,5,13,26
3/24/1970,5,0,2,13,20
3/25/1970,4,0,5,5,14
3/26/1970,5,0,6,12,23
3/27/1970,3,0,6,13,22
3/28/1970,4,0,5,3,12
3/29/1970,3,0,6,10,19
3/30/1970,7,0,6,5,18
3/31/1970,5,0,3,3,11
4/1/1970,3,0,3,3,9
4/2/1970,4,0,4,8,16
4/3/1970,5,0,7,8,20
4/4/1970,7,0,8,4,19
4/5/1970,8,0,7,7,22
4/6/1970,6,0,2,4,12
4/7/1970,8,0,2,7,17
4/8/1970,8,0,5,11,24
4/9/1970,4,0,5,0,9
4/10/1970,7,0,4,5,16
4/11/1970,3,0,3,6,12
4/12/1970,7,0,8,0,15
4/13/1970,7,0,2,0,9
4/14/1970,8,0,2,12,22
4/15/1970,3,0,8,6,17
4/16/1970,3,0,4,3,10
4/17/1970,5,0,3,7,15
4/18/1970,4,0,4,12,20
4/19/1970,8,0,5,9,22
4/20/1970,2,0,7,3,12
4/21/1970,7,0,4,11,22
4/22/1970,8,0,5,11,24
4/23/1970,8,0,8,0,16
4/24/1970,2,0,5,7,14
4/25/1970,8,0,5,9,22
4/26/1970,3,0,8,12,23
4/27/1970,8,0,5,11,24
4/28/1970,3,0,7,5,15
4/29/1970,6,0,3,7,16
4/30/1970,4,0,2,7,13
5/1/1970,6,0,8,12,26
5/2/1970,4,0,5,2,11
5/3/1970,4,0,2,2,8
5/4/1970,2,0,8,12,22
5/5/1970,5,0,2,13,20
5/6/1970,2,0,7,11,20
5/7/1970,3,0,5,8,16
5/8/1970,2,0,5,0,7
5/9/1970,8,0,7,5,20
5/10/1970,7,0,7,4,18
5/11/1970,2,0,7,13,22
5/12/1970,3,0,8,9,20
5/13/1970,4,0,6,13,23
5/14/1970,7,0,3,9,19
5/15/1970,4,0,5,7,16
5/16/1970,5,0,5,5,15
5/17/1970,7,0,6,10,23
5/18/1970,3,0,8,2,13
5/19/1970,7,0,2,1,10
5/20/1970,2,0,7,13,22
5/21/1970,7,0,3,9,19
5/22/1970,7,0,7,8,22
5/23/1970,8,0,5,5,18
5/24/1970,6,0,2,3,11
5/25/1970,7,0,2,2,11
5/26/1970,7,0,5,1,13
5/27/1970,4,0,2,6,12
5/28/1970,2,0,3,2,7
5/29/1970,4,0,2,10,16
5/30/1970,6,0,4,1,11
5/31/1970,4,0,5,2,11
6/1/1970,3,0,3,10,16
6/2/1970,3,0,2,3,8
6/3/1970,4,0,2,2,8
6/4/1970,8,0,8,12,28
6/5/1970,5,0,6,2,13
6/6/1970,7,0,3,1,11
6/7/1970,8,0,2,0,10
6/8/1970,3,0,6,11,20
6/9/1970,2,0,2,11,15
6/10/1970,6,0,7,10,23
6/11/1970,8,0,6,13,27
6/12/1970,4,0,7,4,15
6/13/1970,2,0,5,10,17
6/14/1970,3,0,3,2,8
6/15/1970,6,0,4,8,18
6/16/1970,6,0,2,8,16
6/17/1970,2,0,5,10,17
6/18/1970,2,0,4,8,14
6/19/1970,8,0,8,13,29
6/20/1970,5,0,8,2,15
6/21/1970,7,0,3,11,21
6/22/1970,7,0,3,2,12
6/23/1970,6,0,4,1,11
6/24/1970,2,0,5,5,12
6/25/1970,5,0,5,5,15
6/26/1970,6,0,4,12,22
6/27/1970,8,0,3,5,16
6/28/1970,8,0,5,11,24
6/29/1970,5,0,3,2,10
6/30/1970,6,0,6,6,18
7/1/1970,6,0,2,2,10
7/2/1970,7,0,7,3,17
7/3/1970,6,0,6,10,22
7/4/1970,5,0,3,2,10
7/5/1970,7,0,2,8,17
7/6/1970,3,0,5,10,18
7/7/1970,8,0,6,8,22
7/8/1970,8,0,6,2,16
7/9/1970,2,0,6,3,11
7/10/1970,7,0,3,0,10
7/11/1970,8,0,3,3,14
7/12/1970,6,0,3,4,13
7/13/1970,6,0,6,9,21
7/14/1970,3,0,6,13,22
7/15/1970,5,0,6,11,22
7/16/1970,2,0,7,12,21
7/17/1970,5,0,8,6,19
7/18/1970,2,0,7,10,19
7/19/1970,5,0,8,6,19
7/20/1970,6,0,3,8,17
7/21/1970,3,0,3,8,14
7/22/1970,3,0,2,0,5
7/23/1970,2,0,2,3,7
7/24/1970,6,0,8,1,15
7/25/1970,5,0,7,2,14
7/26/1970,4,0,5,9,18
7/27/1970,4,0,8,0,12
7/28/1970,7,0,7,9,23
7/29/1970,8,0,2,1,11
7/30/1970,4,0,3,12,19
7/31/1970,2,0,7,7,16
8/1/1970,5,0,2,10,17
8/2/1970,8,0,7,7,22
8/3/1970,6,0,8,4,18
8/4/1970,8,0,3,11,22
8/5/1970,8,0,6,4,18
8/6/1970,4,0,2,11,17
8/7/1970,5,0,4,10,19
8/8/1970,8,0,6,5,19
8/9/1970,6,0,3,7,16
8/10/1970,8,0,2,6,16
8/11/1970,4,0,8,8,20
8/12/1970,7,0,5,5,17
8/13/1970,6,0,6,0,12
8/14/1970,6,0,8,11,25
8/15/1970,8,0,4,11,23
8/16/1970,4,0,2,8,14
8/17/1970,3,0,7,7,17
8/18/1970,7,0,7,7,21
8/19/1970,8,0,6,9,23
8/20/1970,6,0,2,7,15
8/21/1970,6,0,3,5,14
8/22/1970,8,0,7,13,28
8/23/1970,8,0,2,6,16
8/24/1970,5,0,3,2,10
8/25/1970,5,0,4,13,22
8/26/1970,8,0,2,7,17
8/27/1970,4,0,6,8,18
8/28/1970,5,0,8,2,15
8/29/1970,6,0,6,13,25
8/30/1970,2,0,8,4,14
8/31/1970,3,0,4,5,12
9/1/1970,6,0,4,2,12
9/2/1970,7,0,3,7,17
9/3/1970,5,0,4,5,14
9/4/1970,7,0,4,0,11
9/5/1970,7,0,7,1,15
9/6/1970,7,0,7,8,22
9/7/1970,5,0,7,10,22
9/8/1970,2,0,6,5,13
9/9/1970,3,0,5,9,17
9/10/1970,5,0,4,2,11
9/11/1970,4,0,5,10,19
9/12/1970,3,0,6,7,16
9/13/1970,7,0,4,10,21
9/14/1970,4,0,2,1,7
9/15/1970,8,0,3,7,18
9/16/1970,6,0,2,12,20
9/17/1970,7,0,4,7,18
9/18/1970,4,0,8,6,18
9/19/1970,5,0,3,13,21
9/20/1970,7,0,6,12,25
9/21/1970,2,0,8,10,20
9/22/1970,3,0,4,13,20
9/23/1970,5,0,5,0,10
9/24/1970,3,0,3,7,13
9/25/1970,6,0,5,7,18
9/26/1970,3,0,3,8,14
9/27/1970,7,0,6,7,20
9/28/1970,6,0,6,5,17
9/29/1970,5,0,5,0,10
9/30/1970,2,0,4,0,6
10/1/1970,3,0,2,7,12
10/2/1970,5,0,2,7,14
10/3/1970,4,0,6,4,14
10/4/1970,8,0,2,4,14
10/5/1970,7,0,2,9,18
10/6/1970,7,0,5,5,17
10/7/1970,6,0,3,10,19
10/8/1970,7,0,3,5,15
10/9/1970,5,0,6,12,23
10/10/1970,5,0,7,8,20
10/11/1970,3,0,5,2,10
10/12/1970,2,0,4,13,19
10/13/1970,6,0,6,3,15
10/14/1970,8,0,2,12,22
10/15/1970,3,0,2,5,10
10/16/1970,5,0,8,3,16
10/17/1970,6,0,3,0,9
10/18/1970,2,0,5,13,20
10/19/1970,6,0,8,2,16
10/20/1970,6,0,3,1,10
10/21/1970,2,0,8,0,10
10/22/1970,7,0,4,4,15
10/23/1970,4,0,7,7,18
10/24/1970,3,0,3,4,10
10/25/1970,2,0,4,4,10
10/26/1970,3,0,3,10,16
10/27/1970,7,0,4,11,22
10/28/1970,5,0,8,1,14
10/29/1970,2,0,2,9,13
10/30/1970,6,0,3,12,21
10/31/1970,3,0,3,13,19
11/1/1970,7,0,8,11,26
11/2/1970,5,0,8,9,22
11/3/1970,7,0,7,3,17
11/4/1970,2,0,2,9,13
11/5/1970,6,0,6,0,12
11/6/1970,8,0,4,8,20
11/7/1970,3,0,6,3,12
11/8/1970,7,0,7,12,26
11/9/1970,4,0,8,1,13
11/10/1970,8,0,6,12,26
11/11/1970,6,0,8,0,14
11/12/1970,5,0,4,5,14
11/13/1970,4,0,4,3,11
11/14/1970,4,0,7,11,22
11/15/1970,7,0,5,7,19
11/16/1970,5,0,2,9,16
11/17/1970,4,0,5,1,10
11/18/1970,6,0,2,6,14
11/19/1970,4,0,8,4,16
11/20/1970,2,0,6,5,13
11/21/1970,7,0,3,10,20
11/22/1970,2,0,4,13,19
11/23/1970,8,0,3,10,21
11/24/1970,8,0,7,12,27
11/25/1970,7,0,4,7,18
11/26/1970,3,0,8,3,14
11/27/1970,7,0,7,0,14
11/28/1970,3,0,8,7,18
11/29/1970,3,0,8,0,11
11/30/1970,5,0,4,6,15
12/1/1970,6,0,7,0,13
12/2/1970,2,0,5,5,12
12/3/1970,6,0,3,5,14
12/4/1970,8,0,7,5,20
12/5/1970,3,0,3,12,18
12/6/1970,7,0,5,10,22
12/7/1970,5,0,5,1,11
12/8/1970,2,0,7,1,10
12/9/1970,8,0,6,5,19
12/10/1970,8,0,6,13,27
12/11/1970,3,0,2,10,15
12/12/1970,7,0,7,6,20
12/13/1970,4,0,3,13,20
12/14/1970,6,0,2,9,17
12/15/1970,8,0,7,5,20
12/16/1970,2,0,7,4,13
12/17/1970,7,0,4,10,21
12/18/1970,6,0,4,13,23
12/19/1970,7,0,5,7,19
12/20/1970,8,0,6,10,24
12/21/1970,6,0,6,12,24
12/22/1970,6,0,7,4,17
12/23/1970,3,0,5,12,20
12/24/1970,4,0,2,10,16
12/25/1970,3,0,3,11,17
12/26/1970,7,0,6,1,14
12/27/1970,6,0,2,1,9
12/28/1970,3,0,8,4,15
12/29/1970,8,0,4,2,14
12/30/1970,8,0,2,11,21
12/31/1970,5,0,7,7,19
1/1/1971,6,0,5,6,17
1/2/1971,5,0,7,6,18
1/3/1971,5,0,6,5,16
1/4/1971,2,0,6,4,12
1/5/1971,6,0,2,2,10
1/6/1971,7,0,7,1,15
1/7/1971,7,0,3,6,16
1/8/1971,3,0,3,13,19
1/9/1971,7,0,8,1,16
1/10/1971,7,0,2,2,11
1/11/1971,8,0,8,11,27
1/12/1971,7,0,4,8,19
1/13/1971,7,0,6,10,23
1/14/1971,3,0,3,5,11
1/15/1971,5,0,6,0,11
1/16/1971,2,0,7,10,19
1/17/1971,6,0,6,0,12
1/18/1971,7,0,7,6,20
1/19/1971,3,0,4,1,8
1/20/1971,5,0,2,5,12
1/21/1971,5,0,6,13,24
1/22/1971,7,0,8,4,19
1/23/1971,3,0,8,6,17
1/24/1971,3,0,3,13,19
1/25/1971,2,0,3,5,10
1/26/1971,4,0,6,9,19
1/27/1971,4,0,6,9,19
1/28/1971,6,0,6,9,21
1/29/1971,5,0,3,1,9
1/30/1971,7,0,5,8,20
1/31/1971,3,0,3,9,15
2/1/1971,7,0,2,13,22
2/2/1971,8,0,7,6,21
2/3/1971,2,0,4,5,11
2/4/1971,5,0,8,11,24
2/5/1971,2,0,7,10,19
2/6/1971,6,0,3,6,15
2/7/1971,2,0,4,3,9
2/8/1971,3,0,5,7,15
2/9/1971,5,0,4,12,21
2/10/1971,7,0,7,4,18
2/11/1971,5,0,6,9,20
2/12/1971,7,0,4,8,19
2/13/1971,4,0,4,10,18
2/14/1971,8,0,7,10,25
2/15/1971,7,0,5,3,15
2/16/1971,6,0,8,9,23
2/17/1971,6,0,3,5,14
2/18/1971,7,0,3,0,10
2/19/1971,8,0,4,6,18
2/20/1971,7,0,2,11,20
2/21/1971,4,0,3,11,18
2/22/1971,2,0,7,12,21
2/23/1971,8,0,5,8,21
2/24/1971,2,0,5,9,16
2/25/1971,5,0,7,1,13
2/26/1971,3,0,7,10,20
2/27/1971,6,0,2,13,21
2/28/1971,2,0,2,10,14
3/1/1971,4,0,5,10,19
3/2/1971,4,0,8,13,25
3/3/1971,2,0,7,12,21
3/4/1971,7,0,2,8,17
3/5/1971,8,0,8,1,17
3/6/1971,2,0,3,4,9
3/7/1971,4,0,4,8,16
3/8/1971,8,0,8,2,18
3/9/1971,4,0,5,8,17
3/10/1971,5,0,7,4,16
3/11/1971,3,0,8,7,18
3/12/1971,7,0,8,13,28
3/13/1971,4,0,5,1,10
3/14/1971,2,0,7,5,14
3/15/1971,4,0,2,3,9
3/16/1971,5,0,2,9,16
3/17/1971,6,0,4,5,15
3/18/1971,6,0,7,0,13
3/19/1971,3,0,5,12,20
3/20/1971,8,0,3,13,24
3/21/1971,5,0,7,3,15
3/22/1971,7,0,7,1,15
3/23/1971,4,0,4,5,13
3/24/1971,4,0,2,2,8
3/25/1971,3,0,3,8,14
3/26/1971,5,0,2,3,10
3/27/1971,6,0,7,13,26
3/28/1971,5,0,5,10,20
3/29/1971,5,0,8,6,19
3/30/1971,7,0,6,7,20
3/31/1971,6,0,6,12,24
4/1/1971,4,0,8,10,22
4/2/1971,4,0,2,4,10
4/3/1971,7,0,4,3,14
4/4/1971,7,0,5,1,13
4/5/1971,8,0,7,5,20
4/6/1971,4,0,5,4,13
4/7/1971,3,0,4,7,14
4/8/1971,3,0,5,10,18
4/9/1971,4,0,3,11,18
4/10/1971,5,0,4,10,19
4/11/1971,8,0,6,0,14
4/12/1971,7,0,5,0,12
4/13/1971,4,0,4,5,13
4/14/1971,2,0,5,2,9
4/15/1971,4,0,7,13,24
4/16/1971,2,0,5,8,15
4/17/1971,2,0,3,11,16
4/18/1971,4,0,7,5,16
4/19/1971,6,0,2,9,17
4/20/1971,2,0,8,9,19
4/21/1971,2,0,2,2,6
4/22/1971,6,0,7,3,16
4/23/1971,7,0,4,6,17
4/24/1971,6,0,8,6,20
4/25/1971,6,0,5,2,13
4/26/1971,5,0,4,11,20
4/27/1971,7,0,2,2,11
4/28/1971,2,0,2,12,16
4/29/1971,6,0,3,1,10
4/30/1971,5,0,3,0,8
5/1/1971,3,0,5,13,21
5/2/1971,3,0,6,6,15
5/3/1971,7,0,3,13,23
5/4/1971,5,0,8,1,14
5/5/1971,3,0,4,6,13
5/6/1971,3,0,5,12,20
5/7/1971,2,0,2,1,5
5/8/1971,5,0,7,11,23
5/9/1971,2,0,6,8,16
5/10/1971,5,0,5,5,15
5/11/1971,6,0,7,4,17
5/12/1971,5,0,4,2,11
5/13/1971,4,0,3,10,17
5/14/1971,4,0,5,6,15
5/15/1971,7,0,7,4,18
5/16/1971,7,0,8,1,16
5/17/1971,5,0,4,11,20
5/18/1971,7,0,7,6,20
5/19/1971,7,0,8,9,24
5/20/1971,3,0,4,9,16
5/21/1971,7,0,3,4,14
5/22/1971,8,0,7,4,19
5/23/1971,5,0,2,10,17
5/24/1971,2,0,8,5,15
5/25/1971,5,0,2,6,13
5/26/1971,7,0,5,0,12
5/27/1971,6,0,3,2,11
5/28/1971,5,0,5,4,14
5/29/1971,4,0,2,5,11
5/30/1971,4,0,5,13,22
5/31/1971,6,0,5,4,15
6/1/1971,4,0,2,12,18
6/2/1971,7,0,5,12,24
6/3/1971,6,0,4,5,15
6/4/1971,7,0,2,7,16
6/5/1971,2,0,7,1,10
6/6/1971,5,0,8,4,17
6/7/1971,3,0,2,11,16
6/8/1971,8,0,3,13,24
6/9/1971,6,0,5,0,11
6/10/1971,2,0,4,7,13
6/11/1971,3,0,4,12,19
6/12/1971,6,0,8,1,15
6/13/1971,8,0,7,2,17
6/14/1971,8,0,8,2,18
6/15/1971,7,0,4,2,13
6/16/1971,3,0,6,9,18
6/17/1971,4,0,8,9,21
6/18/1971,8,0,2,2,12
6/19/1971,7,0,8,1,16
6/20/1971,5,0,6,9,20
6/21/1971,3,0,6,9,18
6/22/1971,5,0,3,4,12
6/23/1971,6,0,3,13,22
6/24/1971,5,0,5,6,16
6/25/1971,5,0,8,3,16
6/26/1971,8,0,7,0,15
6/27/1971,4,0,2,7,13
6/28/1971,2,0,4,3,9
6/29/1971,7,0,8,12,27
6/30/1971,6,0,7,6,19
7/1/1971,4,0,6,5,15
7/2/1971,6,0,6,11,23
7/3/1971,3,0,5,5,13
7/4/1971,7,0,8,6,21
7/5/1971,6,0,7,13,26
7/6/1971,3,0,6,3,12
7/7/1971,7,0,7,1,15
7/8/1971,7,0,8,9,24
7/9/1971,3,0,5,9,17
7/10/1971,7,0,5,0,12
7/11/1971,4,0,7,1,12
7/12/1971,3,0,3,9,15
7/13/1971,6,0,7,10,23
7/14/1971,7,0,6,7,20
7/15/1971,6,0,5,8,19
7/16/1971,4,0,2,4,10
7/17/1971,6,0,7,0,13
7/18/1971,2,0,5,12,19
7/19/1971,6,0,2,2,10
7/20/1971,3,0,3,12,18
7/21/1971,2,0,3,1,6
7/22/1971,7,0,3,12,22
7/23/1971,8,0,8,7,23
7/24/1971,4,0,2,1,7
7/25/1971,3,0,2,12,17
7/26/1971,2,0,4,5,11
7/27/1971,3,0,3,8,14
7/28/1971,8,0,3,5,16
7/29/1971,7,0,5,8,20
7/30/1971,3,0,7,3,13
7/31/1971,2,0,4,9,15
8/1/1971,7,0,8,0,15
8/2/1971,4,0,4,3,11
8/3/1971,3,0,2,10,15
8/4/1971,4,0,8,9,21
8/5/1971,5,0,7,11,23
8/6/1971,4,0,4,10,18
8/7/1971,7,0,5,13,25
8/8/1971,6,0,3,4,13
8/9/1971,4,0,6,13,23
8/10/1971,3,0,2,13,18
8/11/1971,7,0,7,10,24
8/12/1971,7,0,8,11,26
8/13/1971,5,0,7,6,18
8/14/1971,8,0,4,12,24
8/15/1971,8,0,8,4,20
8/16/1971,7,0,7,5,19
8/17/1971,5,0,6,9,20
8/18/1971,7,0,5,10,22
8/19/1971,6,0,3,3,12
8/20/1971,2,0,2,12,16
8/21/1971,3,0,3,5,11
8/22/1971,6,0,6,7,19
8/23/1971,2,0,7,6,15
8/24/1971,4,0,2,12,18
8/25/1971,7,0,6,6,19
8/26/1971,4,0,2,9,15
8/27/1971,6,0,4,1,11
8/28/1971,4,0,4,10,18
8/29/1971,5,0,6,12,23
8/30/1971,2,0,4,10,16
8/31/1971,5,0,6,12,23
9/1/1971,2,0,3,7,12
9/2/1971,4,0,2,3,9
9/3/1971,6,0,7,2,15
9/4/1971,4,0,6,13,23
9/5/1971,8,0,7,2,17
9/6/1971,5,0,4,1,10
9/7/1971,3,0,4,7,14
9/8/1971,4,0,7,11,22
9/9/1971,8,0,3,4,15
9/10/1971,6,0,3,8,17
9/11/1971,8,0,5,4,17
9/12/1971,6,0,6,0,12
9/13/1971,6,0,2,10,18
9/14/1971,4,0,5,8,17
9/15/1971,4,0,3,10,17
9/16/1971,3,0,4,4,11
9/17/1971,6,0,7,4,17
9/18/1971,7,0,3,1,11
9/19/1971,7,0,5,8,20
9/20/1971,3,0,6,9,18
9/21/1971,2,0,7,12,21
9/22/1971,8,0,4,10,22
9/23/1971,3,0,6,10,19
9/24/1971,3,0,8,1,12
9/25/1971,2,0,7,7,16
9/26/1971,5,0,7,11,23
9/27/1971,7,0,5,9,21
9/28/1971,8,0,8,2,18
9/29/1971,5,0,8,6,19
9/30/1971,6,0,5,7,18
10/1/1971,7,0,2,13,22
10/2/1971,8,0,4,6,18
10/3/1971,3,0,3,4,10
10/4/1971,2,0,5,7,14
10/5/1971,2,0,6,10,18
10/6/1971,7,0,8,4,19
10/7/1971,3,0,6,13,22
10/8/1971,4,0,8,2,14
10/9/1971,5,0,5,2,12
10/10/1971,3,0,8,3,14
10/11/1971,3,0,6,7,16
10/12/1971,2,0,5,7,14
10/13/1971,3,0,7,10,20
10/14/1971,4,0,4,13,21
10/15/1971,6,0,5,7,18
10/16/1971,5,0,5,0,10
10/17/1971,5,0,8,10,23
10/18/1971,8,0,5,0,13
10/19/1971,3,0,6,12,21
10/20/1971,4,0,8,12,24
10/21/1971,5,0,4,3,12
10/22/1971,6,0,2,10,18
10/23/1971,4,0,3,10,17
10/24/1971,5,0,6,6,17
10/25/1971,8,0,4,4,16
10/26/1971,7,0,7,10,24
10/27/1971,2,0,8,3,13
10/28/1971,3,0,8,7,18
10/29/1971,2,0,4,8,14
10/30/1971,3,0,8,11,22
10/31/1971,5,0,8,3,16
11/1/1971,6,0,5,12,23
11/2/1971,5,0,3,0,8
11/3/1971,2,0,6,0,8
11/4/1971,7,0,7,6,20
11/5/1971,4,0,4,7,15
11/6/1971,7,0,5,9,21
11/7/1971,4,0,2,2,8
11/8/1971,5,0,8,1,14
11/9/1971,8,0,8,12,28
11/10/1971,8,0,5,11,24
11/11/1971,3,0,2,3,8
11/12/1971,4,0,5,3,12
11/13/1971,5,0,8,3,16
11/14/1971,6,0,7,13,26
11/15/1971,3,0,6,2,11
11/16/1971,4,0,7,5,16
11/17/1971,4,0,4,0,8
11/18/1971,4,0,5,8,17
11/19/1971,3,0,4,4,11
11/20/1971,7,0,7,8,22
11/21/1971,8,0,6,8,22
11/22/1971,8,0,2,7,17
11/23/1971,4,0,8,4,16
11/24/1971,6,0,4,12,22
11/25/1971,3,0,8,9,20
11/26/1971,2,0,6,0,8
11/27/1971,7,0,5,12,24
11/28/1971,8,0,7,4,19
11/29/1971,3,0,5,7,15
11/30/1971,3,0,5,12,20
12/1/1971,2,0,6,2,10
12/2/1971,8,0,4,13,25
12/3/1971,3,0,3,10,16
12/4/1971,5,0,8,4,17
12/5/1971,3,0,3,2,8
12/6/1971,2,0,2,10,14
12/7/1971,2,0,5,12,19
12/8/1971,8,0,6,10,24
12/9/1971,5,0,7,0,12
12/10/1971,8,0,7,12,27
12/11/1971,8,0,7,5,20
12/12/1971,7,0,4,7,18
12/13/1971,5,0,2,11,18
12/14/1971,7,0,4,5,16
12/15/1971,3,0,4,5,12
12/16/1971,7,0,4,0,11
12/17/1971,4,0,7,1,12
12/18/1971,5,0,3,7,15
12/19/1971,2,0,3,0,5
12/20/1971,4,0,4,0,8
12/21/1971,6,0,5,7,18
12/22/1971,5,0,8,1,14
12/23/1971,4,0,8,11,23
12/24/1971,7,0,5,5,17
12/25/1971,8,0,4,10,22
12/26/1971,4,0,4,8,16
12/27/1971,8,0,8,11,27
12/28/1971,6,0,6,0,12
12/29/1971,3,0,7,11,21
12/30/1971,4,0,6,10,20
12/31/1971,6,0,8,2,16
1/1/1972,6,0,6,3,15
1/2/1972,6,0,2,1,9
1/3/1972,5,0,4,7,16
1/4/1972,2,0,3,1,6
1/5/1972,8,0,4,6,18
1/6/1972,7,0,6,7,20
1/7/1972,7,0,8,3,18
1/8/1972,4,0,2,7,13
1/9/1972,7,0,2,8,17
1/10/1972,2,0,4,6,12
1/11/1972,5,0,8,4,17
1/12/1972,2,0,2,6,10
1/13/1972,3,0,5,12,20
1/14/1972,5,0,8,7,20
1/15/1972,2,0,6,13,21
1/16/1972,6,0,8,0,14
1/17/1972,4,0,7,5,16
1/18/1972,4,0,3,13,20
1/19/1972,8,0,2,4,14
1/20/1972,5,0,3,7,15
1/21/1972,5,0,4,11,20
1/22/1972,3,0,6,8,17
1/23/1972,6,0,6,7,19
1/24/1972,3,0,2,10,15
1/25/1972,7,0,7,3,17
1/26/1972,4,0,2,11,17
1/27/1972,5,0,6,3,14
1/28/1972,5,0,6,12,23
1/29/1972,3,0,5,2,10
1/30/1972,5,0,2,9,16
1/31/1972,5,0,6,10,21
2/1/1972,2,0,7,4,13
2/2/1972,2,0,5,2,9
2/3/1972,4,0,5,3,12
2/4/1972,8,0,5,8,21
2/5/1972,4,0,3,7,14
2/6/1972,8,0,5,10,23
2/7/1972,4,0,4,2,10
2/8/1972,2,0,4,10,16
2/9/1972,2,0,8,13,23
2/10/1972,3,0,2,3,8
2/11/1972,2,0,5,4,11
2/12/1972,6,0,7,10,23
2/13/1972,3,0,6,4,13
2/14/1972,3,0,7,9,19
2/15/1972,7,0,8,2,17
2/16/1972,3,0,5,5,13
2/17/1972,3,0,6,10,19
2/18/1972,8,0,8,13,29
2/19/1972,7,0,4,13,24
2/20/1972,6,0,4,2,12
2/21/1972,2,0,7,5,14
2/22/1972,3,0,5,4,12
2/23/1972,7,0,6,4,17
2/24/1972,4,0,5,8,17
2/25/1972,2,0,2,5,9
2/26/1972,7,0,4,11,22
2/27/1972,3,0,4,12,19
2/28/1972,6,0,5,11,22
2/29/1972,2,0,5,9,16
3/1/1972,4,0,4,10,18
3/2/1972,2,0,7,12,21
3/3/1972,8,0,4,2,14
3/4/1972,5,0,7,9,21
3/5/1972,2,0,5,7,14
3/6/1972,4,0,4,5,13
3/7/1972,2,0,3,0,5
3/8/1972,8,0,2,6,16
3/9/1972,6,0,2,8,16
3/10/1972,2,0,7,13,22
3/11/1972,8,0,7,10,25
3/12/1972,8,0,3,8,19
3/13/1972,2,0,6,5,13
3/14/1972,8,0,6,0,14
3/15/1972,4,0,6,12,22
3/16/1972,4,0,2,13,19
3/17/1972,6,0,7,1,14
3/18/1972,5,0,3,9,17
3/19/1972,7,0,4,10,21
3/20/1972,4,0,5,10,19
3/21/1972,7,0,3,10,20
3/22/1972,5,0,2,0,7
3/23/1972,6,0,6,4,16
3/24/1972,2,0,5,9,16
3/25/1972,3,0,2,10,15
3/26/1972,2,0,7,10,19
3/27/1972,3,0,2,4,9
3/28/1972,7,0,8,0,15
3/29/1972,4,0,7,13,24
3/30/1972,2,0,5,9,16
3/31/1972,4,0,3,8,15
4/1/1972,8,0,4,7,19
4/2/1972,3,0,6,4,13
4/3/1972,7,0,5,3,15
4/4/1972,6,0,4,8,18
4/5/1972,2,0,6,3,11
4/6/1972,8,0,6,3,17
4/7/1972,8,0,7,0,15
4/8/1972,2,0,4,7,13
4/9/1972,6,0,4,4,14
4/10/1972,2,0,7,4,13
4/11/1972,4,0,4,1,9
4/12/1972,7,0,7,13,27
4/13/1972,8,0,6,0,14
4/14/1972,8,0,2,6,16
4/15/1972,5,0,7,8,20
4/16/1972,8,0,6,10,24
4/17/1972,3,0,4,3,10
4/18/1972,3,0,8,9,20
4/19/1972,6,0,5,10,21
4/20/1972,3,0,7,0,10
4/21/1972,7,0,2,8,17
4/22/1972,4,0,8,3,15
4/23/1972,6,0,8,0,14
4/24/1972,3,0,6,8,17
4/25/1972,3,0,8,2,13
4/26/1972,8,0,5,4,17
4/27/1972,5,0,5,0,10
4/28/1972,4,0,8,10,22
4/29/1972,7,0,6,12,25
4/30/1972,2,0,6,13,21
5/1/1972,4,0,8,10,22
5/2/1972,7,0,4,12,23
5/3/1972,4,0,5,4,13
5/4/1972,3,0,7,10,20
5/5/1972,8,0,7,0,15
5/6/1972,4,0,4,3,11
5/7/1972,5,0,2,9,16
5/8/1972,6,0,3,5,14
5/9/1972,5,0,6,12,23
5/10/1972,4,0,7,7,18
5/11/1972,8,0,8,7,23
5/12/1972,4,0,7,8,19
5/13/1972,2,0,5,11,18
5/14/1972,6,0,6,6,18
5/15/1972,7,0,3,5,15
5/16/1972,2,0,6,6,14
5/17/1972,6,0,7,3,16
5/18/1972,4,0,7,4,15
5/19/1972,7,0,2,9,18
5/20/1972,6,0,7,13,26
5/21/1972,6,0,2,12,20
5/22/1972,8,0,5,9,22
5/23/1972,5,0,3,4,12
5/24/1972,3,0,2,11,16
5/25/1972,3,0,2,1,6
5/26/1972,4,0,6,4,14
5/27/1972,3,0,6,5,14
5/28/1972,8,0,6,7,21
5/29/1972,5,0,2,3,10
5/30/1972,4,0,4,1,9
5/31/1972,5,0,2,4,11
6/1/1972,6,0,2,9,17
6/2/1972,2,0,8,0,10
6/3/1972,4,0,5,9,18
6/4/1972,6,0,4,1,11
6/5/1972,5,0,6,9,20
6/6/1972,7,0,4,12,23
6/7/1972,6,0,2,8,16
6/8/1972,6,0,6,7,19
6/9/1972,4,0,7,5,16
6/10/1972,5,0,4,10,19
6/11/1972,3,0,2,4,9
6/12/1972,7,0,7,3,17
6/13/1972,5,0,5,10,20
6/14/1972,3,0,7,5,15
6/15/1972,4,0,5,12,21
6/16/1972,6,0,6,9,21
6/17/1972,6,0,8,1,15
6/18/1972,7,0,7,7,21
6/19/1972,3,0,8,7,18
6/20/1972,8,0,3,10,21
6/21/1972,4,0,2,9,15
6/22/1972,7,0,5,10,22
6/23/1972,7,0,8,4,19
6/24/1972,6,0,2,5,13
6/25/1972,6,0,6,3,15
6/26/1972,3,0,5,12,20
6/27/1972,2,0,4,0,6
6/28/1972,8,0,8,2,18
6/29/1972,5,0,3,2,10
6/30/1972,2,0,7,8,17
7/1/1972,7,0,3,12,22
7/2/1972,3,0,7,5,15
7/3/1972,3,0,8,7,18
7/4/1972,5,0,2,7,14
7/5/1972,2,0,2,7,11
7/6/1972,8,0,6,13,27
7/7/1972,4,0,5,0,9
7/8/1972,5,0,6,3,14
7/9/1972,5,0,6,9,20
7/10/1972,4,0,4,10,18
7/11/1972,5,0,6,1,12
7/12/1972,8,0,4,8,20
7/13/1972,6,0,4,0,10
7/14/1972,8,0,2,11,21
7/15/1972,6,0,7,6,19
7/16/1972,6,0,6,8,20
7/17/1972,3,0,3,9,15
7/18/1972,5,0,7,0,12
7/19/1972,6,0,4,10,20
7/20/1972,3,0,3,1,7
7/21/1972,2,0,2,3,7
7/22/1972,6,0,4,0,10
7/23/1972,8,0,2,7,17
7/24/1972,6,0,3,5,14
7/25/1972,2,0,2,9,13
7/26/1972,5,0,5,12,22
7/27/1972,3,0,7,5,15
7/28/1972,3,0,5,8,16
7/29/1972,3,0,7,12,22
7/30/1972,4,0,2,12,18
7/31/1972,6,0,8,3,17
8/1/1972,2,0,8,7,17
8/2/1972,6,0,7,8,21
8/3/1972,5,0,4,3,12
8/4/1972,3,0,7,8,18
8/5/1972,5,0,7,10,22
8/6/1972,8,0,8,10,26
8/7/1972,6,0,4,13,23
8/8/1972,6,0,7,11,24
8/9/1972,7,0,8,3,18
8/10/1972,8,0,3,5,16
8/11/1972,2,0,7,3,12
8/12/1972,5,0,5,4,14
8/13/1972,2,0,5,8,15
8/14/1972,2,0,2,6,10
8/15/1972,2,0,7,5,14
8/16/1972,4,0,6,10,20
8/17/1972,8,0,4,11,23
8/18/1972,6,0,6,2,14
8/19/1972,3,0,6,4,13
8/20/1972,7,0,4,1,12
8/21/1972,4,0,6,2,12
8/22/1972,7,0,7,11,25
8/23/1972,5,0,5,13,23
8/24/1972,8,0,7,6,21
8/25/1972,4,0,3,5,12
8/26/1972,6,0,8,7,21
8/27/1972,4,0,5,2,11
8/28/1972,7,0,3,13,23
8/29/1972,5,0,6,3,14
8/30/1972,8,0,2,2,12
8/31/1972,7,0,2,7,16
9/1/1972,6,0,7,6,19
9/2/1972,4,0,7,2,13
9/3/1972,8,0,7,1,16
9/4/1972,6,0,3,7,16
9/5/1972,7,0,5,12,24
9/6/1972,7,0,7,13,27
9/7/1972,6,0,8,10,24
9/8/1972,2,0,8,1,11
9/9/1972,6,0,4,1,11
9/10/1972,7,0,6,2,15
9/11/1972,5,0,5,7,17
9/12/1972,7,0,5,12,24
9/13/1972,3,0,6,12,21
9/14/1972,8,0,4,11,23
9/15/1972,6,0,7,9,22
9/16/1972,4,0,6,5,15
9/17/1972,7,0,3,10,20
9/18/1972,2,0,3,7,12
9/19/1972,3,0,2,7,12
9/20/1972,5,0,6,13,24
9/21/1972,6,0,7,3,16
9/22/1972,3,0,6,8,17
9/23/1972,2,0,7,5,14
9/24/1972,7,0,3,7,17
9/25/1972,8,0,7,7,22
9/26/1972,8,0,8,1,17
9/27/1972,5,0,4,4,13
9/28/1972,2,0,6,11,19
9/29/1972,5,0,5,9,19
9/30/1972,8,0,5,4,17
10/1/1972,8,0,5,4,17
10/2/1972,3,0,6,7,16
10/3/1972,7,0,4,8,19
10/4/1972,3,0,5,4,12
10/5/1972,8,0,3,9,20
10/6/1972,4,0,5,11,20
10/7/1972,5,0,5,13,23
10/8/1972,5,0,8,9,22
10/9/1972,2,0,6,0,8
10/10/1972,8,0,3,5,16
10/11/1972,8,0,8,8,24
10/12/1972,7,0,5,10,22
10/13/1972,8,0,4,11,23
10/14/1972,2,0,4,13,19
10/15/1972,5,0,7,6,18
10/16/1972,3,0,6,11,20
10/17/1972,5,0,5,4,14
10/18/1972,8,0,3,11,22
10/19/1972,3,0,5,5,13
10/20/1972,6,0,3,4,13
10/21/1972,3,0,5,13,21
10/22/1972,2,0,4,10,16
10/23/1972,5,0,4,3,12
10/24/1972,8,0,4,5,17
10/25/1972,8,0,5,5,18
10/26/1972,4,0,2,11,17
10/27/1972,3,0,6,3,12
10/28/1972,5,0,5,0,10
10/29/1972,4,0,2,1,7
10/30/1972,2,0,3,9,14
10/31/1972,4,0,6,12,22
11/1/1972,7,0,5,6,18
11/2/1972,6,0,6,9,21
11/3/1972,8,0,4,2,14
11/4/1972,8,0,5,12,25
11/5/1972,3,0,5,11,19
11/6/1972,2,0,5,12,19
11/7/1972,5,0,6,2,13
11/8/1972,8,0,2,7,17
11/9/1972,6,0,2,5,13
11/10/1972,3,0,6,12,21
11/11/1972,8,0,7,1,16
11/12/1972,4,0,6,6,16
11/13/1972,2,0,8,2,12
11/14/1972,7,0,2,8,17
11/15/1972,3,0,8,9,20
11/16/1972,6,0,2,0,8
11/17/1972,8,0,2,3,13
11/18/1972,5,0,6,6,17
11/19/1972,5,0,6,11,22
11/20/1972,4,0,3,8,15
11/21/1972,3,0,8,0,11
11/22/1972,4,0,7,0,11
11/23/1972,6,0,5,9,20
11/24/1972,7,0,6,12,25
11/25/1972,4,0,5,8,17
11/26/1972,8,0,6,5,19
11/27/1972,7,0,4,9,20
11/28/1972,8,0,8,4,20
11/29/1972,4,0,6,13,23
11/30/1972,2,0,4,6,12
12/1/1972,3,0,7,13,23
12/2/1972,5,0,8,1,14
12/3/1972,8,0,5,11,24
12/4/1972,7,0,5,3,15
12/5/1972,5,0,2,13,20
12/6/1972,6,0,3,3,12
12/7/1972,7,0,2,10,19
12/8/1972,7,0,2,3,12
12/9/1972,6,0,6,5,17
12/10/1972,6,0,8,1,15
12/11/1972,6,0,3,11,20
12/12/1972,5,0,7,11,23
12/13/1972,2,0,3,2,7
12/14/1972,5,0,5,9,19
12/15/1972,5,0,8,8,21
12/16/1972,6,0,3,3,12
12/17/1972,5,0,5,0,10
12/18/1972,4,0,4,9,17
12/19/1972,6,0,2,7,15
12/20/1972,3,0,4,11,18
12/21/1972,7,0,3,2,12
12/22/1972,4,0,3,8,15
12/23/1972,7,0,7,7,21
12/24/1972,6,0,8,0,14
12/25/1972,4,0,7,2,13
12/26/1972,4,0,5,4,13
12/27/1972,7,0,7,4,18
12/28/1972,5,0,3,7,15
12/29/1972,3,0,7,1,11
12/30/1972,6,0,8,10,24
12/31/1972,7,0,4,1,12
1/1/1973,7,0,6,5,18
1/2/1973,8,0,3,2,13
1/3/1973,5,0,7,11,23
1/4/1973,8,0,4,5,17
1/5/1973,4,0,8,12,24
1/6/1973,6,0,2,13,21
1/7/1973,2,0,2,3,7
1/8/1973,5,0,6,6,17
1/9/1973,6,0,4,8,18
1/10/1973,4,0,5,9,18
1/11/1973,5,0,6,11,22
1/12/1973,4,0,7,3,14
1/13/1973,6,0,3,3,12
1/14/1973,4,0,2,6,12
1/15/1973,2,0,5,1,8
1/16/1973,7,0,7,1,15
1/17/1973,8,0,8,4,20
1/18/1973,7,0,5,10,22
1/19/1973,7,0,3,5,15
1/20/1973,2,0,8,4,14
1/21/1973,3,0,8,0,11
1/22/1973,8,0,2,13,23
1/23/1973,6,0,2,2,10
1/24/1973,3,0,7,6,16
1/25/1973,7,0,3,5,15
1/26/1973,5,0,8,12,25
1/27/1973,8,0,2,10,20
1/28/1973,8,0,6,3,17
1/29/1973,3,0,3,4,10
1/30/1973,6,0,6,1,13
1/31/1973,6,0,7,11,24
2/1/1973,6,0,7,8,21
2/2/1973,2,0,8,13,23
2/3/1973,7,0,8,13,28
2/4/1973,2,0,4,4,10
2/5/1973,7,0,8,13,28
2/6/1973,6,0,7,0,13
2/7/1973,2,0,8,0,10
2/8/1973,8,0,4,11,23
2/9/1973,3,0,5,11,19
2/10/1973,5,0,3,6,14
2/11/1973,8,0,8,0,16
2/12/1973,5,0,4,3,12
2/13/1973,3,0,7,6,16
2/14/1973,7,0,5,0,12
2/15/1973,7,0,2,6,15
2/16/1973,3,0,7,8,18
2/17/1973,3,0,8,0,11
2/18/1973,2,0,5,10,17
2/19/1973,8,0,6,10,24
2/20/1973,5,0,8,10,23
2/21/1973,7,0,8,0,15
2/22/1973,5,0,2,11,18
2/23/1973,3,0,4,0,7
2/24/1973,4,0,6,9,19
2/25/1973,5,0,7,10,22
2/26/1973,5,0,2,3,10
2/27/1973,5,0,5,3,13
2/28/1973,4,0,2,8,14
3/1/1973,6,0,7,8,21
3/2/1973,7,0,5,12,24
3/3/1973,7,0,8,12,27
3/4/1973,5,0,7,3,15
3/5/1973,4,0,6,7,17
3/6/1973,4,0,6,12,22
3/7/1973,3,0,5,4,12
3/8/1973,6,0,2,7,15
3/9/1973,3,0,5,10,18
3/10/1973,2,0,2,3,7
3/11/1973,6,0,3,6,15
3/12/1973,4,0,3,10,17
3/13/1973,6,0,8,5,19
3/14/1973,7,0,6,2,15
3/15/1973,6,0,5,8,19
3/16/1973,7,0,3,8,18
3/17/1973,2,0,8,8,18
3/18/1973,6,0,8,7,21
3/19/1973,3,0,8,4,15
3/20/1973,6,0,4,7,17
3/21/1973,2,0,4,1,7
3/22/1973,3,0,7,3,13
3/23/1973,3,0,4,7,14
3/24/1973,4,0,5,1,10
3/25/1973,6,0,4,4,14
3/26/1973,8,0,7,11,26
3/27/1973,3,0,6,1,10
3/28/1973,3,0,5,2,10
3/29/1973,5,0,6,5,16
3/30/1973,4,0,2,2,8
3/31/1973,8,0,5,3,16
4/1/1973,7,0,5,1,13
4/2/1973,8,0,5,11,24
4/3/1973,6,0,8,5,19
4/4/1973,5,0,8,5,18
4/5/1973,3,0,8,13,24
4/6/1973,4,0,7,2,13
4/7/1973,8,0,2,6,16
4/8/1973,7,0,6,4,17
4/9/1973,8,0,8,1,17
4/10/1973,7,0,6,9,22
4/11/1973,3,0,4,8,15
4/12/1973,7,0,6,12,25
4/13/1973,2,0,2,11,15
4/14/1973,2,0,6,8,16
4/15/1973,5,0,2,9,16
4/16/1973,3,0,7,3,13
4/17/1973,8,0,5,2,15
4/18/1973,8,0,4,9,21
4/19/1973,4,0,3,3,10
4/20/1973,5,0,4,9,18
4/21/1973,7,0,4,9,20
4/22/1973,4,0,7,10,21
4/23/1973,5,0,4,2,11
4/24/1973,6,0,3,7,16
4/25/1973,2,0,2,11,15
4/26/1973,2,0,7,6,15
4/27/1973,8,0,8,7,23
4/28/1973,3,0,8,13,24
4/29/1973,6,0,3,10,19
4/30/1973,6,0,2,2,10
5/1/1973,8,0,4,5,17
5/2/1973,3,0,6,2,11
5/3/1973,3,0,3,0,6
5/4/1973,3,0,6,8,17
5/5/1973,5,0,2,0,7
5/6/1973,7,0,2,8,17
5/7/1973,3,0,7,4,14
5/8/1973,6,0,3,8,17
5/9/1973,3,0,5,10,18
5/10/1973,4,0,4,8,16
5/11/1973,3,0,5,13,21
5/12/1973,8,0,5,12,25
5/13/1973,2,0,4,3,9
5/14/1973,7,0,8,9,24
5/15/1973,8,0,7,13,28
5/16/1973,6,0,8,7,21
5/17/1973,8,0,8,11,27
5/18/1973,5,0,4,3,12
5/19/1973,3,0,5,2,10
5/20/1973,5,0,4,9,18
5/21/1973,2,0,5,5,12
5/22/1973,7,0,4,5,16
5/23/1973,6,0,6,1,13
5/24/1973,4,0,7,0,11
5/25/1973,8,0,7,10,25
5/26/1973,5,0,3,0,8
5/27/1973,2,0,8,6,16
5/28/1973,6,0,3,3,12
5/29/1973,4,0,3,11,18
5/30/1973,3,0,8,5,16
5/31/1973,6,0,8,1,15
6/1/1973,5,0,6,1,12
6/2/1973,5,0,6,4,15
6/3/1973,7,0,3,6,16
6/4/1973,3,0,8,11,22
6/5/1973,4,0,6,9,19
6/6/1973,6,0,5,7,18
6/7/1973,2,0,6,3,11
6/8/1973,3,0,7,10,20
6/9/1973,7,0,3,0,10
6/10/1973,3,0,7,2,12
6/11/1973,6,0,4,5,15
6/12/1973,3,0,7,4,14
6/13/1973,8,0,6,0,14
6/14/1973,2,0,5,4,11
6/15/1973,2,0,7,6,15
6/16/1973,2,0,3,12,17
6/17/1973,8,0,3,13,24
6/18/1973,6,0,5,2,13
6/19/1973,4,0,4,12,20
6/20/1973,6,0,7,6,19
6/21/1973,3,0,6,1,10
6/22/1973,5,0,8,6,19
6/23/1973,6,0,5,0,11
6/24/1973,2,0,4,4,10
6/25/1973,4,0,6,13,23
6/26/1973,2,0,5,11,18
6/27/1973,2,0,5,9,16
6/28/1973,6,0,5,8,19
6/29/1973,3,0,8,4,15
6/30/1973,6,0,4,13,23
7/1/1973,2,0,7,5,14
7/2/1973,3,0,7,3,13
7/3/1973,5,0,6,2,13
7/4/1973,8,0,7,0,15
7/5/1973,2,0,4,7,13
7/6/1973,3,0,8,7,18
7/7/1973,4,0,2,2,8
7/8/1973,8,0,8,10,26
7/9/1973,4,0,4,3,11
7/10/1973,7,0,4,1,12
7/11/1973,8,0,5,0,13
7/12/1973,4,0,4,9,17
7/13/1973,4,0,4,11,19
7/14/1973,5,0,4,1,10
7/15/1973,2,0,4,4,10
7/16/1973,6,0,2,10,18
7/17/1973,5,0,3,12,20
7/18/1973,6,0,7,0,13
7/19/1973,2,0,3,9,14
7/20/1973,4,0,7,4,15
7/21/1973,4,0,7,2,13
7/22/1973,5,0,7,4,16
7/23/1973,4,0,2,7,13
7/24/1973,2,0,6,1,9
7/25/1973,2,0,3,8,13
7/26/1973,2,0,7,10,19
7/27/1973,3,0,6,4,13
7/28/1973,4,0,4,0,8
7/29/1973,3,0,3,5,11
7/30/1973,7,0,7,4,18
7/31/1973,8,0,6,0,14
8/1/1973,4,0,4,5,13
8/2/1973,2,0,2,13,17
8/3/1973,7,0,6,0,13
8/4/1973,3,0,2,9,14
8/5/1973,4,0,5,1,10
8/6/1973,6,0,7,13,26
8/7/1973,8,0,4,8,20
8/8/1973,8,0,4,8,20
8/9/1973,5,0,8,6,19
8/10/1973,2,0,8,4,14
8/11/1973,7,0,8,0,15
8/12/1973,2,0,7,11,20
8/13/1973,7,0,3,12,22
8/14/1973,3,0,4,1,8
8/15/1973,4,0,7,0,11
8/16/1973,2,0,7,6,15
8/17/1973,4,0,4,7,15
8/18/1973,6,0,6,3,15
8/19/1973,8,0,2,10,20
8/20/1973,3,0,7,0,10
8/21/1973,2,0,8,9,19
8/22/1973,5,0,8,9,22
8/23/1973,5,0,8,10,23
8/24/1973,2,0,5,8,15
8/25/1973,6,0,2,3,11
8/26/1973,7,0,6,13,26
8/27/1973,4,0,5,13,22
8/28/1973,3,0,3,2,8
8/29/1973,8,0,8,5,21
8/30/1973,2,0,4,10,16
8/31/1973,8,0,6,3,17
9/1/1973,5,0,8,11,24
9/2/1973,3,0,8,9,20
9/3/1973,8,0,5,11,24
9/4/1973,6,0,2,13,21
9/5/1973,5,0,7,1,13
9/6/1973,6,0,3,10,19
9/7/1973,2,0,7,12,21
9/8/1973,8,0,3,0,11
9/9/1973,3,0,3,1,7
9/10/1973,8,0,4,1,13
9/11/1973,2,0,8,12,22
9/12/1973,8,0,6,1,15
9/13/1973,7,0,6,10,23
9/14/1973,7,0,3,5,15
9/15/1973,5,0,6,8,19
9/16/1973,3,0,7,10,20
9/17/1973,7,0,6,1,14
9/18/1973,7,0,3,4,14
9/19/1973,6,0,4,3,13
9/20/1973,5,0,4,3,12
9/21/1973,6,0,6,8,20
9/22/1973,7,0,5,5,17
9/23/1973,7,0,6,8,21
9/24/1973,4,0,3,9,16
9/25/1973,2,0,5,11,18
9/26/1973,5,0,4,3,12
9/27/1973,3,0,7,6,16
9/28/1973,6,0,2,6,14
9/29/1973,7,0,3,6,16
9/30/1973,8,0,6,13,27
10/1/1973,2,0,7,4,13
10/2/1973,2,0,4,7,13
10/3/1973,7,0,7,5,19
10/4/1973,4,0,5,8,17
10/5/1973,5,0,7,12,24
10/6/1973,3,0,6,6,15
10/7/1973,4,0,8,11,23
10/8/1973,6,0,4,1,11
10/9/1973,8,0,6,9,23
10/10/1973,7,0,3,8,18
10/11/1973,4,0,8,7,19
10/12/1973,3,0,5,9,17
10/13/1973,7,0,8,4,19
10/14/1973,3,0,6,13,22
10/15/1973,5,0,8,0,13
10/16/1973,2,0,6,5,13
10/17/1973,3,0,2,7,12
10/18/1973,6,0,6,1,13
10/19/1973,4,0,5,8,17
10/20/1973,3,0,7,7,17
10/21/1973,3,0,8,4,15
10/22/1973,8,0,2,3,13
10/23/1973,7,0,2,2,11
10/24/1973,6,0,6,1,13
10/25/1973,6,0,7,9,22
10/26/1973,2,0,8,2,12
10/27/1973,4,0,2,5,11
10/28/1973,4,0,3,2,9
10/29/1973,3,0,5,10,18
10/30/1973,8,0,6,6,20
10/31/1973,3,0,3,10,16
11/1/1973,4,0,8,3,15
11/2/1973,4,0,3,11,18
11/3/1973,7,0,7,2,16
11/4/1973,5,0,6,0,11
11/5/1973,6,0,6,12,24
11/6/1973,6,0,7,12,25
11/7/1973,4,0,2,12,18
11/8/1973,7,0,6,8,21
11/9/1973,3,0,8,1,12
11/10/1973,6,0,6,9,21
11/11/1973,4,0,7,2,13
11/12/1973,8,0,3,13,24
11/13/1973,4,0,7,13,24
11/14/1973,4,0,4,1,9
11/15/1973,5,0,5,5,15
11/16/1973,7,0,3,6,16
11/17/1973,6,0,7,2,15
11/18/1973,6,0,7,12,25
11/19/1973,3,0,3,9,15
11/20/1973,7,0,6,3,16
11/21/1973,5,0,5,7,17
11/22/1973,8,0,3,12,23
11/23/1973,6,0,8,12,26
11/24/1973,2,0,3,1,6
11/25/1973,7,0,7,7,21
11/26/1973,4,0,3,6,13
11/27/1973,5,0,5,3,13
11/28/1973,6,0,6,4,16
11/29/1973,2,0,5,0,7
11/30/1973,7,0,2,4,13
12/1/1973,6,0,5,10,21
12/2/1973,7,0,8,13,28
12/3/1973,2,0,5,13,20
12/4/1973,7,0,8,8,23
12/5/1973,6,0,6,1,13
12/6/1973,2,0,2,7,11
12/7/1973,2,0,6,5,13
12/8/1973,5,0,8,0,13
12/9/1973,8,0,8,9,25
12/10/1973,2,0,5,2,9
12/11/1973,6,0,5,11,22
12/12/1973,7,0,4,4,15
12/13/1973,2,0,3,10,15
12/14/1973,5,0,4,11,20
12/15/1973,7,0,6,5,18
12/16/1973,2,0,3,6,11
12/17/1973,7,0,7,0,14
12/18/1973,2,0,2,5,9
12/19/1973,8,0,2,8,18
12/20/1973,7,0,8,11,26
12/21/1973,8,0,2,9,19
12/22/1973,5,0,5,3,13
12/23/1973,5,0,2,2,9
12/24/1973,6,0,7,10,23
12/25/1973,2,0,3,2,7
12/26/1973,3,0,5,9,17
12/27/1973,2,0,8,6,16
12/28/1973,7,0,7,0,14
12/29/1973,3,0,5,12,20
12/30/1973,3,0,2,13,18
12/31/1973,6,0,2,5,13
1/1/1974,6,0,2,1,9
1/2/1974,7,0,3,6,16
1/3/1974,6,0,7,7,20
1/4/1974,7,0,2,13,22
1/5/1974,5,0,7,5,17
1/6/1974,3,0,6,12,21
1/7/1974,2,0,2,9,13
1/8/1974,3,0,5,10,18
1/9/1974,4,0,3,4,11
1/10/1974,5,0,2,10,17
1/11/1974,4,0,2,4,10
1/12/1974,8,0,6,7,21
1/13/1974,6,0,7,13,26
1/14/1974,8,0,6,13,27
1/15/1974,7,0,4,9,20
1/16/1974,3,0,5,6,14
1/17/1974,5,0,7,1,13
1/18/1974,8,0,2,10,20
1/19/1974,3,0,8,5,16
1/20/1974,5,0,2,10,17
1/21/1974,4,0,5,10,19
1/22/1974,2,0,4,7,13
1/23/1974,4,0,8,12,24
1/24/1974,6,0,6,12,24
1/25/1974,2,0,4,7,13
1/26/1974,6,0,8,9,23
1/27/1974,6,0,3,1,10
1/28/1974,4,0,2,11,17
1/29/1974,4,0,3,10,17
1/30/1974,5,0,3,1,9
1/31/1974,8,0,2,5,15
2/1/1974,7,0,5,2,14
2/2/1974,3,0,6,13,22
2/3/1974,5,0,8,5,18
2/4/1974,6,0,6,2,14
2/5/1974,7,0,6,10,23
2/6/1974,7,0,5,6,18
2/7/1974,7,0,8,7,22
2/8/1974,4,0,8,0,12
2/9/1974,5,0,3,5,13
2/10/1974,8,0,3,9,20
2/11/1974,4,0,8,1,13
2/12/1974,2,0,5,0,7
2/13/1974,4,0,6,8,18
2/14/1974,7,0,4,1,12
2/15/1974,3,0,4,2,9
2/16/1974,5,0,3,1,9
2/17/1974,4,0,7,10,21
2/18/1974,7,0,3,13,23
2/19/1974,3,0,2,5,10
2/20/1974,2,0,5,7,14
2/21/1974,6,0,2,9,17
2/22/1974,7,0,7,11,25
2/23/1974,5,0,3,12,20
2/24/1974,8,0,4,0,12
2/25/1974,5,0,2,1,8
2/26/1974,4,0,5,8,17
2/27/1974,3,0,5,5,13
2/28/1974,2,0,5,11,18
3/1/1974,3,0,3,0,6
3/2/1974,6,0,3,5,14
3/3/1974,5,0,7,10,22
3/4/1974,7,0,8,2,17
3/5/1974,5,0,8,11,24
3/6/1974,3,0,7,1,11
3/7/1974,6,0,4,0,10
3/8/1974,4,0,7,12,23
3/9/1974,8,0,6,10,24
3/10/1974,8,0,2,9,19
3/11/1974,5,0,5,4,14
3/12/1974,2,0,8,12,22
3/13/1974,2,0,7,9,18
3/14/1974,4,0,3,6,13
3/15/1974,5,0,4,2,11
3/16/1974,5,0,4,7,16
3/17/1974,3,0,3,6,12
3/18/1974,2,0,6,10,18
3/19/1974,4,0,2,13,19
3/20/1974,5,0,3,10,18
3/21/1974,7,0,3,4,14
3/22/1974,2,0,5,12,19
3/23/1974,7,0,3,1,11
3/24/1974,6,0,5,8,19
3/25/1974,7,0,8,6,21
3/26/1974,3,0,2,10,15
3/27/1974,8,0,2,11,21
3/28/1974,4,0,5,13,22
3/29/1974,7,0,6,2,15
3/30/1974,5,0,6,11,22
3/31/1974,7,0,2,12,21
4/1/1974,8,0,5,0,13
4/2/1974,8,0,8,10,26
4/3/1974,8,0,6,11,25
4/4/1974,8,0,2,9,19
4/5/1974,3,0,2,10,15
4/6/1974,4,0,6,5,15
4/7/1974,8,0,5,9,22
4/8/1974,6,0,7,8,21
4/9/1974,5,0,7,7,19
4/10/1974,5,0,8,1,14
4/11/1974,3,0,3,3,9
4/12/1974,4,0,6,9,19
4/13/1974,4,0,4,8,16
4/14/1974,4,0,2,6,12
4/15/1974,6,0,8,9,23
4/16/1974,5,0,3,4,12
4/17/1974,4,0,7,10,21
4/18/1974,2,0,6,0,8
4/19/1974,7,0,2,9,18
4/20/1974,3,0,4,6,13
4/21/1974,3,0,6,2,11
4/22/1974,2,0,3,8,13
4/23/1974,7,0,3,9,19
4/24/1974,3,0,4,3,10
4/25/1974,7,0,4,5,16
4/26/1974,4,0,6,6,16
4/27/1974,8,0,2,6,16
4/28/1974,5,0,2,13,20
4/29/1974,7,0,2,9,18
4/30/1974,6,0,4,5,15
5/1/1974,8,0,6,11,25
5/2/1974,8,0,7,5,20
5/3/1974,3,0,5,8,16
5/4/1974,4,0,7,10,21
5/5/1974,2,0,8,0,10
5/6/1974,4,0,8,0,12
5/7/1974,6,0,7,13,26
5/8/1974,3,0,4,8,15
5/9/1974,2,0,5,1,8
5/10/1974,3,0,7,11,21
5/11/1974,7,0,5,10,22
5/12/1974,6,0,4,10,20
5/13/1974,4,0,4,11,19
5/14/1974,7,0,6,11,24
5/15/1974,2,0,2,13,17
5/16/1974,6,0,7,5,18
5/17/1974,4,0,8,6,18
5/18/1974,6,0,6,9,21
5/19/1974,4,0,4,13,21
5/20/1974,5,0,8,9,22
5/21/1974,5,0,2,13,20
5/22/1974,3,0,8,5,16
5/23/1974,6,0,3,11,20
5/24/1974,2,0,2,8,12
5/25/1974,5,0,7,3,15
5/26/1974,3,0,5,7,15
5/27/1974,5,0,3,10,18
5/28/1974,4,0,4,0,8
5/29/1974,7,0,3,7,17
5/30/1974,6,0,5,3,14
5/31/1974,2,0,2,11,15
6/1/1974,3,0,4,10,17
6/2/1974,2,0,8,13,23
6/3/1974,4,0,4,7,15
6/4/1974,6,0,7,3,16
6/5/1974,2,0,8,3,13
6/6/1974,2,0,8,2,12
6/7/1974,8,0,6,12,26
6/8/1974,2,0,6,0,8
6/9/1974,3,0,7,9,19
6/10/1974,4,0,6,2,12
6/11/1974,6,0,3,0,9
6/12/1974,3,0,6,10,19
6/13/1974,3,0,5,0,8
6/14/1974,6,0,8,6,20
6/15/1974,8,0,4,11,23
6/16/1974,2,0,2,9,13
6/17/1974,2,0,2,13,17
6/18/1974,4,0,6,0,10
6/19/1974,5,0,7,3,15
6/20/1974,5,0,2,2,9
6/21/1974,7,0,5,10,22
6/22/1974,5,0,8,8,21
6/23/1974,4,0,7,2,13
6/24/1974,3,0,8,1,12
6/25/1974,2,0,6,13,21
6/26/1974,7,0,3,13,23
6/27/1974,5,0,6,3,14
6/28/1974,3,0,3,6,12
6/29/1974,3,0,3,0,6
6/30/1974,3,0,8,9,20
7/1/1974,2,0,3,5,10
7/2/1974,6,0,3,11,20
7/3/1974,3,0,8,3,14
7/4/1974,4,0,4,2,10
7/5/1974,4,0,2,5,11
7/6/1974,6,0,3,13,22
7/7/1974,2,0,6,7,15
7/8/1974,3,0,4,1,8
7/9/1974,7,0,5,0,12
7/10/1974,5,0,5,0,10
7/11/1974,6,0,8,7,21
7/12/1974,7,0,6,11,24
7/13/1974,6,0,2,13,21
7/14/1974,4,0,4,7,15
7/15/1974,5,0,2,10,17
7/16/1974,6,0,8,9,23
7/17/1974,6,0,5,0,11
7/18/1974,5,0,5,3,13
7/19/1974,3,0,5,11,19
7/20/1974,7,0,2,13,22
7/21/1974,8,0,8,7,23
7/22/1974,6,0,7,12,25
7/23/1974,2,0,6,10,18
7/24/1974,4,0,7,11,22
7/25/1974,2,0,4,11,17
7/26/1974,8,0,8,11,27
7/27/1974,3,0,2,8,13
7/28/1974,2,0,2,5,9
7/29/1974,2,0,2,7,11
7/30/1974,8,0,4,4,16
7/31/1974,3,0,8,3,14
8/1/1974,6,0,5,2,13
8/2/1974,2,0,3,11,16
8/3/1974,3,0,4,0,7
8/4/1974,4,0,6,0,10
8/5/1974,7,0,4,12,23
8/6/1974,6,0,6,6,18
8/7/1974,7,0,3,10,20
8/8/1974,3,0,8,12,23
8/9/1974,7,0,4,12,23
8/10/1974,5,0,4,6,15
8/11/1974,3,0,7,5,15
8/12/1974,6,0,7,0,13
8/13/1974,6,0,2,9,17
8/14/1974,8,0,6,13,27
8/15/1974,6,0,2,3,11
8/16/1974,3,0,4,11,18
8/17/1974,7,0,4,7,18
8/18/1974,8,0,4,2,14
8/19/1974,3,0,3,11,17
8/20/1974,6,0,6,9,21
8/21/1974,7,0,5,3,15
8/22/1974,2,0,6,3,11
8/23/1974,4,0,4,5,13
8/24/1974,5,0,8,4,17
8/25/1974,2,0,3,5,10
8/26/1974,2,0,6,6,14
8/27/1974,8,0,5,12,25
8/28/1974,5,0,2,2,9
8/29/1974,7,0,3,0,10
8/30/1974,7,0,5,5,17
8/31/1974,3,0,6,13,22
9/1/1974,2,0,7,0,9
9/2/1974,8,0,5,7,20
9/3/1974,5,0,8,8,21
9/4/1974,2,0,6,8,16
9/5/1974,5,0,7,9,21
9/6/1974,2,0,2,10,14
9/7/1974,3,0,6,4,13
9/8/1974,6,0,3,5,14
9/9/1974,8,0,7,1,16
9/10/1974,2,0,3,7,12
9/11/1974,6,0,5,4,15
9/12/1974,2,0,3,11,16
9/13/1974,8,0,3,1,12
9/14/1974,2,0,8,13,23
9/15/1974,2,0,6,1,9
9/16/1974,8,0,2,10,20
9/17/1974,2,0,3,6,11
9/18/1974,3,0,7,0,10
9/19/1974,4,0,8,3,15
9/20/1974,3,0,7,2,12
9/21/1974,6,0,5,10,21
9/22/1974,7,0,3,13,23
9/23/1974,2,0,7,1,10
9/24/1974,8,0,8,13,29
9/25/1974,5,0,2,9,16
9/26/1974,7,0,2,1,10
9/27/1974,6,0,5,13,24
9/28/1974,2,0,8,6,16
9/29/1974,6,0,5,3,14
9/30/1974,5,0,5,13,23
10/1/1974,4,0,3,2,9
10/2/1974,8,0,3,12,23
10/3/1974,2,0,4,0,6
10/4/1974,4,0,8,10,22
10/5/1974,4,0,8,11,23
10/6/1974,7,0,2,4,13
10/7/1974,6,0,3,4,13
10/8/1974,2,0,2,10,14
10/9/1974,4,0,5,0,9
10/10/1974,6,0,4,0,10
10/11/1974,7,0,2,8,17
10/12/1974,6,0,2,9,17
10/13/1974,3,0,4,13,20
10/14/1974,7,0,6,8,21
10/15/1974,5,0,4,1,10
10/16/1974,2,0,3,10,15
10/17/1974,2,0,8,10,20
10/18/1974,8,0,3,2,13
10/19/1974,4,0,5,0,9
10/20/1974,2,0,7,7,16
10/21/1974,5,0,7,0,12
10/22/1974,6,0,5,11,22
10/23/1974,4,0,4,6,14
10/24/1974,6,0,7,12,25
10/25/1974,5,0,8,0,13
10/26/1974,8,0,5,7,20
10/27/1974,6,0,2,13,21
10/28/1974,5,0,6,3,14
10/29/1974,8,0,6,8,22
10/30/1974,7,0,3,13,23
10/31/1974,3,0,5,5,13
11/1/1974,8,0,3,2,13
11/2/1974,3,0,2,0,5
11/3/1974,5,0,8,9,22
11/4/1974,4,0,4,1,9
11/5/1974,8,0,3,12,23
11/6/1974,2,0,6,5,13
11/7/1974,3,0,2,6,11
11/8/1974,4,0,8,4,16
11/9/1974,3,0,3,4,10
11/10/1974,7,0,6,11,24
11/11/1974,2,0,8,5,15
11/12/1974,4,0,6,0,10
11/13/1974,4,0,6,13,23
11/14/1974,6,0,4,6,16
11/15/1974,3,0,5,4,12
11/16/1974,3,0,2,7,12
11/17/1974,6,0,3,2,11
11/18/1974,7,0,6,10,23
11/19/1974,7,0,2,8,17
11/20/1974,7,0,2,3,12
11/21/1974,4,0,2,12,18
11/22/1974,7,0,5,3,15
11/23/1974,5,0,8,2,15
11/24/1974,5,0,5,4,14
11/25/1974,8,0,3,12,23
11/26/1974,2,0,3,3,8
11/27/1974,8,0,4,0,12
11/28/1974,6,0,8,0,14
11/29/1974,8,0,6,7,21
11/30/1974,7,0,7,9,23
12/1/1974,4,0,7,7,18
12/2/1974,5,0,3,13,21
12/3/1974,3,0,3,8,14
12/4/1974,3,0,8,13,24
12/5/1974,3,0,3,0,6
12/6/1974,2,0,8,3,13
12/7/1974,8,0,7,2,17
12/8/1974,8,0,2,6,16
12/9/1974,6,0,7,12,25
12/10/1974,4,0,2,4,10
12/11/1974,4,0,7,0,11
12/12/1974,3,0,7,13,23
12/13/1974,8,0,7,8,23
12/14/1974,8,0,4,5,17
12/15/1974,6,0,5,0,11
12/16/1974,5,0,4,6,15
12/17/1974,3,0,4,11,18
12/18/1974,7,0,4,9,20
12/19/1974,3,0,7,13,23
12/20/1974,8,0,3,5,16
12/21/1974,7,0,7,7,21
12/22/1974,6,0,6,1,13
12/23/1974,3,0,6,9,18
12/24/1974,2,0,2,10,14
12/25/1974,6,0,6,13,25
12/26/1974,6,0,2,7,15
12/27/1974,8,0,7,0,15
12/28/1974,4,0,2,2,8
12/29/1974,6,0,2,6,14
12/30/1974,7,0,4,13,24
12/31/1974,3,0,3,5,11
1/1/1975,8,0,2,3,13
1/2/1975,8,0,6,6,20
1/3/1975,3,0,3,11,17
1/4/1975,5,0,5,7,17
1/5/1975,7,0,4,11,22
1/6/1975,8,0,6,7,21
1/7/1975,3,0,8,13,24
1/8/1975,8,0,3,5,16
1/9/1975,7,0,8,10,25
1/10/1975,2,0,2,9,13
1/11/1975,6,0,8,7,21
1/12/1975,3,0,2,9,14
1/13/1975,4,0,8,8,20
1/14/1975,5,0,3,9,17
1/15/1975,8,0,4,9,21
1/16/1975,7,0,6,1,14
1/17/1975,3,0,8,11,22
1/18/1975,3,0,7,1,11
1/19/1975,5,0,6,3,14
1/20/1975,2,0,6,4,12
1/21/1975,4,0,8,8,20
1/22/1975,7,0,8,11,26
1/23/1975,2,0,8,6,16
1/24/1975,4,0,6,6,16
1/25/1975,2,0,5,7,14
1/26/1975,2,0,2,8,12
1/27/1975,7,0,6,12,25
1/28/1975,2,0,4,3,9
1/29/1975,7,0,8,2,17
1/30/1975,5,0,5,4,14
1/31/1975,7,0,6,12,25
2/1/1975,5,0,3,3,11
2/2/1975,5,0,3,1,9
2/3/1975,8,0,8,1,17
2/4/1975,5,0,7,13,25
2/5/1975,3,0,8,1,12
2/6/1975,5,0,4,12,21
2/7/1975,8,0,3,4,15
2/8/1975,4,0,7,8,19
2/9/1975,2,0,5,3,10
2/10/1975,4,0,8,2,14
2/11/1975,7,0,8,9,24
2/12/1975,3,0,6,13,22
2/13/1975,4,0,5,6,15
2/14/1975,5,0,2,4,11
2/15/1975,2,0,4,11,17
2/16/1975,8,0,6,9,23
2/17/1975,5,0,4,6,15
2/18/1975,7,0,5,0,12
2/19/1975,8,0,2,3,13
2/20/1975,2,0,4,8,14
2/21/1975,8,0,3,2,13
2/22/1975,2,0,2,5,9
2/23/1975,4,0,3,10,17
2/24/1975,3,0,6,3,12
2/25/1975,5,0,3,2,10
2/26/1975,5,0,6,3,14
2/27/1975,6,0,3,1,10
2/28/1975,4,0,7,3,14
3/1/1975,6,0,2,2,10
3/2/1975,3,0,8,7,18
3/3/1975,8,0,6,1,15
3/4/1975,8,0,7,3,18
3/5/1975,4,0,5,10,19
3/6/1975,3,0,4,3,10
3/7/1975,3,0,7,0,10
3/8/1975,4,0,4,13,21
3/9/1975,8,0,5,7,20
3/10/1975,8,0,8,2,18
3/11/1975,6,0,7,11,24
3/12/1975,2,0,2,5,9
3/13/1975,5,0,5,9,19
3/14/1975,7,0,8,9,24
3/15/1975,5,0,8,3,16
3/16/1975,3,0,4,11,18
3/17/1975,6,0,2,1,9
3/18/1975,7,0,2,3,12
3/19/1975,5,0,2,10,17
3/20/1975,3,0,3,9,15
3/21/1975,7,0,7,8,22
3/22/1975,8,0,4,13,25
3/23/1975,3,0,3,6,12
3/24/1975,7,0,4,4,15
3/25/1975,6,0,6,8,20
3/26/1975,8,0,6,9,23
3/27/1975,7,0,2,5,14
3/28/1975,2,0,2,1,5
3/29/1975,4,0,8,7,19
3/30/1975,4,0,6,4,14
3/31/1975,5,0,7,8,20
4/1/1975,6,0,3,7,16
4/2/1975,7,0,2,10,19
4/3/1975,2,0,2,0,4
4/4/1975,5,0,7,5,17
4/5/1975,7,0,5,6,18
4/6/1975,2,0,6,2,10
4/7/1975,3,0,4,0,7
4/8/1975,5,0,3,3,11
4/9/1975,7,0,3,5,15
4/10/1975,6,0,7,8,21
4/11/1975,6,0,4,6,16
4/12/1975,8,0,8,6,22
4/13/1975,5,0,7,9,21
4/14/1975,8,0,7,0,15
4/15/1975,7,0,2,7,16
4/16/1975,8,0,5,12,25
4/17/1975,4,0,4,1,9
4/18/1975,7,0,6,2,15
4/19/1975,7,0,4,8,19
4/20/1975,2,0,7,6,15
4/21/1975,3,0,7,9,19
4/22/1975,4,0,2,2,8
4/23/1975,4,0,4,9,17
4/24/1975,4,0,5,10,19
4/25/1975,6,0,2,3,11
4/26/1975,8,0,5,1,14
4/27/1975,5,0,8,10,23
4/28/1975,6,0,6,9,21
4/29/1975,6,0,4,7,17
4/30/1975,3,0,5,12,20
5/1/1975,5,0,5,13,23
5/2/1975,3,0,4,0,7
5/3/1975,5,0,7,5,17
5/4/1975,4,0,8,4,16
5/5/1975,4,0,4,2,10
5/6/1975,6,0,3,8,17
5/7/1975,3,0,2,10,15
5/8/1975,6,0,8,11,25
5/9/1975,8,0,4,3,15
5/10/1975,3,0,2,11,16
5/11/1975,5,0,4,2,11
5/12/1975,3,0,4,13,20
5/13/1975,5,0,5,5,15
5/14/1975,4,0,4,1,9
5/15/1975,8,0,2,11,21
5/16/1975,7,0,7,6,20
5/17/1975,6,0,8,1,15
5/18/1975,3,0,8,7,18
5/19/1975,8,0,6,3,17
5/20/1975,8,0,4,0,12
5/21/1975,7,0,6,13,26
5/22/1975,4,0,8,5,17
5/23/1975,3,0,5,0,8
5/24/1975,4,0,5,11,20
5/25/1975,7,0,6,9,22
5/26/1975,7,0,8,11,26
5/27/1975,3,0,4,3,10
5/28/1975,6,0,4,9,19
5/29/1975,3,0,3,9,15
5/30/1975,8,0,2,5,15
5/31/1975,4,0,5,3,12
6/1/1975,3,0,6,11,20
6/2/1975,5,0,2,2,9
6/3/1975,8,0,3,11,22
6/4/1975,3,0,5,10,18
6/5/1975,8,0,6,13,27
6/6/1975,2,0,6,12,20
6/7/1975,4,0,4,12,20
6/8/1975,6,0,8,9,23
6/9/1975,3,0,6,6,15
6/10/1975,8,0,2,5,15
6/11/1975,7,0,2,0,9
6/12/1975,8,0,7,5,20
6/13/1975,5,0,7,13,25
6/14/1975,6,0,4,5,15
6/15/1975,5,0,5,13,23
6/16/1975,2,0,7,9,18
6/17/1975,7,0,3,8,18
6/18/1975,7,0,3,0,10
6/19/1975,6,0,2,1,9
6/20/1975,8,0,4,13,25
6/21/1975,6,0,3,3,12
6/22/1975,4,0,2,3,9
6/23/1975,5,0,4,3,12
6/24/1975,3,0,3,8,14
6/25/1975,7,0,5,6,18
6/26/1975,4,0,3,5,12
6/27/1975,3,0,3,10,16
6/28/1975,7,0,6,11,24
6/29/1975,8,0,7,13,28
6/30/1975,5,0,4,3,12
7/1/1975,6,0,4,2,12
7/2/1975,7,0,4,11,22
7/3/1975,8,0,2,6,16
7/4/1975,6,0,5,13,24
7/5/1975,6,0,3,3,12
7/6/1975,6,0,7,5,18
7/7/1975,8,0,4,12,24
7/8/1975,4,0,3,3,10
7/9/1975,3,0,4,8,15
7/10/1975,4,0,5,10,19
7/11/1975,7,0,3,9,19
7/12/1975,6,0,6,0,12
7/13/1975,5,0,5,9,19
7/14/1975,3,0,6,8,17
7/15/1975,2,0,2,13,17
7/16/1975,5,0,4,8,17
7/17/1975,2,0,4,4,10
7/18/1975,3,0,7,7,17
7/19/1975,6,0,3,10,19
7/20/1975,7,0,6,7,20
7/21/1975,5,0,2,7,14
7/22/1975,7,0,5,0,12
7/23/1975,5,0,4,13,22
7/24/1975,3,0,7,10,20
7/25/1975,4,0,2,11,17
7/26/1975,4,0,3,9,16
7/27/1975,3,0,3,4,10
7/28/1975,2,0,7,6,15
7/29/1975,7,0,5,3,15
7/30/1975,6,0,6,2,14
7/31/1975,4,0,4,2,10
8/1/1975,4,0,2,12,18
8/2/1975,6,0,2,9,17
8/3/1975,2,0,4,12,18
8/4/1975,2,0,6,5,13
8/5/1975,2,0,7,9,18
8/6/1975,8,0,4,10,22
8/7/1975,7,0,3,0,10
8/8/1975,2,0,6,12,20
8/9/1975,6,0,7,4,17
8/10/1975,5,0,5,13,23
8/11/1975,7,0,8,5,20
8/12/1975,7,0,5,13,25
8/13/1975,8,0,4,4,16
8/14/1975,7,0,8,9,24
8/15/1975,7,0,7,8,22
8/16/1975,4,0,6,3,13
8/17/1975,4,0,8,2,14
8/18/1975,4,0,4,10,18
8/19/1975,8,0,5,0,13
8/20/1975,5,0,7,5,17
8/21/1975,5,0,8,9,22
8/22/1975,3,0,7,3,13
8/23/1975,6,0,8,7,21
8/24/1975,6,0,8,12,26
8/25/1975,5,0,6,1,12
8/26/1975,7,0,5,9,21
8/27/1975,2,0,6,4,12
8/28/1975,6,0,3,12,21
8/29/1975,7,0,6,2,15
8/30/1975,8,0,7,11,26
8/31/1975,8,0,2,12,22
9/1/1975,6,0,7,5,18
9/2/1975,2,0,3,11,16
9/3/1975,7,0,4,4,15
9/4/1975,6,0,8,5,19
9/5/1975,6,0,6,2,14
9/6/1975,5,0,2,1,8
9/7/1975,8,0,6,3,17
9/8/1975,2,0,7,8,17
9/9/1975,3,0,6,4,13
9/10/1975,4,0,2,12,18
9/11/1975,4,0,7,7,18
9/12/1975,2,0,8,10,20
9/13/1975,6,0,3,12,21
9/14/1975,2,0,6,7,15
9/15/1975,4,0,3,0,7
9/16/1975,5,0,2,0,7
9/17/1975,3,0,8,12,23
9/18/1975,4,0,8,13,25
9/19/1975,2,0,2,9,13
9/20/1975,3,0,4,11,18
9/21/1975,5,0,5,5,15
9/22/1975,7,0,2,7,16
9/23/1975,4,0,2,1,7
9/24/1975,4,0,8,7,19
9/25/1975,2,0,2,3,7
9/26/1975,4,0,4,3,11
9/27/1975,3,0,2,4,9
9/28/1975,5,0,6,13,24
9/29/1975,8,0,4,3,15
9/30/1975,8,0,2,7,17
10/1/1975,5,0,3,13,21
10/2/1975,5,0,5,9,19
10/3/1975,2,0,7,0,9
10/4/1975,6,0,8,3,17
10/5/1975,8,0,2,4,14
10/6/1975,8,0,4,1,13
10/7/1975,6,0,4,5,15
10/8/1975,3,0,2,6,11
10/9/1975,8,0,8,11,27
10/10/1975,2,0,8,9,19
10/11/1975,2,0,5,7,14
10/12/1975,5,0,7,6,18
10/13/1975,6,0,4,5,15
10/14/1975,7,0,3,9,19
10/15/1975,7,0,6,2,15
10/16/1975,8,0,8,11,27
10/17/1975,7,0,2,13,22
10/18/1975,5,0,2,4,11
10/19/1975,3,0,4,1,8
10/20/1975,6,0,6,7,19
10/21/1975,5,0,2,0,7
10/22/1975,2,0,3,9,14
10/23/1975,6,0,3,0,9
10/24/1975,4,0,4,13,21
10/25/1975,3,0,7,11,21
10/26/1975,4,0,2,8,14
10/27/1975,5,0,6,7,18
10/28/1975,8,0,8,12,28
10/29/1975,7,0,2,3,12
10/30/1975,7,0,5,1,13
10/31/1975,2,0,8,8,18
11/1/1975,8,0,6,9,23
11/2/1975,8,0,6,11,25
11/3/1975,3,0,8,9,20
11/4/1975,6,0,6,12,24
11/5/1975,5,0,8,2,15
11/6/1975,8,0,4,1,13
11/7/1975,8,0,3,1,12
11/8/1975,3,0,5,1,9
11/9/1975,6,0,5,11,22
11/10/1975,7,0,7,1,15
11/11/1975,4,0,3,9,16
11/12/1975,7,0,2,9,18
11/13/1975,2,0,8,3,13
11/14/1975,3,0,6,9,18
11/15/1975,4,0,5,12,21
11/16/1975,3,0,2,3,8
11/17/1975,3,0,7,0,10
11/18/1975,3,0,8,11,22
11/19/1975,5,0,6,9,20
11/20/1975,7,0,6,0,13
11/21/1975,3,0,3,5,11
11/22/1975,6,0,3,6,15
11/23/1975,3,0,7,1,11
11/24/1975,4,0,5,0,9
11/25/1975,3,0,7,9,19
11/26/1975,8,0,5,7,20
11/27/1975,7,0,2,9,18
11/28/1975,7,0,5,4,16
11/29/1975,2,0,7,2,11
11/30/1975,3,0,7,3,13
12/1/1975,6,0,8,3,17
12/2/1975,2,0,4,10,16
12/3/1975,5,0,8,1,14
12/4/1975,3,0,5,8,16
12/5/1975,8,0,5,1,14
12/6/1975,3,0,5,11,19
12/7/1975,6,0,2,1,9
12/8/1975,4,0,2,6,12
12/9/1975,5,0,6,4,15
12/10/1975,8,0,2,13,23
12/11/1975,4,0,8,5,17
12/12/1975,5,0,8,8,21
12/13/1975,5,0,3,5,13
12/14/1975,4,0,4,10,18
12/15/1975,2,0,4,7,13
12/16/1975,4,0,7,8,19
12/17/1975,7,0,3,10,20
12/18/1975,8,0,3,10,21
12/19/1975,5,0,4,2,11
12/20/1975,5,0,6,12,23
12/21/1975,3,0,2,4,9
12/22/1975,6,0,7,4,17
12/23/1975,6,0,4,7,17
12/24/1975,7,0,8,2,17
12/25/1975,5,0,5,4,14
12/26/1975,6,0,7,5,18
12/27/1975,8,0,8,12,28
12/28/1975,7,0,6,10,23
12/29/1975,2,0,8,3,13
12/30/1975,3,0,5,7,15
12/31/1975,4,0,3,2,9
1/1/1976,4,0,3,4,11
1/2/1976,3,0,5,6,14
1/3/1976,5,0,3,10,18
1/4/1976,2,0,5,1,8
1/5/1976,5,0,5,12,22
1/6/1976,2,0,4,8,14
1/7/1976,3,0,6,5,14
1/8/1976,6,0,7,9,22
1/9/1976,6,0,3,10,19
1/10/1976,7,0,7,4,18
1/11/1976,6,0,3,11,20
1/12/1976,7,0,4,10,21
1/13/1976,2,0,3,6,11
1/14/1976,2,0,7,2,11
1/15/1976,5,0,4,11,20
1/16/1976,5,0,7,10,22
1/17/1976,8,0,5,11,24
1/18/1976,3,0,5,13,21
1/19/1976,3,0,7,4,14
1/20/1976,6,0,8,1,15
1/21/1976,6,0,6,12,24
1/22/1976,3,0,3,1,7
1/23/1976,3,0,7,12,22
1/24/1976,7,0,8,8,23
1/25/1976,6,0,8,12,26
1/26/1976,8,0,2,6,16
1/27/1976,5,0,4,8,17
1/28/1976,6,0,3,12,21
1/29/1976,4,0,7,2,13
1/30/1976,6,0,6,6,18
1/31/1976,4,0,4,4,12
2/1/1976,8,0,2,4,14
2/2/1976,3,0,6,0,9
2/3/1976,4,0,6,1,11
2/4/1976,2,0,6,10,18
2/5/1976,2,0,8,9,19
2/6/1976,8,0,2,0,10
2/7/1976,4,0,8,6,18
2/8/1976,2,0,5,5,12
2/9/1976,7,0,3,0,10
2/10/1976,3,0,3,12,18
2/11/1976,6,0,2,2,10
2/12/1976,6,0,4,2,12
2/13/1976,4,0,6,13,23
2/14/1976,5,0,5,4,14
2/15/1976,7,0,3,5,15
2/16/1976,3,0,2,7,12
2/17/1976,3,0,7,1,11
2/18/1976,7,0,7,11,25
2/19/1976,2,0,5,1,8
2/20/1976,3,0,7,3,13
2/21/1976,6,0,4,10,20
2/22/1976,2,0,6,8,16
2/23/1976,8,0,3,11,22
2/24/1976,6,0,4,4,14
2/25/1976,4,0,7,6,17
2/26/1976,4,0,6,11,21
2/27/1976,8,0,3,9,20
2/28/1976,7,0,3,11,21
2/29/1976,8,0,8,7,23
3/1/1976,3,0,2,12,17
3/2/1976,2,0,5,3,10
3/3/1976,2,0,5,6,13
3/4/1976,7,0,3,12,22
3/5/1976,4,0,7,11,22
3/6/1976,7,0,8,3,18
3/7/1976,3,0,2,7,12
3/8/1976,7,0,4,6,17
3/9/1976,2,0,8,3,13
3/10/1976,6,0,7,10,23
3/11/1976,6,0,5,12,23
3/12/1976,8,0,3,8,19
3/13/1976,4,0,2,5,11
3/14/1976,3,0,2,12,17
3/15/1976,3,0,6,2,11
3/16/1976,2,0,7,4,13
3/17/1976,3,0,5,0,8
3/18/1976,5,0,7,7,19
3/19/1976,6,0,4,2,12
3/20/1976,3,0,5,11,19
3/21/1976,2,0,2,5,9
3/22/1976,6,0,4,4,14
3/23/1976,3,0,3,9,15
3/24/1976,6,0,3,0,9
3/25/1976,4,0,6,3,13
3/26/1976,6,0,4,4,14
3/27/1976,8,0,3,13,24
3/28/1976,4,0,4,3,11
3/29/1976,7,0,2,4,13
3/30/1976,3,0,3,3,9
3/31/1976,5,0,6,6,17
4/1/1976,7,0,5,1,13
4/2/1976,6,0,3,9,18
4/3/1976,8,0,5,9,22
4/4/1976,8,0,3,11,22
4/5/1976,2,0,3,1,6
4/6/1976,2,0,7,6,15
4/7/1976,8,0,7,9,24
4/8/1976,3,0,6,10,19
4/9/1976,4,0,2,7,13
4/10/1976,2,0,2,0,4
4/11/1976,2,0,3,2,7
4/12/1976,6,0,5,5,16
4/13/1976,6,0,8,2,16
4/14/1976,2,0,5,10,17
4/15/1976,4,0,2,3,9
4/16/1976,4,0,7,6,17
4/17/1976,4,0,7,1,12
4/18/1976,6,0,6,4,16
4/19/1976,7,0,8,10,25
4/20/1976,5,0,8,12,25
4/21/1976,6,0,3,7,16
4/22/1976,4,0,3,12,19
4/23/1976,6,0,4,8,18
4/24/1976,5,0,3,4,12
4/25/1976,2,0,7,4,13
4/26/1976,2,0,6,6,14
4/27/1976,5,0,3,12,20
4/28/1976,2,0,7,12,21
4/29/1976,3,0,4,8,15
4/30/1976,3,0,8,5,16
5/1/1976,4,0,4,12,20
5/2/1976,3,0,3,6,12
5/3/1976,2,0,3,13,18
5/4/1976,8,0,4,5,17
5/5/1976,4,0,5,2,11
5/6/1976,7,0,3,9,19
5/7/1976,3,0,2,5,10
5/8/1976,6,0,4,4,14
5/9/1976,2,0,8,9,19
5/10/1976,4,0,4,1,9
5/11/1976,4,0,8,1,13
5/12/1976,5,0,8,3,16
5/13/1976,3,0,4,11,18
5/14/1976,8,0,2,13,23
5/15/1976,6,0,7,7,20
5/16/1976,6,0,7,5,18
5/17/1976,5,0,8,1,14
5/18/1976,6,0,6,8,20
5/19/1976,6,0,2,9,17
5/20/1976,7,0,5,2,14
5/21/1976,6,0,6,10,22
5/22/1976,2,0,7,5,14
5/23/1976,7,0,2,4,13
5/24/1976,4,0,6,3,13
5/25/1976,8,0,6,12,26
5/26/1976,4,0,7,12,23
5/27/1976,2,0,8,0,10
5/28/1976,7,0,2,5,14
5/29/1976,8,0,3,3,14
5/30/1976,8,0,8,11,27
5/31/1976,7,0,6,10,23
6/1/1976,4,0,2,1,7
6/2/1976,4,0,8,7,19
6/3/1976,7,0,4,11,22
6/4/1976,3,0,2,0,5
6/5/1976,8,0,6,4,18
6/6/1976,6,0,8,0,14
6/7/1976,4,0,4,10,18
6/8/1976,4,0,4,1,9
6/9/1976,3,0,4,2,9
6/10/1976,3,0,2,13,18
6/11/1976,6,0,6,5,17
6/12/1976,4,0,5,9,18
6/13/1976,2,0,4,8,14
6/14/1976,6,0,7,0,13
6/15/1976,8,0,7,6,21
6/16/1976,8,0,5,0,13
6/17/1976,7,0,4,2,13
6/18/1976,4,0,5,1,10
6/19/1976,7,0,2,5,14
6/20/1976,8,0,8,10,26
6/21/1976,5,0,8,9,22
6/22/1976,4,0,3,4,11
6/23/1976,4,0,5,8,17
6/24/1976,4,0,2,4,10
6/25/1976,2,0,2,12,16
6/26/1976,6,0,2,10,18
6/27/1976,6,0,6,7,19
6/28/1976,8,0,8,13,29
6/29/1976,7,0,3,7,17
6/30/1976,7,0,4,8,19
7/1/1976,7,0,8,8,23
7/2/1976,5,0,5,4,14
7/3/1976,3,0,8,11,22
7/4/1976,6,0,7,2,15
7/5/1976,3,0,5,13,21
7/6/1976,8,0,8,10,26
7/7/1976,8,0,6,10,24
7/8/1976,7,0,5,13,25
7/9/1976,8,0,5,11,24
7/10/1976,3,0,7,13,23
7/11/1976,7,0,4,10,21
7/12/1976,5,0,6,7,18
7/13/1976,7,0,8,13,28
7/14/1976,8,0,2,13,23
7/15/1976,2,0,4,4,10
7/16/1976,7,0,6,3,16
7/17/1976,2,0,3,12,17
7/18/1976,6,0,4,9,19
7/19/1976,3,0,4,12,19
7/20/1976,2,0,6,7,15
7/21/1976,5,0,2,4,11
7/22/1976,7,0,3,5,15
7/23/1976,2,0,4,3,9
7/24/1976,4,0,3,6,13
7/25/1976,3,0,5,1,9
7/26/1976,5,0,4,9,18
7/27/1976,4,0,8,0,12
7/28/1976,5,0,6,4,15
7/29/1976,4,0,8,0,12
7/30/1976,7,0,3,10,20
7/31/1976,4,0,6,9,19
8/1/1976,7,0,5,7,19
8/2/1976,5,0,2,0,7
8/3/1976,2,0,5,1,8
8/4/1976,6,0,8,5,19
8/5/1976,7,0,6,5,18
8/6/1976,2,0,6,9,17
8/7/1976,3,0,7,2,12
8/8/1976,8,0,6,3,17
8/9/1976,7,0,7,1,15
8/10/1976,4,0,3,10,17
8/11/1976,3,0,3,5,11
8/12/1976,4,0,2,9,15
8/13/1976,8,0,2,8,18
8/14/1976,7,0,5,11,23
8/15/1976,3,0,8,3,14
8/16/1976,2,0,6,2,10
8/17/1976,7,0,5,8,20
8/18/1976,7,0,8,0,15
8/19/1976,5,0,7,2,14
8/20/1976,6,0,6,8,20
8/21/1976,6,0,2,9,17
8/22/1976,7,0,5,10,22
8/23/1976,3,0,5,6,14
8/24/1976,4,0,2,0,6
8/25/1976,2,0,2,8,12
8/26/1976,4,0,3,7,14
8/27/1976,8,0,6,10,24
8/28/1976,4,0,5,4,13
8/29/1976,7,0,6,5,18
8/30/1976,8,0,6,6,20
8/31/1976,7,0,6,7,20
9/1/1976,7,0,6,6,19
9/2/1976,8,0,7,5,20
9/3/1976,7,0,6,12,25
9/4/1976,5,0,8,1,14
9/5/1976,6,0,5,8,19
9/6/1976,8,0,2,3,13
9/7/1976,4,0,6,2,12
9/8/1976,8,0,3,9,20
9/9/1976,6,0,3,8,17
9/10/1976,6,0,2,8,16
9/11/1976,5,0,8,13,26
9/12/1976,8,0,6,7,21
9/13/1976,8,0,6,13,27
9/14/1976,4,0,4,1,9
9/15/1976,3,0,5,0,8
9/16/1976,4,0,4,12,20
9/17/1976,3,0,5,12,20
9/18/1976,5,0,4,1,10
9/19/1976,3,0,3,11,17
9/20/1976,8,0,7,5,20
9/21/1976,4,0,8,3,15
9/22/1976,6,0,8,12,26
9/23/1976,6,0,5,11,22
9/24/1976,3,0,2,12,17
9/25/1976,4,0,8,9,21
9/26/1976,4,0,5,10,19
9/27/1976,5,0,5,2,12
9/28/1976,6,0,4,6,16
9/29/1976,7,0,8,12,27
9/30/1976,3,0,5,2,10
10/1/1976,3,0,2,12,17
10/2/1976,2,0,5,8,15
10/3/1976,6,0,7,6,19
10/4/1976,3,0,4,6,13
10/5/1976,2,0,2,10,14
10/6/1976,7,0,7,4,18
10/7/1976,5,0,6,10,21
10/8/1976,6,0,4,2,12
10/9/1976,2,0,3,4,9
10/10/1976,5,0,7,0,12
10/11/1976,3,0,6,3,12
10/12/1976,8,0,7,3,18
10/13/1976,5,0,7,7,19
10/14/1976,6,0,3,13,22
10/15/1976,5,0,5,9,19
10/16/1976,8,0,8,9,25
10/17/1976,8,0,8,8,24
10/18/1976,8,0,3,4,15
10/19/1976,6,0,3,8,17
10/20/1976,2,0,2,11,15
10/21/1976,5,0,2,5,12
10/22/1976,2,0,6,7,15
10/23/1976,8,0,3,12,23
10/24/1976,8,0,8,1,17
10/25/1976,3,0,2,11,16
10/26/1976,3,0,5,3,11
10/27/1976,3,0,5,11,19
10/28/1976,5,0,8,1,14
10/29/1976,7,0,2,7,16
10/30/1976,8,0,8,1,17
10/31/1976,3,0,8,7,18
11/1/1976,4,0,5,8,17
11/2/1976,6,0,5,8,19
11/3/1976,8,0,8,8,24
11/4/1976,2,0,4,5,11
11/5/1976,7,0,5,9,21
11/6/1976,8,0,4,12,24
11/7/1976,4,0,5,8,17
11/8/1976,3,0,5,1,9
11/9/1976,4,0,2,4,10
11/10/1976,8,0,6,9,23
11/11/1976,6,0,6,13,25
11/12/1976,8,0,5,6,19
11/13/1976,7,0,2,2,11
11/14/1976,7,0,5,6,18
11/15/1976,6,0,2,11,19
11/16/1976,5,0,2,10,17
11/17/1976,7,0,3,3,13
11/18/1976,5,0,4,5,14
11/19/1976,8,0,3,3,14
11/20/1976,4,0,7,1,12
11/21/1976,2,0,7,0,9
11/22/1976,5,0,6,4,15
11/23/1976,2,0,2,7,11
11/24/1976,7,0,4,2,13
11/25/1976,5,0,6,1,12
11/26/1976,5,0,6,3,14
11/27/1976,5,0,6,4,15
11/28/1976,5,0,3,9,17
11/29/1976,8,0,4,4,16
11/30/1976,5,0,3,12,20
12/1/1976,8,0,2,6,16
12/2/1976,5,0,4,13,22
12/3/1976,4,0,2,3,9
12/4/1976,5,0,4,8,17
12/5/1976,4,0,2,0,6
12/6/1976,2,0,6,6,14
12/7/1976,7,0,5,12,24
12/8/1976,4,0,7,4,15
12/9/1976,2,0,4,7,13
12/10/1976,3,0,6,4,13
12/11/1976,8,0,6,9,23
12/12/1976,3,0,2,9,14
12/13/1976,7,0,7,3,17
12/14/1976,5,0,7,5,17
12/15/1976,5,0,2,0,7
12/16/1976,5,0,4,10,19
12/17/1976,5,0,4,7,16
12/18/1976,2,0,6,8,16
12/19/1976,4,0,7,2,13
12/20/1976,5,0,3,6,14
12/21/1976,8,0,3,6,17
12/22/1976,4,0,7,13,24
12/23/1976,6,0,5,12,23
12/24/1976,8,0,6,1,15
12/25/1976,2,0,8,4,14
12/26/1976,7,0,6,5,18
12/27/1976,5,0,2,12,19
12/28/1976,5,0,5,11,21
12/29/1976,6,0,6,6,18
12/30/1976,2,0,7,11,20
12/31/1976,5,0,3,3,11
1/1/1977,7,0,8,7,22
1/2/1977,8,0,8,7,23
1/3/1977,6,0,6,8,20
1/4/1977,6,0,8,12,26
1/5/1977,2,0,3,4,9
1/6/1977,4,0,4,4,12
1/7/1977,4,0,5,3,12
1/8/1977,4,0,3,0,7
1/9/1977,8,0,5,8,21
1/10/1977,7,0,3,3,13
1/11/1977,8,0,7,2,17
1/12/1977,8,0,2,11,21
1/13/1977,7,0,3,9,19
1/14/1977,6,0,3,12,21
1/15/1977,8,0,8,5,21
1/16/1977,8,0,2,8,18
1/17/1977,7,0,2,2,11
1/18/1977,4,0,6,10,20
1/19/1977,4,0,6,0,10
1/20/1977,6,0,2,1,9
1/21/1977,5,0,2,7,14
1/22/1977,2,0,6,13,21
1/23/1977,2,0,4,6,12
1/24/1977,5,0,7,5,17
1/25/1977,4,0,2,13,19
1/26/1977,8,0,7,7,22
1/27/1977,6,0,5,11,22
1/28/1977,2,0,7,11,20
1/29/1977,2,0,7,7,16
1/30/1977,6,0,4,8,18
1/31/1977,8,0,5,8,21
2/1/1977,2,0,2,12,16
2/2/1977,2,0,8,9,19
2/3/1977,6,0,8,5,19
2/4/1977,6,0,4,1,11
2/5/1977,8,0,4,7,19
2/6/1977,2,0,6,10,18
2/7/1977,4,0,6,6,16
2/8/1977,5,0,3,5,13
2/9/1977,5,0,3,12,20
2/10/1977,6,0,8,5,19
2/11/1977,3,0,5,13,21
2/12/1977,4,0,5,7,16
2/13/1977,3,0,5,1,9
2/14/1977,6,0,8,5,19
2/15/1977,7,0,4,8,19
2/16/1977,3,0,3,13,19
2/17/1977,4,0,6,8,18
2/18/1977,2,0,2,12,16
2/19/1977,7,0,4,0,11
2/20/1977,6,0,7,2,15
2/21/1977,4,0,4,6,14
2/22/1977,8,0,5,11,24
2/23/1977,5,0,6,9,20
2/24/1977,8,0,8,0,16
2/25/1977,6,0,6,4,16
2/26/1977,8,0,2,13,23
2/27/1977,2,0,5,0,7
2/28/1977,5,0,7,8,20
3/1/1977,7,0,4,0,11
3/2/1977,2,0,6,9,17
3/3/1977,5,0,2,12,19
3/4/1977,6,0,8,8,22
3/5/1977,3,0,3,4,10
3/6/1977,8,0,5,1,14
3/7/1977,5,0,7,0,12
3/8/1977,5,0,7,3,15
3/9/1977,3,0,7,1,11
3/10/1977,2,0,7,0,9
3/11/1977,3,0,8,2,13
3/12/1977,3,0,7,12,22
3/13/1977,8,0,6,2,16
3/14/1977,8,0,4,5,17
3/15/1977,5,0,3,2,10
3/16/1977,4,0,8,4,16
3/17/1977,7,0,6,13,26
3/18/1977,4,0,5,7,16
3/19/1977,6,0,7,12,25
3/20/1977,6,0,2,13,21
3/21/1977,5,0,2,7,14
3/22/1977,8,0,8,4,20
3/23/1977,8,0,5,13,26
3/24/1977,2,0,4,3,9
3/25/1977,3,0,5,11,19
3/26/1977,4,0,8,13,25
3/27/1977,6,0,2,6,14
3/28/1977,6,0,2,7,15
3/29/1977,3,0,7,7,17
3/30/1977,8,0,5,4,17
3/31/1977,5,0,8,4,17
4/1/1977,7,0,8,0,15
4/2/1977,3,0,4,7,14
4/3/1977,3,0,2,11,16
4/4/1977,3,0,8,9,20
4/5/1977,8,0,2,3,13
4/6/1977,4,0,5,6,15
4/7/1977,2,0,3,2,7
4/8/1977,6,0,3,8,17
4/9/1977,6,0,5,3,14
4/10/1977,8,0,2,12,22
4/11/1977,2,0,7,3,12
4/12/1977,2,0,7,12,21
4/13/1977,7,0,5,4,16
4/14/1977,7,0,5,12,24
4/15/1977,4,0,6,13,23
4/16/1977,4,0,4,13,21
4/17/1977,3,0,3,8,14
4/18/1977,7,0,7,6,20
4/19/1977,5,0,5,3,13
4/20/1977,8,0,6,11,25
4/21/1977,3,0,3,10,16
4/22/1977,2,0,5,8,15
4/23/1977,3,0,5,1,9
4/24/1977,3,0,2,1,6
4/25/1977,3,0,4,11,18
4/26/1977,5,0,6,9,20
4/27/1977,6,0,6,0,12
4/28/1977,8,0,6,3,17
4/29/1977,4,0,3,12,19
4/30/1977,2,0,2,0,4
5/1/1977,4,0,7,2,13
5/2/1977,3,0,3,7,13
5/3/1977,8,0,8,12,28
5/4/1977,7,0,8,13,28
5/5/1977,7,0,8,12,27
5/6/1977,8,0,7,7,22
5/7/1977,6,0,7,6,19
5/8/1977,5,0,3,9,17
5/9/1977,2,0,3,6,11
5/10/1977,3,0,2,11,16
5/11/1977,3,0,6,2,11
5/12/1977,8,0,6,3,17
5/13/1977,6,0,4,2,12
5/14/1977,5,0,4,12,21
5/15/1977,5,0,7,8,20
5/16/1977,4,0,5,1,10
5/17/1977,5,0,2,1,8
5/18/1977,2,0,4,11,17
5/19/1977,4,0,2,11,17
5/20/1977,4,0,4,11,19
5/21/1977,5,0,5,4,14
5/22/1977,2,0,6,10,18
5/23/1977,6,0,6,13,25
5/24/1977,3,0,5,4,12
5/25/1977,3,0,2,8,13
5/26/1977,6,0,3,2,11
5/27/1977,6,0,8,8,22
5/28/1977,8,0,8,4,20
5/29/1977,4,0,3,9,16
5/30/1977,4,0,3,5,12
5/31/1977,4,0,5,5,14
6/1/1977,7,0,2,1,10
6/2/1977,3,0,2,6,11
6/3/1977,7,0,6,0,13
6/4/1977,7,0,3,7,17
6/5/1977,5,0,4,0,9
6/6/1977,8,0,8,8,24
6/7/1977,5,0,4,11,20
6/8/1977,3,0,2,10,15
6/9/1977,7,0,7,10,24
6/10/1977,5,0,2,6,13
6/11/1977,8,0,4,9,21
6/12/1977,3,0,2,11,16
6/13/1977,7,0,6,9,22
6/14/1977,6,0,4,9,19
6/15/1977,4,0,6,7,17
6/16/1977,5,0,3,2,10
6/17/1977,6,0,2,0,8
6/18/1977,2,0,2,3,7
6/19/1977,2,0,5,3,10
6/20/1977,7,0,5,6,18
6/21/1977,6,0,7,3,16
6/22/1977,6,0,8,4,18
6/23/1977,3,0,7,10,20
6/24/1977,4,0,3,13,20
6/25/1977,7,0,4,3,14
6/26/1977,8,0,3,10,21
6/27/1977,4,0,2,4,10
6/28/1977,5,0,4,10,19
6/29/1977,5,0,5,13,23
6/30/1977,3,0,2,9,14
7/1/1977,2,0,3,0,5
7/2/1977,7,0,3,4,14
7/3/1977,7,0,4,13,24
7/4/1977,2,0,2,7,11
7/5/1977,4,0,2,12,18
7/6/1977,4,0,8,3,15
7/7/1977,2,0,4,11,17
7/8/1977,5,0,6,9,20
7/9/1977,8,0,6,10,24
7/10/1977,4,0,2,5,11
7/11/1977,8,0,2,4,14
7/12/1977,3,0,5,6,14
7/13/1977,4,0,3,2,9
7/14/1977,5,0,8,9,22
7/15/1977,8,0,6,9,23
7/16/1977,5,0,7,4,16
7/17/1977,4,0,7,9,20
7/18/1977,3,0,3,10,16
7/19/1977,4,0,5,13,22
7/20/1977,4,0,3,4,11
7/21/1977,6,0,3,8,17
7/22/1977,4,0,3,6,13
7/23/1977,6,0,2,5,13
7/24/1977,3,0,8,9,20
7/25/1977,6,0,2,10,18
7/26/1977,6,0,2,3,11
7/27/1977,7,0,5,11,23
7/28/1977,7,0,7,0,14
7/29/1977,2,0,2,8,12
7/30/1977,3,0,8,13,24
7/31/1977,4,0,6,3,13
8/1/1977,3,0,4,10,17
8/2/1977,3,0,6,1,10
8/3/1977,3,0,7,2,12
8/4/1977,8,0,6,11,25
8/5/1977,3,0,7,4,14
8/6/1977,7,0,6,10,23
8/7/1977,5,0,6,12,23
8/8/1977,2,0,8,0,10
8/9/1977,5,0,6,9,20
8/10/1977,3,0,2,5,10
8/11/1977,3,0,5,0,8
8/12/1977,5,0,2,0,7
8/13/1977,2,0,4,7,13
8/14/1977,4,0,5,11,20
8/15/1977,7,0,5,5,17
8/16/1977,6,0,3,2,11
8/17/1977,4,0,2,11,17
8/18/1977,4,0,2,8,14
8/19/1977,7,0,5,4,16
8/20/1977,4,0,3,1,8
8/21/1977,2,0,7,5,14
8/22/1977,5,0,8,4,17
8/23/1977,4,0,2,8,14
8/24/1977,2,0,4,7,13
8/25/1977,7,0,6,4,17
8/26/1977,3,0,3,5,11
8/27/1977,5,0,5,0,10
8/28/1977,6,0,7,4,17
8/29/1977,6,0,4,9,19
8/30/1977,4,0,6,5,15
8/31/1977,7,0,8,1,16
9/1/1977,7,0,3,5,15
9/2/1977,2,0,7,13,22
9/3/1977,5,0,2,11,18
9/4/1977,4,0,5,3,12
9/5/1977,6,0,8,12,26
9/6/1977,5,0,8,6,19
9/7/1977,3,0,7,7,17
9/8/1977,8,0,4,4,16
9/9/1977,8,0,6,12,26
9/10/1977,6,0,4,2,12
9/11/1977,4,0,7,7,18
9/12/1977,3,0,4,8,15
9/13/1977,7,0,2,11,20
9/14/1977,6,0,8,10,24
9/15/1977,7,0,7,13,27
9/16/1977,7,0,3,1,11
9/17/1977,6,0,5,7,18
9/18/1977,7,0,5,11,23
9/19/1977,3,0,2,6,11
9/20/1977,2,0,3,2,7
9/21/1977,3,0,5,9,17
9/22/1977,4,0,4,10,18
9/23/1977,7,0,7,10,24
9/24/1977,8,0,8,10,26
9/25/1977,7,0,5,2,14
9/26/1977,8,0,4,7,19
9/27/1977,5,0,7,7,19
9/28/1977,6,0,4,1,11
9/29/1977,4,0,4,2,10
9/30/1977,2,0,5,1,8
10/1/1977,4,0,8,13,25
10/2/1977,4,0,8,10,22
10/3/1977,7,0,2,8,17
10/4/1977,8,0,5,8,21
10/5/1977,4,0,7,3,14
10/6/1977,2,0,7,10,19
10/7/1977,3,0,7,0,10
10/8/1977,6,0,4,11,21
10/9/1977,3,0,7,2,12
10/10/1977,4,0,3,12,19
10/11/1977,2,0,5,10,17
10/12/1977,7,0,5,8,20
10/13/1977,8,0,3,4,15
10/14/1977,3,0,7,10,20
10/15/1977,5,0,7,1,13
10/16/1977,5,0,5,8,18
10/17/1977,4,0,8,10,22
10/18/1977,8,0,5,8,21
10/19/1977,6,0,3,12,21
10/20/1977,7,0,3,2,12
10/21/1977,2,0,7,5,14
10/22/1977,7,0,3,3,13
10/23/1977,8,0,6,10,24
10/24/1977,6,0,3,10,19
10/25/1977,2,0,5,8,15
10/26/1977,2,0,8,13,23
10/27/1977,6,0,7,12,25
10/28/1977,3,0,6,12,21
10/29/1977,8,0,5,2,15
10/30/1977,7,0,5,11,23
10/31/1977,4,0,3,4,11
11/1/1977,6,0,7,4,17
11/2/1977,8,0,6,10,24
11/3/1977,7,0,8,2,17
11/4/1977,6,0,2,4,12
11/5/1977,6,0,7,0,13
11/6/1977,8,0,5,11,24
11/7/1977,8,0,3,7,18
11/8/1977,7,0,2,3,12
11/9/1977,5,0,8,12,25
11/10/1977,4,0,7,4,15
11/11/1977,8,0,2,12,22
11/12/1977,7,0,2,13,22
11/13/1977,5,0,6,5,16
11/14/1977,8,0,3,6,17
11/15/1977,6,0,2,6,14
11/16/1977,4,0,6,5,15
11/17/1977,3,0,3,11,17
11/18/1977,6,0,8,1,15
11/19/1977,3,0,7,9,19
11/20/1977,4,0,2,6,12
11/21/1977,4,0,4,7,15
11/22/1977,6,0,7,13,26
11/23/1977,2,0,2,9,13
11/24/1977,3,0,7,6,16
11/25/1977,6,0,6,1,13
11/26/1977,7,0,3,9,19
11/27/1977,5,0,7,0,12
11/28/1977,8,0,8,4,20
11/29/1977,6,0,4,3,13
11/30/1977,3,0,5,0,8
12/1/1977,7,0,7,0,14
12/2/1977,3,0,8,3,14
12/3/1977,7,0,5,7,19
12/4/1977,4,0,5,3,12
12/5/1977,4,0,8,1,13
12/6/1977,6,0,4,12,22
12/7/1977,4,0,4,5,13
12/8/1977,8,0,2,13,23
12/9/1977,8,0,7,13,28
12/10/1977,6,0,8,3,17
12/11/1977,2,0,5,4,11
12/12/1977,8,0,7,12,27
12/13/1977,6,0,8,0,14
12/14/1977,8,0,5,2,15
12/15/1977,2,0,6,3,11
12/16/1977,6,0,3,11,20
12/17/1977,5,0,5,8,18
12/18/1977,4,0,6,2,12
12/19/1977,7,0,7,2,16
12/20/1977,2,0,2,13,17
12/21/1977,6,0,4,2,12
12/22/1977,3,0,8,11,22
12/23/1977,2,0,4,7,13
12/24/1977,2,0,7,0,9
12/25/1977,3,0,4,7,14
12/26/1977,5,0,3,6,14
12/27/1977,2,0,4,10,16
12/28/1977,8,0,8,5,21
12/29/1977,3,0,5,6,14
12/30/1977,4,0,6,8,18
12/31/1977,3,0,2,3,8
1/1/1978,6,0,5,1,12
1/2/1978,8,0,3,12,23
1/3/1978,3,0,2,10,15
1/4/1978,2,0,3,6,11
1/5/1978,4,0,2,0,6
1/6/1978,6,0,4,2,12
1/7/1978,8,0,6,3,17
1/8/1978,8,0,6,5,19
1/9/1978,8,0,6,3,17
1/10/1978,7,0,3,1,11
1/11/1978,4,0,3,8,15
1/12/1978,7,0,7,9,23
1/13/1978,5,0,2,1,8
1/14/1978,3,0,6,5,14
1/15/1978,7,0,7,0,14
1/16/1978,8,0,7,9,24
1/17/1978,2,0,4,6,12
1/18/1978,5,0,6,5,16
1/19/1978,4,0,4,0,8
1/20/1978,6,0,4,2,12
1/21/1978,2,0,2,7,11
1/22/1978,8,0,2,1,11
1/23/1978,6,0,3,6,15
1/24/1978,5,0,7,8,20
1/25/1978,6,0,7,3,16
1/26/1978,4,0,6,3,13
1/27/1978,8,0,3,4,15
1/28/1978,6,0,2,8,16
1/29/1978,6,0,4,9,19
1/30/1978,5,0,3,9,17
1/31/1978,5,0,8,2,15
2/1/1978,6,0,8,1,15
2/2/1978,2,0,5,1,8
2/3/1978,4,0,5,7,16
2/4/1978,2,0,3,0,5
2/5/1978,6,0,8,10,24
2/6/1978,2,0,4,2,8
2/7/1978,2,0,7,2,11
2/8/1978,4,0,8,4,16
2/9/1978,8,0,5,7,20
2/10/1978,3,0,3,3,9
2/11/1978,3,0,7,3,13
2/12/1978,4,0,5,12,21
2/13/1978,4,0,2,3,9
2/14/1978,2,0,6,11,19
2/15/1978,5,0,4,0,9
2/16/1978,5,0,2,13,20
2/17/1978,8,0,3,11,22
2/18/1978,7,0,2,9,18
2/19/1978,4,0,5,5,14
2/20/1978,8,0,3,3,14
2/21/1978,8,0,8,4,20
2/22/1978,7,0,3,3,13
2/23/1978,4,0,5,6,15
2/24/1978,7,0,5,5,17
2/25/1978,2,0,7,6,15
2/26/1978,2,0,6,11,19
2/27/1978,4,0,3,11,18
2/28/1978,8,0,3,4,15
3/1/1978,7,0,4,9,20
3/2/1978,2,0,2,7,11
3/3/1978,6,0,7,6,19
3/4/1978,4,0,3,9,16
3/5/1978,2,0,5,2,9
3/6/1978,5,0,5,13,23
3/7/1978,6,0,5,2,13
3/8/1978,2,0,5,8,15
3/9/1978,8,0,5,5,18
3/10/1978,7,0,6,2,15
3/11/1978,7,0,6,6,19
3/12/1978,3,0,6,7,16
3/13/1978,7,0,2,3,12
3/14/1978,6,0,7,7,20
3/15/1978,4,0,8,9,21
3/16/1978,2,0,2,7,11
3/17/1978,2,0,4,5,11
3/18/1978,6,0,6,5,17
3/19/1978,4,0,6,8,18
3/20/1978,8,0,7,11,26
3/21/1978,6,0,8,8,22
3/22/1978,8,0,8,12,28
3/23/1978,6,0,6,10,22
3/24/1978,2,0,4,8,14
3/25/1978,3,0,7,1,11
3/26/1978,3,0,5,10,18
3/27/1978,3,0,5,1,9
3/28/1978,7,0,4,11,22
3/29/1978,3,0,5,12,20
3/30/1978,7,0,2,8,17
3/31/1978,2,0,6,0,8
4/1/1978,5,0,5,13,23
4/2/1978,8,0,7,8,23
4/3/1978,7,0,5,4,16
4/4/1978,3,0,3,0,6
4/5/1978,4,0,6,11,21
4/6/1978,7,0,7,0,14
4/7/1978,4,0,5,6,15
4/8/1978,7,0,3,6,16
4/9/1978,7,0,7,7,21
4/10/1978,6,0,3,4,13
4/11/1978,8,0,4,10,22
4/12/1978,4,0,5,1,10
4/13/1978,4,0,6,10,20
4/14/1978,8,0,7,4,19
4/15/1978,6,0,6,7,19
4/16/1978,5,0,3,12,20
4/17/1978,2,0,8,13,23
4/18/1978,3,0,6,6,15
4/19/1978,6,0,8,8,22
4/20/1978,7,0,3,3,13
4/21/1978,5,0,6,6,17
4/22/1978,6,0,5,4,15
4/23/1978,8,0,4,1,13
4/24/1978,7,0,8,9,24
4/25/1978,6,0,8,0,14
4/26/1978,2,0,6,13,21
4/27/1978,5,0,6,5,16
4/28/1978,4,0,6,12,22
4/29/1978,6,0,3,12,21
4/30/1978,4,0,2,13,19
5/1/1978,6,0,5,8,19
5/2/1978,2,0,3,2,7
5/3/1978,2,0,8,10,20
5/4/1978,5,0,5,9,19
5/5/1978,5,0,3,6,14
5/6/1978,4,0,3,2,9
5/7/1978,8,0,2,1,11
5/8/1978,7,0,7,12,26
5/9/1978,6,0,2,1,9
5/10/1978,8,0,7,0,15
5/11/1978,6,0,5,3,14
5/12/1978,4,0,7,3,14
5/13/1978,2,0,6,4,12
5/14/1978,7,0,6,11,24
5/15/1978,4,0,6,5,15
5/16/1978,5,0,3,10,18
5/17/1978,7,0,4,1,12
5/18/1978,6,0,7,6,19
5/19/1978,3,0,7,6,16
5/20/1978,6,0,6,6,18
5/21/1978,6,0,7,8,21
5/22/1978,5,0,7,3,15
5/23/1978,2,0,4,10,16
5/24/1978,3,0,3,4,10
5/25/1978,5,0,8,5,18
5/26/1978,3,0,4,13,20
5/27/1978,7,0,2,6,15
5/28/1978,8,0,3,0,11
5/29/1978,3,0,8,11,22
5/30/1978,8,0,4,8,20
5/31/1978,7,0,4,7,18
6/1/1978,4,0,4,13,21
6/2/1978,6,0,4,7,17
6/3/1978,8,0,5,7,20
6/4/1978,5,0,5,11,21
6/5/1978,8,0,8,4,20
6/6/1978,7,0,3,2,12
6/7/1978,2,0,8,11,21
6/8/1978,3,0,4,10,17
6/9/1978,7,0,4,9,20
6/10/1978,3,0,3,5,11
6/11/1978,4,0,8,12,24
6/12/1978,4,0,7,1,12
6/13/1978,2,0,4,2,8
6/14/1978,2,0,5,0,7
6/15/1978,2,0,4,8,14
6/16/1978,5,0,7,1,13
6/17/1978,5,0,8,6,19
6/18/1978,2,0,4,2,8
6/19/1978,6,0,6,9,21
6/20/1978,8,0,3,12,23
6/21/1978,4,0,2,11,17
6/22/1978,7,0,2,0,9
6/23/1978,4,0,8,6,18
6/24/1978,6,0,3,13,22
6/25/1978,5,0,7,11,23
6/26/1978,7,0,5,8,20
6/27/1978,5,0,8,9,22
6/28/1978,3,0,2,1,6
6/29/1978,2,0,8,5,15
6/30/1978,7,0,6,12,25
7/1/1978,7,0,3,5,15
7/2/1978,8,0,6,9,23
7/3/1978,8,0,7,6,21
7/4/1978,3,0,7,0,10
7/5/1978,4,0,2,5,11
7/6/1978,3,0,6,1,10
7/7/1978,5,0,8,4,17
7/8/1978,7,0,4,4,15
7/9/1978,8,0,7,6,21
7/10/1978,6,0,2,3,11
7/11/1978,5,0,3,5,13
7/12/1978,5,0,4,5,14
7/13/1978,4,0,8,13,25
7/14/1978,5,0,6,13,24
7/15/1978,3,0,4,6,13
7/16/1978,4,0,7,11,22
7/17/1978,8,0,2,5,15
7/18/1978,7,0,3,5,15
7/19/1978,7,0,4,8,19
7/20/1978,2,0,5,10,17
7/21/1978,3,0,3,3,9
7/22/1978,6,0,8,7,21
7/23/1978,6,0,6,13,25
7/24/1978,5,0,6,13,24
7/25/1978,2,0,5,1,8
7/26/1978,6,0,4,8,18
7/27/1978,7,0,8,4,19
7/28/1978,3,0,6,9,18
7/29/1978,3,0,3,13,19
7/30/1978,4,0,2,7,13
7/31/1978,4,0,8,11,23
8/1/1978,2,0,4,5,11
8/2/1978,4,0,6,7,17
8/3/1978,6,0,5,8,19
8/4/1978,4,0,8,8,20
8/5/1978,4,0,3,2,9
8/6/1978,8,0,2,5,15
8/7/1978,3,0,6,1,10
8/8/1978,7,0,3,3,13
8/9/1978,2,0,8,9,19
8/10/1978,5,0,2,10,17
8/11/1978,4,0,5,8,17
8/12/1978,3,0,4,5,12
8/13/1978,5,0,6,1,12
8/14/1978,3,0,5,10,18
8/15/1978,3,0,6,5,14
8/16/1978,4,0,7,12,23
8/17/1978,3,0,2,8,13
8/18/1978,5,0,7,6,18
8/19/1978,2,0,7,7,16
8/20/1978,5,0,4,6,15
8/21/1978,5,0,7,3,15
8/22/1978,8,0,2,6,16
8/23/1978,3,0,4,8,15
8/24/1978,6,0,8,8,22
8/25/1978,7,0,2,12,21
8/26/1978,7,0,6,8,21
8/27/1978,7,0,3,10,20
8/28/1978,2,0,7,0,9
8/29/1978,7,0,5,9,21
8/30/1978,4,0,8,12,24
8/31/1978,5,0,8,9,22
9/1/1978,2,0,8,6,16
9/2/1978,7,0,6,10,23
9/3/1978,3,0,6,1,10
9/4/1978,8,0,8,1,17
9/5/1978,7,0,4,0,11
9/6/1978,5,0,5,13,23
9/7/1978,7,0,6,9,22
9/8/1978,5,0,4,7,16
9/9/1978,2,0,6,9,17
9/10/1978,4,0,8,13,25
9/11/1978,3,0,8,7,18
9/12/1978,7,0,4,6,17
9/13/1978,4,0,5,2,11
9/14/1978,8,0,7,9,24
9/15/1978,6,0,7,1,14
9/16/1978,5,0,3,13,21
9/17/1978,5,0,8,0,13
9/18/1978,7,0,4,11,22
9/19/1978,6,0,3,6,15
9/20/1978,4,0,6,11,21
9/21/1978,3,0,4,10,17
9/22/1978,8,0,6,9,23
9/23/1978,6,0,6,12,24
9/24/1978,8,0,5,8,21
9/25/1978,8,0,8,6,22
9/26/1978,2,0,5,5,12
9/27/1978,6,0,3,4,13
9/28/1978,2,0,5,8,15
9/29/1978,8,0,6,1,15
9/30/1978,4,0,6,6,16
10/1/1978,3,0,2,12,17
10/2/1978,5,0,6,11,22
10/3/1978,4,0,5,2,11
10/4/1978,3,0,7,1,11
10/5/1978,3,0,7,10,20
10/6/1978,7,0,6,2,15
10/7/1978,8,0,5,7,20
10/8/1978,5,0,7,3,15
10/9/1978,7,0,4,10,21
10/10/1978,5,0,2,1,8
10/11/1978,7,0,5,3,15
10/12/1978,7,0,2,11,20
10/13/1978,6,0,3,7,16
10/14/1978,8,0,7,2,17
10/15/1978,6,0,4,3,13
10/16/1978,7,0,2,12,21
10/17/1978,2,0,4,8,14
10/18/1978,3,0,6,12,21
10/19/1978,3,0,7,2,12
10/20/1978,6,0,8,3,17
10/21/1978,7,0,4,2,13
10/22/1978,6,0,8,13,27
10/23/1978,4,0,3,13,20
10/24/1978,5,0,7,0,12
10/25/1978,8,0,3,0,11
10/26/1978,3,0,8,11,22
10/27/1978,2,0,2,12,16
10/28/1978,8,0,3,10,21
10/29/1978,8,0,5,12,25
10/30/1978,4,0,4,12,20
10/31/1978,6,0,8,10,24
11/1/1978,5,0,2,8,15
11/2/1978,8,0,5,4,17
11/3/1978,2,0,4,4,10
11/4/1978,7,0,5,2,14
11/5/1978,7,0,7,9,23
11/6/1978,3,0,7,0,10
11/7/1978,7,0,2,8,17
11/8/1978,8,0,4,0,12
11/9/1978,5,0,7,5,17
11/10/1978,5,0,3,6,14
11/11/1978,4,0,8,0,12
11/12/1978,3,0,3,2,8
11/13/1978,3,0,3,0,6
11/14/1978,5,0,3,11,19
11/15/1978,7,0,7,12,26
11/16/1978,3,0,5,8,16
11/17/1978,6,0,4,8,18
11/18/1978,5,0,5,3,13
11/19/1978,2,0,2,5,9
11/20/1978,2,0,5,4,11
11/21/1978,6,0,2,2,10
11/22/1978,7,0,8,2,17
11/23/1978,7,0,2,1,10
11/24/1978,7,0,3,2,12
11/25/1978,2,0,3,0,5
11/26/1978,6,0,3,3,12
11/27/1978,7,0,2,13,22
11/28/1978,3,0,5,7,15
11/29/1978,6,0,6,8,20
11/30/1978,6,0,2,3,11
12/1/1978,3,0,7,5,15
12/2/1978,2,0,2,3,7
12/3/1978,5,0,7,4,16
12/4/1978,4,0,8,3,15
12/5/1978,5,0,5,5,15
12/6/1978,8,0,8,8,24
12/7/1978,8,0,2,5,15
12/8/1978,6,0,4,12,22
12/9/1978,3,0,5,5,13
12/10/1978,3,0,5,4,12
12/11/1978,8,0,5,9,22
12/12/1978,8,0,2,6,16
12/13/1978,7,0,7,1,15
12/14/1978,2,0,6,2,10
12/15/1978,2,0,5,0,7
12/16/1978,4,0,3,5,12
12/17/1978,4,0,4,9,17
12/18/1978,4,0,7,2,13
12/19/1978,8,0,2,5,15
12/20/1978,6,0,7,5,18
12/21/1978,4,0,5,7,16
12/22/1978,7,0,2,0,9
12/23/1978,4,0,4,6,14
12/24/1978,6,0,4,2,12
12/25/1978,6,0,2,9,17
12/26/1978,7,0,2,12,21
12/27/1978,2,0,6,10,18
12/28/1978,6,0,4,13,23
12/29/1978,8,0,2,3,13
12/30/1978,8,0,6,2,16
12/31/1978,7,0,3,7,17
1/1/1979,5,0,2,10,17
1/2/1979,7,0,6,2,15
1/3/1979,5,0,2,1,8
1/4/1979,4,0,4,8,16
1/5/1979,6,0,2,11,19
1/6/1979,8,0,6,11,25
1/7/1979,6,0,2,6,14
1/8/1979,8,0,3,3,14
1/9/1979,5,0,5,8,18
1/10/1979,6,0,7,3,16
1/11/1979,5,0,2,5,12
1/12/1979,8,0,8,7,23
1/13/1979,3,0,7,13,23
1/14/1979,4,0,6,2,12
1/15/1979,4,0,7,11,22
1/16/1979,7,0,6,3,16
1/17/1979,5,0,4,9,18
1/18/1979,3,0,3,7,13
1/19/1979,2,0,3,3,8
1/20/1979,7,0,6,8,21
1/21/1979,7,0,8,8,23
1/22/1979,3,0,2,4,9
1/23/1979,8,0,6,11,25
1/24/1979,3,0,2,0,5
1/25/1979,7,0,3,5,15
1/26/1979,5,0,6,7,18
1/27/1979,4,0,5,6,15
1/28/1979,5,0,6,13,24
1/29/1979,5,0,7,12,24
1/30/1979,8,0,7,6,21
1/31/1979,5,0,4,4,13
2/1/1979,5,0,4,4,13
2/2/1979,5,0,2,0,7
2/3/1979,8,0,8,13,29
2/4/1979,4,0,4,6,14
2/5/1979,5,0,4,0,9
2/6/1979,3,0,6,1,10
2/7/1979,5,0,6,6,17
2/8/1979,3,0,8,10,21
2/9/1979,5,0,8,3,16
2/10/1979,5,0,4,7,16
2/11/1979,8,0,4,10,22
2/12/1979,6,0,2,6,14
2/13/1979,4,0,8,11,23
2/14/1979,8,0,7,4,19
2/15/1979,4,0,7,13,24
2/16/1979,2,0,2,4,8
2/17/1979,6,0,8,13,27
2/18/1979,6,0,8,5,19
2/19/1979,3,0,2,6,11
2/20/1979,7,0,4,0,11
2/21/1979,8,0,5,6,19
2/22/1979,6,0,8,5,19
2/23/1979,7,0,3,11,21
2/24/1979,4,0,3,13,20
2/25/1979,6,0,6,0,12
2/26/1979,8,0,2,11,21
2/27/1979,5,0,6,7,18
2/28/1979,6,0,3,8,17
3/1/1979,8,0,5,0,13
3/2/1979,8,0,4,11,23
3/3/1979,3,0,5,13,21
3/4/1979,2,0,5,11,18
3/5/1979,6,0,8,11,25
3/6/1979,7,0,4,2,13
3/7/1979,4,0,5,7,16
3/8/1979,6,0,3,6,15
3/9/1979,4,0,7,11,22
3/10/1979,5,0,8,13,26
3/11/1979,2,0,5,10,17
3/12/1979,4,0,3,5,12
3/13/1979,8,0,8,3,19
3/14/1979,6,0,6,12,24
3/15/1979,3,0,5,12,20
3/16/1979,2,0,6,11,19
3/17/1979,3,0,3,8,14
3/18/1979,3,0,7,11,21
3/19/1979,4,0,3,7,14
3/20/1979,3,0,3,6,12
3/21/1979,4,0,3,7,14
3/22/1979,7,0,7,6,20
3/23/1979,7,0,5,3,15
3/24/1979,8,0,7,13,28
3/25/1979,6,0,6,12,24
3/26/1979,4,0,6,5,15
3/27/1979,3,0,8,9,20
3/28/1979,3,0,8,9,20
3/29/1979,2,0,6,7,15
3/30/1979,5,0,3,0,8
3/31/1979,5,0,2,2,9
4/1/1979,4,0,5,8,17
4/2/1979,6,0,7,11,24
4/3/1979,2,0,6,8,16
4/4/1979,2,0,6,11,19
4/5/1979,5,0,2,10,17
4/6/1979,6,0,4,6,16
4/7/1979,2,0,5,11,18
4/8/1979,3,0,8,3,14
4/9/1979,7,0,7,0,14
4/10/1979,6,0,4,11,21
4/11/1979,7,0,8,1,16
4/12/1979,7,0,5,5,17
4/13/1979,7,0,7,13,27
4/14/1979,7,0,8,1,16
4/15/1979,6,0,5,1,12
4/16/1979,7,0,6,10,23
4/17/1979,2,0,7,10,19
4/18/1979,5,0,7,1,13
4/19/1979,6,0,7,10,23
4/20/1979,5,0,8,3,16
4/21/1979,2,0,8,7,17
4/22/1979,6,0,5,5,16
4/23/1979,3,0,3,4,10
4/24/1979,3,0,5,7,15
4/25/1979,6,0,3,10,19
4/26/1979,8,0,5,7,20
4/27/1979,8,0,8,0,16
4/28/1979,7,0,7,1,15
4/29/1979,2,0,4,1,7
4/30/1979,4,0,8,4,16
5/1/1979,6,0,3,12,21
5/2/1979,3,0,5,8,16
5/3/1979,4,0,3,9,16
5/4/1979,8,0,8,9,25
5/5/1979,8,0,8,5,21
5/6/1979,2,0,2,6,10
5/7/1979,5,0,6,5,16
5/8/1979,8,0,2,13,23
5/9/1979,4,0,2,4,10
5/10/1979,7,0,4,7,18
5/11/1979,7,0,2,7,16
5/12/1979,6,0,4,5,15
5/13/1979,4,0,4,1,9
5/14/1979,7,0,7,4,18
5/15/1979,2,0,5,7,14
5/16/1979,5,0,6,12,23
5/17/1979,7,0,8,1,16
5/18/1979,7,0,5,11,23
5/19/1979,7,0,4,3,14
5/20/1979,3,0,7,8,18
5/21/1979,6,0,6,2,14
5/22/1979,3,0,5,12,20
5/23/1979,5,0,3,12,20
5/24/1979,6,0,7,3,16
5/25/1979,2,0,8,7,17
5/26/1979,7,0,6,10,23
5/27/1979,5,0,7,9,21
5/28/1979,8,0,8,6,22
5/29/1979,8,0,3,1,12
5/30/1979,4,0,4,2,10
5/31/1979,5,0,2,5,12
6/1/1979,4,0,7,5,16
6/2/1979,8,0,6,7,21
6/3/1979,3,0,7,12,22
6/4/1979,3,0,8,10,21
6/5/1979,7,0,6,2,15
6/6/1979,3,0,4,13,20
6/7/1979,3,0,4,3,10
6/8/1979,5,0,2,11,18
6/9/1979,4,0,8,7,19
6/10/1979,3,0,6,3,12
6/11/1979,3,0,2,6,11
6/12/1979,5,0,4,1,10
6/13/1979,5,0,6,9,20
6/14/1979,7,0,7,5,19
6/15/1979,5,0,2,2,9
6/16/1979,4,0,7,12,23
6/17/1979,6,0,7,11,24
6/18/1979,2,0,7,0,9
6/19/1979,5,0,7,0,12
6/20/1979,3,0,6,7,16
6/21/1979,3,0,3,9,15
6/22/1979,3,0,8,3,14
6/23/1979,6,0,2,8,16
6/24/1979,8,0,8,9,25
6/25/1979,3,0,5,6,14
6/26/1979,3,0,4,1,8
6/27/1979,6,0,4,6,16
6/28/1979,4,0,4,5,13
6/29/1979,7,0,4,0,11
6/30/1979,5,0,2,5,12
7/1/1979,7,0,5,9,21
7/2/1979,6,0,4,13,23
7/3/1979,5,0,7,2,14
7/4/1979,3,0,4,4,11
7/5/1979,6,0,6,9,21
7/6/1979,2,0,7,12,21
7/7/1979,8,0,6,1,15
7/8/1979,2,0,6,8,16
7/9/1979,2,0,5,6,13
7/10/1979,7,0,2,8,17
7/11/1979,5,0,5,6,16
7/12/1979,4,0,2,7,13
7/13/1979,8,0,4,8,20
7/14/1979,5,0,4,3,12
7/15/1979,8,0,8,13,29
7/16/1979,4,0,3,4,11
7/17/1979,4,0,6,3,13
7/18/1979,4,0,2,0,6
7/19/1979,2,0,6,13,21
7/20/1979,5,0,3,10,18
7/21/1979,6,0,5,5,16
7/22/1979,5,0,3,7,15
7/23/1979,8,0,3,11,22
7/24/1979,5,0,3,10,18
7/25/1979,2,0,3,3,8
7/26/1979,5,0,2,6,13
7/27/1979,7,0,3,10,20
7/28/1979,3,0,4,2,9
7/29/1979,8,0,4,3,15
7/30/1979,5,0,5,3,13
7/31/1979,2,0,5,12,19
8/1/1979,4,0,8,2,14
8/2/1979,6,0,8,13,27
8/3/1979,8,0,4,13,25
8/4/1979,4,0,6,7,17
8/5/1979,7,0,4,1,12
8/6/1979,5,0,7,8,20
8/7/1979,8,0,2,1,11
8/8/1979,6,0,8,3,17
8/9/1979,5,0,8,13,26
8/10/1979,5,0,3,13,21
8/11/1979,4,0,2,8,14
8/12/1979,6,0,5,11,22
8/13/1979,6,0,2,4,12
8/14/1979,7,0,5,10,22
8/15/1979,7,0,8,3,18
8/16/1979,6,0,7,9,22
8/17/1979,5,0,2,6,13
8/18/1979,6,0,7,2,15
8/19/1979,3,0,5,8,16
8/20/1979,8,0,7,3,18
8/21/1979,5,0,7,8,20
8/22/1979,5,0,4,5,14
8/23/1979,2,0,4,2,8
8/24/1979,4,0,8,1,13
8/25/1979,3,0,6,0,9
8/26/1979,3,0,8,8,19
8/27/1979,8,0,2,9,19
8/28/1979,4,0,5,5,14
8/29/1979,5,0,8,10,23
8/30/1979,4,0,4,13,21
8/31/1979,4,0,3,8,15
9/1/1979,5,0,5,11,21
9/2/1979,4,0,7,8,19
9/3/1979,2,0,8,1,11
9/4/1979,3,0,8,2,13
9/5/1979,3,0,8,6,17
9/6/1979,6,0,3,10,19
9/7/1979,2,0,6,0,8
9/8/1979,7,0,2,1,10
9/9/1979,8,0,6,2,16
9/10/1979,2,0,5,6,13
9/11/1979,4,0,4,5,13
9/12/1979,5,0,4,12,21
9/13/1979,8,0,2,1,11
9/14/1979,7,0,6,7,20
9/15/1979,5,0,2,2,9
9/16/1979,7,0,7,11,25
9/17/1979,5,0,7,9,21
9/18/1979,3,0,2,6,11
9/19/1979,3,0,7,2,12
9/20/1979,7,0,2,6,15
9/21/1979,2,0,4,10,16
9/22/1979,8,0,3,4,15
9/23/1979,7,0,3,7,17
9/24/1979,8,0,4,8,20
9/25/1979,5,0,7,9,21
9/26/1979,6,0,2,11,19
9/27/1979,5,0,8,4,17
9/28/1979,8,0,2,1,11
9/29/1979,4,0,6,1,11
9/30/1979,8,0,5,11,24
10/1/1979,2,0,7,2,11
10/2/1979,4,0,4,3,11
10/3/1979,7,0,4,11,22
10/4/1979,6,0,5,8,19
10/5/1979,3,0,7,12,22
10/6/1979,6,0,2,11,19
10/7/1979,2,0,7,8,17
10/8/1979,5,0,6,5,16
10/9/1979,7,0,5,1,13
10/10/1979,5,0,5,3,13
10/11/1979,3,0,3,9,15
10/12/1979,8,0,5,11,24
10/13/1979,6,0,4,13,23
10/14/1979,8,0,3,5,16
10/15/1979,4,0,8,5,17
10/16/1979,2,0,2,0,4
10/17/1979,4,0,3,12,19
10/18/1979,6,0,6,1,13
10/19/1979,3,0,2,7,12
10/20/1979,4,0,8,10,22
10/21/1979,4,0,2,10,16
10/22/1979,4,0,4,10,18
10/23/1979,4,0,4,5,13
10/24/1979,6,0,7,1,14
10/25/1979,5,0,6,0,11
10/26/1979,5,0,3,3,11
10/27/1979,7,0,2,10,19
10/28/1979,4,0,4,3,11
10/29/1979,2,0,5,12,19
10/30/1979,5,0,4,3,12
10/31/1979,8,0,6,4,18
11/1/1979,3,0,6,13,22
11/2/1979,8,0,3,6,17
11/3/1979,8,0,4,9,21
11/4/1979,5,0,6,12,23
11/5/1979,3,0,2,7,12
11/6/1979,3,0,5,12,20
11/7/1979,6,0,8,13,27
11/8/1979,6,0,2,5,13
11/9/1979,7,0,5,2,14
11/10/1979,7,0,7,7,21
11/11/1979,6,0,2,6,14
11/12/1979,2,0,6,9,17
11/13/1979,8,0,5,12,25
11/14/1979,8,0,5,3,16
11/15/1979,8,0,3,4,15
11/16/1979,2,0,4,10,16
11/17/1979,3,0,8,11,22
11/18/1979,6,0,5,1,12
11/19/1979,7,0,7,6,20
11/20/1979,6,0,8,1,15
11/21/1979,7,0,6,0,13
11/22/1979,6,0,3,6,15
11/23/1979,7,0,6,4,17
11/24/1979,2,0,6,2,10
11/25/1979,2,0,3,8,13
11/26/1979,8,0,5,2,15
11/27/1979,3,0,4,1,8
11/28/1979,7,0,3,2,12
11/29/1979,3,0,4,1,8
11/30/1979,6,0,7,6,19
12/1/1979,4,0,4,0,8
12/2/1979,7,0,4,2,13
12/3/1979,4,0,4,3,11
12/4/1979,8,0,6,13,27
12/5/1979,5,0,4,13,22
12/6/1979,8,0,3,1,12
12/7/1979,2,0,2,12,16
12/8/1979,7,0,2,11,20
12/9/1979,3,0,3,10,16
12/10/1979,2,0,2,12,16
12/11/1979,2,0,8,4,14
12/12/1979,5,0,5,2,12
12/13/1979,4,0,8,9,21
12/14/1979,5,0,5,7,17
12/15/1979,8,0,4,13,25
12/16/1979,2,0,7,5,14
12/17/1979,5,0,5,3,13
12/18/1979,3,0,3,7,13
12/19/1979,2,0,7,11,20
12/20/1979,5,0,7,1,13
12/21/1979,2,0,7,5,14
12/22/1979,6,0,6,7,19
12/23/1979,3,0,6,4,13
12/24/1979,3,0,8,3,14
12/25/1979,4,0,3,3,10
12/26/1979,3,0,8,2,13
12/27/1979,6,0,2,7,15
12/28/1979,6,0,2,10,18
12/29/1979,5,0,3,0,8
12/30/1979,7,0,3,3,13
12/31/1979,7,0,3,11,21
1/1/1980,6,0,6,3,15
1/2/1980,3,0,6,9,18
1/3/1980,8,0,7,8,23
1/4/1980,2,0,3,5,10
1/5/1980,7,0,2,2,11
1/6/1980,6,0,3,2,11
1/7/1980,4,0,4,13,21
1/8/1980,8,0,4,4,16
1/9/1980,5,0,6,12,23
1/10/1980,6,0,7,7,20
1/11/1980,5,0,3,6,14
1/12/1980,5,0,4,9,18
1/13/1980,2,0,7,6,15
1/14/1980,7,0,6,6,19
1/15/1980,5,0,7,9,21
1/16/1980,4,0,4,0,8
1/17/1980,5,0,3,13,21
1/18/1980,2,0,3,12,17
1/19/1980,4,0,4,5,13
1/20/1980,6,0,8,6,20
1/21/1980,5,0,5,9,19
1/22/1980,8,0,7,1,16
1/23/1980,6,0,7,1,14
1/24/1980,8,0,5,1,14
1/25/1980,7,0,8,12,27
1/26/1980,6,0,6,0,12
1/27/1980,2,0,6,2,10
1/28/1980,8,0,8,13,29
1/29/1980,3,0,3,0,6
1/30/1980,7,0,8,13,28
1/31/1980,8,0,7,5,20
2/1/1980,5,0,7,0,12
2/2/1980,7,0,2,10,19
2/3/1980,8,0,8,4,20
2/4/1980,6,0,3,12,21
2/5/1980,7,0,3,2,12
2/6/1980,7,0,7,5,19
2/7/1980,4,0,7,7,18
2/8/1980,3,0,4,5,12
2/9/1980,4,0,2,10,16
2/10/1980,6,0,8,6,20
2/11/1980,2,0,7,0,9
2/12/1980,2,0,6,3,11
2/13/1980,4,0,3,3,10
2/14/1980,4,0,3,3,10
2/15/1980,3,0,2,3,8
2/16/1980,5,0,7,0,12
2/17/1980,7,0,7,0,14
2/18/1980,5,0,6,11,22
2/19/1980,6,0,6,13,25
2/20/1980,6,0,3,0,9
2/21/1980,5,0,7,13,25
2/22/1980,2,0,2,7,11
2/23/1980,4,0,6,0,10
2/24/1980,6,0,2,8,16
2/25/1980,2,0,3,10,15
2/26/1980,7,0,3,11,21
2/27/1980,7,0,4,8,19
2/28/1980,7,0,5,2,14
2/29/1980,4,0,6,8,18
3/1/1980,2,0,3,6,11
3/2/1980,6,0,6,5,17
3/3/1980,5,0,5,8,18
3/4/1980,8,0,8,1,17
3/5/1980,3,0,6,0,9
3/6/1980,4,0,5,5,14
3/7/1980,7,0,6,2,15
3/8/1980,2,0,6,0,8
3/9/1980,3,0,3,8,14
3/10/1980,6,0,3,12,21
3/11/1980,8,0,8,9,25
3/12/1980,8,0,3,4,15
3/13/1980,7,0,7,7,21
3/14/1980,5,0,6,7,18
3/15/1980,7,0,2,9,18
3/16/1980,4,0,7,9,20
3/17/1980,6,0,7,1,14
3/18/1980,7,0,3,4,14
3/19/1980,4,0,4,3,11
3/20/1980,8,0,5,4,17
3/21/1980,7,0,4,10,21
3/22/1980,2,0,7,9,18
3/23/1980,3,0,3,7,13
3/24/1980,4,0,2,8,14
3/25/1980,2,0,2,4,8
3/26/1980,4,0,2,7,13
3/27/1980,8,0,6,3,17
3/28/1980,8,0,8,2,18
3/29/1980,6,0,5,11,22
3/30/1980,8,0,6,8,22
3/31/1980,5,0,8,13,26
4/1/1980,4,0,3,3,10
4/2/1980,5,0,4,4,13
4/3/1980,4,0,3,4,11
4/4/1980,4,0,2,13,19
4/5/1980,4,0,5,11,20
4/6/1980,7,0,4,3,14
4/7/1980,7,0,6,9,22
4/8/1980,3,0,3,12,18
4/9/1980,5,0,4,1,10
4/10/1980,4,0,6,6,16
4/11/1980,3,0,2,2,7
4/12/1980,8,0,6,2,16
4/13/1980,4,0,8,8,20
4/14/1980,8,0,3,1,12
4/15/1980,7,0,4,12,23
4/16/1980,6,0,4,11,21
4/17/1980,5,0,4,12,21
4/18/1980,2,0,8,11,21
4/19/1980,2,0,4,5,11
4/20/1980,7,0,7,13,27
4/21/1980,2,0,5,12,19
4/22/1980,3,0,8,3,14
4/23/1980,5,0,8,2,15
4/24/1980,2,0,3,2,7
4/25/1980,7,0,6,2,15
4/26/1980,4,0,5,10,19
4/27/1980,5,0,4,0,9
4/28/1980,5,0,5,0,10
4/29/1980,5,0,8,2,15
4/30/1980,2,0,2,4,8
5/1/1980,6,0,2,8,16
5/2/1980,6,0,8,1,15
5/3/1980,7,0,4,6,17
5/4/1980,6,0,7,3,16
5/5/1980,5,0,3,8,16
5/6/1980,4,0,3,12,19
5/7/1980,8,0,6,4,18
5/8/1980,3,0,5,12,20
5/9/1980,6,0,5,2,13
5/10/1980,6,0,4,3,13
5/11/1980,4,0,4,11,19
5/12/1980,5,0,6,1,12
5/13/1980,4,0,7,0,11
5/14/1980,4,0,4,5,13
5/15/1980,8,0,6,2,16
5/16/1980,2,0,3,13,18
5/17/1980,5,0,4,10,19
5/18/1980,2,0,3,6,11
5/19/1980,8,0,7,8,23
5/20/1980,5,0,3,11,19
5/21/1980,7,0,2,6,15
5/22/1980,4,0,5,13,22
5/23/1980,5,0,7,13,25
5/24/1980,6,0,8,0,14
5/25/1980,6,0,7,10,23
5/26/1980,8,0,5,2,15
5/27/1980,3,0,6,10,19
5/28/1980,8,0,3,0,11
5/29/1980,5,0,4,4,13
5/30/1980,2,0,7,7,16
5/31/1980,7,0,7,8,22
6/1/1980,5,0,3,11,19
6/2/1980,8,0,3,10,21
6/3/1980,4,0,4,8,16
6/4/1980,3,0,5,8,16
6/5/1980,4,0,3,5,12
6/6/1980,8,0,4,9,21
6/7/1980,5,0,5,10,20
6/8/1980,4,0,6,7,17
6/9/1980,6,0,5,3,14
6/10/1980,8,0,6,12,26
6/11/1980,3,0,5,12,20
6/12/1980,5,0,5,5,15
6/13/1980,7,0,6,2,15
6/14/1980,8,0,7,4,19
6/15/1980,3,0,2,11,16
6/16/1980,5,0,3,10,18
6/17/1980,4,0,3,10,17
6/18/1980,2,0,8,6,16
6/19/1980,4,0,3,3,10
6/20/1980,6,0,4,1,11
6/21/1980,3,0,2,13,18
6/22/1980,7,0,2,5,14
6/23/1980,8,0,6,9,23
6/24/1980,4,0,7,2,13
6/25/1980,5,0,2,1,8
6/26/1980,8,0,3,6,17
6/27/1980,3,0,8,13,24
6/28/1980,5,0,6,5,16
6/29/1980,5,0,8,1,14
6/30/1980,6,0,6,2,14
7/1/1980,4,0,2,11,17
7/2/1980,8,0,6,3,17
7/3/1980,5,0,6,1,12
7/4/1980,5,0,3,1,9
7/5/1980,4,0,2,10,16
7/6/1980,2,0,2,9,13
7/7/1980,6,0,6,10,22
7/8/1980,6,0,7,12,25
7/9/1980,6,0,5,6,17
7/10/1980,3,0,5,2,10
7/11/1980,3,0,5,5,13
7/12/1980,7,0,3,8,18
7/13/1980,2,0,2,12,16
7/14/1980,6,0,4,8,18
7/15/1980,5,0,5,4,14
7/16/1980,8,0,6,11,25
7/17/1980,6,0,4,12,22
7/18/1980,2,0,6,8,16
7/19/1980,7,0,5,12,24
7/20/1980,8,0,4,3,15
7/21/1980,3,0,3,0,6
7/22/1980,8,0,4,11,23
7/23/1980,3,0,7,13,23
7/24/1980,2,0,7,0,9
7/25/1980,6,0,8,4,18
7/26/1980,4,0,7,2,13
7/27/1980,3,0,5,6,14
7/28/1980,3,0,8,13,24
7/29/1980,2,0,6,9,17
7/30/1980,6,0,2,2,10
7/31/1980,8,0,8,6,22
8/1/1980,6,0,8,6,20
8/2/1980,7,0,7,2,16
8/3/1980,8,0,3,0,11
8/4/1980,2,0,8,6,16
8/5/1980,4,0,6,0,10
8/6/1980,3,0,8,0,11
8/7/1980,6,0,2,4,12
8/8/1980,5,0,6,5,16
8/9/1980,2,0,2,11,15
8/10/1980,6,0,6,13,25
8/11/1980,3,0,8,1,12
8/12/1980,3,0,3,9,15
8/13/1980,4,0,6,10,20
8/14/1980,7,0,6,11,24
8/15/1980,6,0,3,9,18
8/16/1980,8,0,2,0,10
8/17/1980,4,0,6,3,13
8/18/1980,8,0,5,0,13
8/19/1980,8,0,8,0,16
8/20/1980,7,0,2,7,16
8/21/1980,2,0,2,10,14
8/22/1980,2,0,4,12,18
8/23/1980,6,0,6,9,21
8/24/1980,7,0,8,5,20
8/25/1980,2,0,4,2,8
8/26/1980,2,0,8,0,10
8/27/1980,5,0,8,10,23
8/28/1980,4,0,3,5,12
8/29/1980,2,0,6,11,19
8/30/1980,4,0,3,11,18
8/31/1980,6,0,6,1,13
9/1/1980,3,0,2,8,13
9/2/1980,5,0,4,9,18
9/3/1980,7,0,5,9,21
9/4/1980,6,0,7,7,20
9/5/1980,3,0,5,3,11
9/6/1980,7,0,4,1,12
9/7/1980,8,0,3,6,17
9/8/1980,6,0,5,9,20
9/9/1980,8,0,3,0,11
9/10/1980,6,0,7,12,25
9/11/1980,2,0,7,11,20
9/12/1980,8,0,2,2,12
9/13/1980,7,0,5,3,15
9/14/1980,7,0,5,7,19
9/15/1980,8,0,2,7,17
9/16/1980,4,0,8,2,14
9/17/1980,2,0,5,10,17
9/18/1980,5,0,4,2,11
9/19/1980,3,0,6,4,13
9/20/1980,8,0,6,13,27
9/21/1980,5,0,5,11,21
9/22/1980,4,0,5,5,14
9/23/1980,4,0,7,4,15
9/24/1980,6,0,6,4,16
9/25/1980,5,0,4,12,21
9/26/1980,2,0,8,4,14
9/27/1980,3,0,3,5,11
9/28/1980,3,0,3,11,17
9/29/1980,5,0,4,5,14
9/30/1980,8,0,3,2,13
10/1/1980,5,0,6,11,22
10/2/1980,6,0,2,13,21
10/3/1980,7,0,5,13,25
10/4/1980,3,0,8,11,22
10/5/1980,7,0,4,13,24
10/6/1980,6,0,8,9,23
10/7/1980,5,0,8,4,17
10/8/1980,6,0,8,1,15
10/9/1980,5,0,8,2,15
10/10/1980,7,0,5,4,16
10/11/1980,6,0,4,11,21
10/12/1980,8,0,2,3,13
10/13/1980,3,0,2,8,13
10/14/1980,5,0,7,4,16
10/15/1980,8,0,6,10,24
10/16/1980,4,0,3,5,12
10/17/1980,2,0,6,3,11
10/18/1980,4,0,2,0,6
10/19/1980,3,0,3,8,14
10/20/1980,4,0,5,11,20
10/21/1980,5,0,7,13,25
10/22/1980,7,0,7,11,25
10/23/1980,4,0,7,10,21
10/24/1980,6,0,7,0,13
10/25/1980,5,0,6,3,14
10/26/1980,5,0,3,0,8
10/27/1980,8,0,3,6,17
10/28/1980,7,0,7,8,22
10/29/1980,4,0,8,2,14
10/30/1980,6,0,4,6,16
10/31/1980,5,0,5,1,11
11/1/1980,6,0,4,5,15
11/2/1980,6,0,2,11,19
11/3/1980,7,0,2,13,22
11/4/1980,2,0,3,5,10
11/5/1980,5,0,2,13,20
11/6/1980,5,0,2,8,15
11/7/1980,4,0,3,0,7
11/8/1980,4,0,2,9,15
11/9/1980,3,0,4,8,15
11/10/1980,8,0,7,3,18
11/11/1980,6,0,5,7,18
11/12/1980,4,0,4,12,20
11/13/1980,5,0,8,2,15
11/14/1980,7,0,4,9,20
11/15/1980,4,0,3,9,16
11/16/1980,8,0,3,12,23
11/17/1980,3,0,7,11,21
11/18/1980,4,0,8,6,18
11/19/1980,6,0,3,1,10
11/20/1980,5,0,7,8,20
11/21/1980,5,0,4,11,20
11/22/1980,3,0,7,10,20
11/23/1980,3,0,4,3,10
11/24/1980,4,0,5,8,17
11/25/1980,5,0,7,6,18
11/26/1980,2,0,6,13,21
11/27/1980,8,0,5,7,20
11/28/1980,7,0,8,4,19
11/29/1980,5,0,4,0,9
11/30/1980,7,0,2,2,11
12/1/1980,8,0,4,11,23
12/2/1980,7,0,5,3,15
12/3/1980,5,0,5,2,12
12/4/1980,4,0,5,13,22
12/5/1980,7,0,7,13,27
12/6/1980,2,0,2,7,11
12/7/1980,4,0,7,9,20
12/8/1980,5,0,7,13,25
12/9/1980,6,0,2,12,20
12/10/1980,5,0,3,4,12
12/11/1980,2,0,6,10,18
12/12/1980,5,0,3,3,11
12/13/1980,5,0,3,1,9
12/14/1980,5,0,8,0,13
12/15/1980,2,0,8,11,21
12/16/1980,4,0,7,6,17
12/17/1980,6,0,4,1,11
12/18/1980,2,0,2,10,14
12/19/1980,4,0,8,5,17
12/20/1980,2,0,3,3,8
12/21/1980,6,0,6,13,25
12/22/1980,2,0,6,13,21
12/23/1980,4,0,3,0,7
12/24/1980,2,0,4,1,7
12/25/1980,6,0,2,5,13
12/26/1980,7,0,5,10,22
12/27/1980,8,0,2,9,19
12/28/1980,4,0,2,6,12
12/29/1980,6,0,8,5,19
12/30/1980,2,0,5,12,19
12/31/1980,8,0,6,3,17
1/1/1981,8,0,7,9,24
1/2/1981,2,0,2,9,13
1/3/1981,6,0,7,13,26
1/4/1981,4,0,4,5,13
1/5/1981,5,0,6,1,12
1/6/1981,7,0,6,0,13
1/7/1981,3,0,6,0,9
1/8/1981,3,0,7,9,19
1/9/1981,6,0,7,8,21
1/10/1981,3,0,4,9,16
1/11/1981,6,0,7,9,22
1/12/1981,6,0,5,9,20
1/13/1981,8,0,6,5,19
1/14/1981,7,0,2,5,14
1/15/1981,6,0,5,11,22
1/16/1981,5,0,6,13,24
1/17/1981,8,0,5,10,23
1/18/1981,2,0,7,10,19
1/19/1981,7,0,5,2,14
1/20/1981,5,0,2,4,11
1/21/1981,8,0,6,0,14
1/22/1981,6,0,3,4,13
1/23/1981,4,0,6,0,10
1/24/1981,7,0,5,11,23
1/25/1981,4,0,4,1,9
1/26/1981,2,0,4,0,6
1/27/1981,7,0,2,3,12
1/28/1981,5,0,2,10,17
1/29/1981,5,0,5,10,20
1/30/1981,4,0,6,7,17
1/31/1981,2,0,7,7,16
2/1/1981,6,0,5,8,19
2/2/1981,7,0,8,4,19
2/3/1981,4,0,3,0,7
2/4/1981,3,0,4,4,11
2/5/1981,2,0,5,11,18
2/6/1981,5,0,8,4,17
2/7/1981,2,0,2,0,4
2/8/1981,6,0,8,10,24
2/9/1981,8,0,2,6,16
2/10/1981,6,0,3,1,10
2/11/1981,4,0,2,8,14
2/12/1981,7,0,4,0,11
2/13/1981,3,0,2,11,16
2/14/1981,8,0,8,11,27
2/15/1981,3,0,5,3,11
2/16/1981,2,0,6,6,14
2/17/1981,6,0,8,11,25
2/18/1981,7,0,4,2,13
2/19/1981,7,0,4,7,18
2/20/1981,8,0,2,12,22
2/21/1981,5,0,4,4,13
2/22/1981,5,0,4,6,15
2/23/1981,8,0,7,6,21
2/24/1981,7,0,8,0,15
2/25/1981,2,0,6,11,19
2/26/1981,2,0,8,9,19
2/27/1981,6,0,8,3,17
2/28/1981,6,0,2,13,21
3/1/1981,2,0,6,10,18
3/2/1981,7,0,6,3,16
3/3/1981,6,0,7,2,15
3/4/1981,3,0,2,7,12
3/5/1981,2,0,4,12,18
3/6/1981,8,0,6,1,15
3/7/1981,8,0,8,5,21
3/8/1981,5,0,5,0,10
3/9/1981,5,0,5,1,11
3/10/1981,5,0,5,13,23
3/11/1981,5,0,2,9,16
3/12/1981,3,0,6,0,9
3/13/1981,4,0,7,7,18
3/14/1981,6,0,6,5,17
3/15/1981,5,0,3,7,15
3/16/1981,5,0,8,0,13
3/17/1981,7,0,8,9,24
3/18/1981,6,0,2,6,14
3/19/1981,7,0,4,7,18
3/20/1981,2,0,4,0,6
3/21/1981,7,0,2,13,22
3/22/1981,3,0,7,8,18
3/23/1981,7,0,2,2,11
3/24/1981,8,0,4,8,20
3/25/1981,6,0,8,10,24
3/26/1981,3,0,4,5,12
3/27/1981,4,0,7,11,22
3/28/1981,3,0,5,2,10
3/29/1981,4,0,2,11,17
3/30/1981,6,0,7,2,15
3/31/1981,7,0,3,13,23
4/1/1981,8,0,3,11,22
4/2/1981,5,0,5,7,17
4/3/1981,8,0,8,7,23
4/4/1981,7,0,8,2,17
4/5/1981,5,0,4,13,22
4/6/1981,4,0,4,4,12
4/7/1981,5,0,5,1,11
4/8/1981,3,0,8,6,17
4/9/1981,5,0,3,5,13
4/10/1981,5,0,7,8,20
4/11/1981,6,0,3,6,15
4/12/1981,5,0,7,7,19
4/13/1981,7,0,5,7,19
4/14/1981,3,0,3,4,10
4/15/1981,6,0,4,8,18
4/16/1981,2,0,7,10,19
4/17/1981,3,0,7,1,11
4/18/1981,5,0,4,5,14
4/19/1981,7,0,7,5,19
4/20/1981,4,0,4,4,12
4/21/1981,6,0,6,5,17
4/22/1981,5,0,2,1,8
4/23/1981,2,0,4,13,19
4/24/1981,7,0,5,7,19
4/25/1981,4,0,8,12,24
4/26/1981,6,0,4,5,15
4/27/1981,8,0,7,12,27
4/28/1981,4,0,7,0,11
4/29/1981,3,0,8,2,13
4/30/1981,3,0,4,0,7
5/1/1981,7,0,4,1,12
5/2/1981,7,0,5,6,18
5/3/1981,7,0,8,10,25
5/4/1981,4,0,3,13,20
5/5/1981,3,0,2,3,8
5/6/1981,5,0,7,6,18
5/7/1981,2,0,2,12,16
5/8/1981,7,0,4,3,14
5/9/1981,3,0,7,2,12
5/10/1981,7,0,7,1,15
5/11/1981,2,0,7,13,22
5/12/1981,6,0,4,12,22
5/13/1981,5,0,5,6,16
5/14/1981,4,0,6,4,14
5/15/1981,6,0,3,13,22
5/16/1981,5,0,5,1,11
5/17/1981,3,0,8,4,15
5/18/1981,2,0,8,7,17
5/19/1981,3,0,6,8,17
5/20/1981,4,0,2,6,12
5/21/1981,7,0,5,2,14
5/22/1981,6,0,3,0,9
5/23/1981,5,0,2,6,13
5/24/1981,6,0,6,2,14
5/25/1981,4,0,5,4,13
5/26/1981,8,0,5,1,14
5/27/1981,3,0,3,6,12
5/28/1981,4,0,5,3,12
5/29/1981,4,0,8,1,13
5/30/1981,4,0,2,1,7
5/31/1981,2,0,4,13,19
6/1/1981,5,0,8,6,19
6/2/1981,7,0,7,5,19
6/3/1981,7,0,3,6,16
6/4/1981,6,0,2,6,14
6/5/1981,6,0,5,7,18
6/6/1981,2,0,4,7,13
6/7/1981,7,0,6,13,26
6/8/1981,7,0,2,2,11
6/9/1981,6,0,3,13,22
6/10/1981,8,0,3,4,15
6/11/1981,6,0,2,13,21
6/12/1981,6,0,5,0,11
6/13/1981,2,0,2,9,13
6/14/1981,7,0,6,1,14
6/15/1981,5,0,6,5,16
6/16/1981,5,0,6,8,19
6/17/1981,3,0,8,0,11
6/18/1981,5,0,3,13,21
6/19/1981,5,0,8,11,24
6/20/1981,3,0,2,4,9
6/21/1981,3,0,6,10,19
6/22/1981,6,0,6,11,23
6/23/1981,6,0,4,3,13
6/24/1981,2,0,2,6,10
6/25/1981,8,0,3,10,21
6/26/1981,6,0,6,9,21
6/27/1981,4,0,4,8,16
6/28/1981,3,0,3,10,16
6/29/1981,2,0,3,10,15
6/30/1981,3,0,6,7,16
7/1/1981,6,0,5,10,21
7/2/1981,8,0,3,2,13
7/3/1981,3,0,5,11,19
7/4/1981,3,0,2,12,17
7/5/1981,7,0,4,7,18
7/6/1981,7,0,7,3,17
7/7/1981,3,0,2,13,18
7/8/1981,2,0,5,5,12
7/9/1981,5,0,5,2,12
7/10/1981,7,0,4,3,14
7/11/1981,3,0,4,11,18
7/12/1981,8,0,4,3,15
7/13/1981,5,0,8,7,20
7/14/1981,3,0,5,2,10
7/15/1981,3,0,8,12,23
7/16/1981,2,0,6,3,11
7/17/1981,4,0,4,1,9
7/18/1981,5,0,6,2,13
7/19/1981,7,0,4,12,23
7/20/1981,3,0,3,2,8
7/21/1981,7,0,4,4,15
7/22/1981,2,0,2,7,11
7/23/1981,7,0,4,12,23
7/24/1981,3,0,4,4,11
7/25/1981,2,0,8,13,23
7/26/1981,7,0,3,2,12
7/27/1981,6,0,8,12,26
7/28/1981,4,0,6,2,12
7/29/1981,3,0,4,7,14
7/30/1981,3,0,4,10,17
7/31/1981,7,0,4,3,14
8/1/1981,3,0,2,13,18
8/2/1981,4,0,8,8,20
8/3/1981,8,0,7,2,17
8/4/1981,3,0,8,13,24
8/5/1981,3,0,5,8,16
8/6/1981,8,0,8,3,19
8/7/1981,2,0,8,1,11
8/8/1981,8,0,3,6,17
8/9/1981,4,0,5,6,15
8/10/1981,3,0,5,0,8
8/11/1981,2,0,4,3,9
8/12/1981,8,0,6,5,19
8/13/1981,4,0,5,4,13
8/14/1981,3,0,3,4,10
8/15/1981,6,0,7,6,19
8/16/1981,5,0,4,1,10
8/17/1981,3,0,8,11,22
8/18/1981,3,0,4,11,18
8/19/1981,4,0,5,9,18
8/20/1981,5,0,6,6,17
8/21/1981,7,0,7,4,18
8/22/1981,3,0,5,8,16
8/23/1981,8,0,3,8,19
8/24/1981,2,0,8,8,18
8/25/1981,5,0,2,11,18
8/26/1981,7,0,2,1,10
8/27/1981,6,0,6,11,23
8/28/1981,4,0,5,0,9
8/29/1981,3,0,3,1,7
8/30/1981,2,0,5,9,16
8/31/1981,2,0,8,13,23
9/1/1981,3,0,2,8,13
9/2/1981,5,0,5,13,23
9/3/1981,4,0,2,3,9
9/4/1981,5,0,8,5,18
9/5/1981,6,0,6,9,21
9/6/1981,4,0,2,12,18
9/7/1981,4,0,6,2,12
9/8/1981,6,0,6,12,24
9/9/1981,3,0,6,3,12
9/10/1981,6,0,6,7,19
9/11/1981,7,0,4,9,20
9/12/1981,8,0,7,0,15
9/13/1981,3,0,5,0,8
9/14/1981,3,0,8,2,13
9/15/1981,5,0,6,8,19
9/16/1981,4,0,3,0,7
9/17/1981,7,0,5,7,19
9/18/1981,4,0,6,9,19
9/19/1981,2,0,5,6,13
9/20/1981,3,0,4,8,15
9/21/1981,7,0,6,1,14
9/22/1981,8,0,2,2,12
9/23/1981,6,0,6,7,19
9/24/1981,7,0,2,8,17
9/25/1981,5,0,5,10,20
9/26/1981,3,0,4,1,8
9/27/1981,7,0,3,7,17
9/28/1981,6,0,2,6,14
9/29/1981,6,0,7,1,14
9/30/1981,2,0,5,11,18
10/1/1981,2,0,2,10,14
10/2/1981,7,0,7,12,26
10/3/1981,7,0,6,5,18
10/4/1981,4,0,7,13,24
10/5/1981,7,0,7,11,25
10/6/1981,6,0,6,13,25
10/7/1981,7,0,7,5,19
10/8/1981,2,0,3,0,5
10/9/1981,3,0,8,2,13
10/10/1981,2,0,6,9,17
10/11/1981,3,0,6,11,20
10/12/1981,4,0,2,9,15
10/13/1981,6,0,7,10,23
10/14/1981,2,0,5,1,8
10/15/1981,2,0,7,12,21
10/16/1981,7,0,4,8,19
10/17/1981,2,0,4,11,17
10/18/1981,7,0,4,12,23
10/19/1981,2,0,3,10,15
10/20/1981,5,0,2,4,11
10/21/1981,8,0,6,4,18
10/22/1981,2,0,8,6,16
10/23/1981,5,0,8,7,20
10/24/1981,7,0,2,2,11
10/25/1981,6,0,7,7,20
10/26/1981,8,0,8,5,21
10/27/1981,4,0,8,8,20
10/28/1981,3,0,4,2,9
10/29/1981,5,0,8,3,16
10/30/1981,7,0,4,5,16
10/31/1981,4,0,2,6,12
11/1/1981,4,0,5,12,21
11/2/1981,5,0,6,8,19
11/3/1981,4,0,7,13,24
11/4/1981,3,0,7,0,10
11/5/1981,5,0,3,2,10
11/6/1981,8,0,2,0,10
11/7/1981,6,0,3,6,15
11/8/1981,4,0,8,12,24
11/9/1981,5,0,4,7,16
11/10/1981,8,0,3,5,16
11/11/1981,3,0,6,7,16
11/12/1981,4,0,3,9,16
11/13/1981,4,0,8,5,17
11/14/1981,8,0,6,9,23
11/15/1981,2,0,4,8,14
11/16/1981,4,0,3,8,15
11/17/1981,6,0,3,9,18
11/18/1981,5,0,2,0,7
11/19/1981,3,0,3,5,11
11/20/1981,3,0,6,4,13
11/21/1981,8,0,4,10,22
11/22/1981,7,0,7,5,19
11/23/1981,5,0,5,12,22
11/24/1981,7,0,6,8,21
11/25/1981,7,0,7,1,15
11/26/1981,5,0,3,0,8
11/27/1981,8,0,2,2,12
11/28/1981,4,0,4,5,13
11/29/1981,2,0,8,2,12
11/30/1981,2,0,5,4,11
12/1/1981,4,0,3,5,12
12/2/1981,3,0,4,10,17
12/3/1981,7,0,4,1,12
12/4/1981,5,0,8,3,16
12/5/1981,3,0,5,13,21
12/6/1981,5,0,8,4,17
12/7/1981,7,0,4,10,21
12/8/1981,5,0,7,1,13
12/9/1981,4,0,4,8,16
12/10/1981,6,0,3,12,21
12/11/1981,4,0,3,8,15
12/12/1981,5,0,2,5,12
12/13/1981,5,0,3,12,20
12/14/1981,2,0,4,7,13
12/15/1981,6,0,7,3,16
12/16/1981,5,0,2,3,10
12/17/1981,3,0,3,3,9
12/18/1981,7,0,2,7,16
12/19/1981,8,0,8,13,29
12/20/1981,5,0,3,9,17
12/21/1981,4,0,5,4,13
12/22/1981,4,0,2,5,11
12/23/1981,3,0,8,1,12
12/24/1981,7,0,8,12,27
12/25/1981,2,0,4,5,11
12/26/1981,6,0,7,4,17
12/27/1981,4,0,7,5,16
12/28/1981,2,0,5,0,7
12/29/1981,5,0,8,11,24
12/30/1981,2,0,2,5,9
12/31/1981,2,0,7,4,13
1/1/1982,8,0,2,13,23
1/2/1982,8,0,6,2,16
1/3/1982,4,0,8,12,24
1/4/1982,5,0,5,13,23
1/5/1982,4,0,2,13,19
1/6/1982,4,0,7,11,22
1/7/1982,7,0,4,4,15
1/8/1982,4,0,4,2,10
1/9/1982,4,0,3,13,20
1/10/1982,3,0,7,13,23
1/11/1982,3,0,7,5,15
1/12/1982,6,0,2,4,12
1/13/1982,4,0,7,11,22
1/14/1982,2,0,6,4,12
1/15/1982,3,0,5,6,14
1/16/1982,3,0,2,6,11
1/17/1982,7,0,8,5,20
1/18/1982,6,0,7,12,25
1/19/1982,7,0,3,4,14
1/20/1982,4,0,7,2,13
1/21/1982,4,0,6,11,21
1/22/1982,7,0,2,5,14
1/23/1982,5,0,3,9,17
1/24/1982,2,0,7,11,20
1/25/1982,2,0,5,3,10
1/26/1982,3,0,7,11,21
1/27/1982,3,0,3,2,8
1/28/1982,3,0,6,6,15
1/29/1982,4,0,5,1,10
1/30/1982,2,0,5,2,9
1/31/1982,3,0,3,4,10
2/1/1982,3,0,2,12,17
2/2/1982,8,0,7,0,15
2/3/1982,6,0,6,3,15
2/4/1982,3,0,7,1,11
2/5/1982,4,0,8,9,21
2/6/1982,4,0,6,7,17
2/7/1982,3,0,7,10,20
2/8/1982,6,0,8,13,27
2/9/1982,2,0,8,0,10
2/10/1982,6,0,4,13,23
2/11/1982,3,0,5,7,15
2/12/1982,7,0,5,12,24
2/13/1982,7,0,2,5,14
2/14/1982,4,0,8,10,22
2/15/1982,3,0,5,6,14
2/16/1982,7,0,2,2,11
2/17/1982,8,0,8,0,16
2/18/1982,4,0,4,5,13
2/19/1982,5,0,3,1,9
2/20/1982,7,0,2,0,9
2/21/1982,3,0,6,8,17
2/22/1982,6,0,3,7,16
2/23/1982,6,0,7,7,20
2/24/1982,7,0,8,9,24
2/25/1982,5,0,5,5,15
2/26/1982,7,0,5,8,20
2/27/1982,5,0,3,5,13
2/28/1982,3,0,5,2,10
3/1/1982,4,0,7,6,17
3/2/1982,4,0,6,13,23
3/3/1982,5,0,4,6,15
3/4/1982,8,0,2,5,15
3/5/1982,3,0,4,5,12
3/6/1982,6,0,6,12,24
3/7/1982,2,0,3,10,15
3/8/1982,2,0,4,1,7
3/9/1982,7,0,8,5,20
3/10/1982,3,0,4,3,10
3/11/1982,6,0,8,7,21
3/12/1982,6,0,4,1,11
3/13/1982,3,0,5,13,21
3/14/1982,7,0,4,3,14
3/15/1982,8,0,3,8,19
3/16/1982,8,0,4,1,13
3/17/1982,6,0,2,4,12
3/18/1982,3,0,3,4,10
3/19/1982,7,0,7,1,15
3/20/1982,8,0,7,7,22
3/21/1982,4,0,7,2,13
3/22/1982,8,0,4,8,20
3/23/1982,8,0,3,7,18
3/24/1982,6,0,3,12,21
3/25/1982,6,0,8,1,15
3/26/1982,5,0,6,1,12
3/27/1982,6,0,6,0,12
3/28/1982,4,0,4,13,21
3/29/1982,7,0,5,3,15
3/30/1982,2,0,2,6,10
3/31/1982,7,0,2,9,18
4/1/1982,8,0,5,12,25
4/2/1982,8,0,5,13,26
4/3/1982,2,0,2,9,13
4/4/1982,4,0,5,3,12
4/5/1982,8,0,3,13,24
4/6/1982,8,0,6,10,24
4/7/1982,4,0,2,3,9
4/8/1982,5,0,5,12,22
4/9/1982,5,0,8,7,20
4/10/1982,4,0,6,8,18
4/11/1982,8,0,7,3,18
4/12/1982,4,0,2,3,9
4/13/1982,4,0,3,13,20
4/14/1982,6,0,5,9,20
4/15/1982,4,0,5,8,17
4/16/1982,7,0,8,1,16
4/17/1982,8,0,5,10,23
4/18/1982,4,0,4,13,21
4/19/1982,3,0,6,9,18
4/20/1982,6,0,5,0,11
4/21/1982,8,0,4,6,18
4/22/1982,5,0,2,8,15
4/23/1982,4,0,2,13,19
4/24/1982,3,0,3,11,17
4/25/1982,2,0,3,6,11
4/26/1982,8,0,7,13,28
4/27/1982,7,0,5,6,18
4/28/1982,5,0,2,3,10
4/29/1982,4,0,6,8,18
4/30/1982,4,0,7,12,23
5/1/1982,3,0,4,0,7
5/2/1982,5,0,8,10,23
5/3/1982,7,0,2,7,16
5/4/1982,6,0,7,1,14
5/5/1982,6,0,7,6,19
5/6/1982,3,0,7,12,22
5/7/1982,8,0,5,0,13
5/8/1982,6,0,6,7,19
5/9/1982,4,0,2,2,8
5/10/1982,5,0,4,0,9
5/11/1982,8,0,4,10,22
5/12/1982,5,0,3,9,17
5/13/1982,6,0,5,1,12
5/14/1982,4,0,2,6,12
5/15/1982,3,0,4,6,13
5/16/1982,2,0,7,3,12
5/17/1982,6,0,4,13,23
5/18/1982,3,0,8,4,15
5/19/1982,5,0,7,9,21
5/20/1982,6,0,7,8,21
5/21/1982,3,0,6,0,9
5/22/1982,6,0,7,6,19
5/23/1982,4,0,3,6,13
5/24/1982,4,0,6,6,16
5/25/1982,5,0,4,6,15
5/26/1982,8,0,2,4,14
5/27/1982,4,0,5,5,14
5/28/1982,7,0,6,8,21
5/29/1982,3,0,2,12,17
5/30/1982,3,0,8,1,12
5/31/1982,3,0,3,6,12
6/1/1982,8,0,5,13,26
6/2/1982,4,0,6,2,12
6/3/1982,6,0,7,12,25
6/4/1982,3,0,4,1,8
6/5/1982,2,0,3,4,9
6/6/1982,5,0,8,12,25
6/7/1982,7,0,5,7,19
6/8/1982,2,0,4,5,11
6/9/1982,4,0,3,11,18
6/10/1982,2,0,8,0,10
6/11/1982,6,0,5,10,21
6/12/1982,8,0,5,8,21
6/13/1982,3,0,5,8,16
6/14/1982,8,0,3,11,22
6/15/1982,4,0,5,10,19
6/16/1982,2,0,8,1,11
6/17/1982,6,0,2,5,13
6/18/1982,5,0,5,3,13
6/19/1982,3,0,3,13,19
6/20/1982,6,0,3,2,11
6/21/1982,4,0,8,1,13
6/22/1982,2,0,4,4,10
6/23/1982,6,0,7,8,21
6/24/1982,2,0,4,11,17
6/25/1982,5,0,7,8,20
6/26/1982,5,0,7,2,14
6/27/1982,4,0,8,8,20
6/28/1982,6,0,3,10,19
6/29/1982,6,0,3,6,15
6/30/1982,4,0,3,9,16
7/1/1982,2,0,5,1,8
7/2/1982,6,0,4,12,22
7/3/1982,4,0,2,9,15
7/4/1982,8,0,7,6,21
7/5/1982,8,0,2,0,10
7/6/1982,4,0,8,13,25
7/7/1982,4,0,5,5,14
7/8/1982,5,0,8,6,19
7/9/1982,4,0,8,7,19
7/10/1982,6,0,3,7,16
7/11/1982,7,0,2,11,20
7/12/1982,7,0,4,4,15
7/13/1982,6,0,4,9,19
7/14/1982,2,0,6,10,18
7/15/1982,8,0,5,4,17
7/16/1982,8,0,2,12,22
7/17/1982,3,0,8,3,14
7/18/1982,6,0,7,6,19
7/19/1982,3,0,6,10,19
7/20/1982,6,0,5,3,14
7/21/1982,5,0,8,5,18
7/22/1982,2,0,3,7,12
7/23/1982,8,0,3,6,17
7/24/1982,4,0,3,5,12
7/25/1982,5,0,6,10,21
7/26/1982,5,0,6,1,12
7/27/1982,5,0,6,8,19
7/28/1982,4,0,5,8,17
7/29/1982,7,0,7,1,15
7/30/1982,6,0,2,12,20
7/31/1982,2,0,8,9,19
8/1/1982,8,0,6,13,27
8/2/1982,4,0,6,13,23
8/3/1982,3,0,7,6,16
8/4/1982,3,0,7,3,13
8/5/1982,2,0,6,9,17
8/6/1982,5,0,5,11,21
8/7/1982,6,0,5,12,23
8/8/1982,5,0,4,11,20
8/9/1982,5,0,7,8,20
8/10/1982,7,0,4,11,22
8/11/1982,4,0,7,1,12
8/12/1982,5,0,6,10,21
8/13/1982,7,0,4,4,15
8/14/1982,3,0,8,5,16
8/15/1982,4,0,8,11,23
8/16/1982,2,0,4,8,14
8/17/1982,2,0,4,10,16
8/18/1982,7,0,3,1,11
8/19/1982,7,0,8,11,26
8/20/1982,8,0,3,4,15
8/21/1982,3,0,4,4,11
8/22/1982,5,0,4,6,15
8/23/1982,8,0,7,0,15
8/24/1982,6,0,3,1,10
8/25/1982,3,0,2,0,5
8/26/1982,4,0,4,7,15
8/27/1982,4,0,3,3,10
8/28/1982,7,0,6,4,17
8/29/1982,2,0,4,6,12
8/30/1982,3,0,8,0,11
8/31/1982,8,0,4,12,24
9/1/1982,6,0,5,8,19
9/2/1982,4,0,4,12,20
9/3/1982,4,0,2,0,6
9/4/1982,7,0,4,0,11
9/5/1982,4,0,2,4,10
9/6/1982,5,0,5,3,13
9/7/1982,7,0,3,10,20
9/8/1982,3,0,8,0,11
9/9/1982,6,0,3,6,15
9/10/1982,2,0,2,5,9
9/11/1982,3,0,3,4,10
9/12/1982,8,0,7,4,19
9/13/1982,6,0,4,9,19
9/14/1982,7,0,6,2,15
9/15/1982,4,0,8,1,13
9/16/1982,6,0,2,0,8
9/17/1982,4,0,3,1,8
9/18/1982,2,0,7,2,11
9/19/1982,5,0,6,2,13
9/20/1982,6,0,3,6,15
9/21/1982,6,0,4,6,16
9/22/1982,2,0,3,7,12
9/23/1982,5,0,3,12,20
9/24/1982,3,0,6,12,21
9/25/1982,5,0,8,8,21
9/26/1982,4,0,8,4,16
9/27/1982,8,0,6,13,27
9/28/1982,5,0,5,0,10
9/29/1982,2,0,7,0,9
9/30/1982,4,0,6,2,12
10/1/1982,3,0,3,7,13
10/2/1982,8,0,2,0,10
10/3/1982,2,0,4,2,8
10/4/1982,8,0,6,10,24
10/5/1982,8,0,7,7,22
10/6/1982,8,0,5,12,25
10/7/1982,5,0,2,5,12
10/8/1982,5,0,6,12,23
10/9/1982,5,0,3,10,18
10/10/1982,6,0,2,7,15
10/11/1982,3,0,8,1,12
10/12/1982,7,0,6,11,24
10/13/1982,2,0,5,7,14
10/14/1982,3,0,8,7,18
10/15/1982,6,0,6,13,25
10/16/1982,7,0,5,2,14
10/17/1982,8,0,5,13,26
10/18/1982,2,0,6,1,9
10/19/1982,5,0,2,0,7
10/20/1982,6,0,4,1,11
10/21/1982,3,0,4,10,17
10/22/1982,2,0,3,11,16
10/23/1982,3,0,6,1,10
10/24/1982,7,0,6,12,25
10/25/1982,5,0,5,12,22
10/26/1982,2,0,2,10,14
10/27/1982,6,0,2,13,21
10/28/1982,3,0,6,1,10
10/29/1982,6,0,4,11,21
10/30/1982,2,0,6,11,19
10/31/1982,8,0,3,7,18
11/1/1982,8,0,6,13,27
11/2/1982,7,0,5,12,24
11/3/1982,2,0,2,1,5
11/4/1982,8,0,3,11,22
11/5/1982,8,0,7,13,28
11/6/1982,6,0,6,13,25
11/7/1982,3,0,6,7,16
11/8/1982,4,0,6,10,20
11/9/1982,4,0,2,3,9
11/10/1982,2,0,8,3,13
11/11/1982,6,0,5,8,19
11/12/1982,3,0,3,10,16
11/13/1982,4,0,7,4,15
11/14/1982,3,0,5,8,16
11/15/1982,4,0,8,1,13
11/16/1982,7,0,4,11,22
11/17/1982,7,0,8,11,26
11/18/1982,8,0,6,2,16
11/19/1982,4,0,6,8,18
11/20/1982,3,0,3,5,11
11/21/1982,2,0,6,10,18
11/22/1982,7,0,3,2,12
11/23/1982,6,0,5,1,12
11/24/1982,2,0,7,10,19
11/25/1982,3,0,7,10,20
11/26/1982,2,0,2,10,14
11/27/1982,4,0,4,8,16
11/28/1982,5,0,7,7,19
11/29/1982,6,0,3,9,18
11/30/1982,7,0,8,12,27
12/1/1982,8,0,5,11,24
12/2/1982,7,0,4,7,18
12/3/1982,5,0,4,13,22
12/4/1982,8,0,8,11,27
12/5/1982,7,0,6,5,18
12/6/1982,5,0,4,3,12
12/7/1982,5,0,4,7,16
12/8/1982,4,0,2,5,11
12/9/1982,4,0,3,7,14
12/10/1982,8,0,8,6,22
12/11/1982,4,0,6,8,18
12/12/1982,3,0,8,3,14
12/13/1982,6,0,2,10,18
12/14/1982,8,0,4,5,17
12/15/1982,3,0,7,7,17
12/16/1982,7,0,5,13,25
12/17/1982,4,0,6,12,22
12/18/1982,3,0,2,6,11
12/19/1982,7,0,4,1,12
12/20/1982,3,0,8,12,23
12/21/1982,2,0,5,0,7
12/22/1982,3,0,5,0,8
12/23/1982,6,0,7,0,13
12/24/1982,2,0,6,8,16
12/25/1982,5,0,8,7,20
12/26/1982,3,0,5,10,18
12/27/1982,6,0,5,12,23
12/28/1982,8,0,2,5,15
12/29/1982,5,0,7,3,15
12/30/1982,3,0,7,13,23
12/31/1982,7,0,8,12,27
1/1/1983,3,0,7,6,16
1/2/1983,4,0,2,10,16
1/3/1983,2,0,3,4,9
1/4/1983,5,0,7,12,24
1/5/1983,4,0,2,10,16
1/6/1983,6,0,7,4,17
1/7/1983,3,0,4,8,15
1/8/1983,4,0,7,0,11
1/9/1983,2,0,5,4,11
1/10/1983,6,0,4,1,11
1/11/1983,2,0,8,11,21
1/12/1983,4,0,5,8,17
1/13/1983,4,0,2,5,11
1/14/1983,3,0,2,5,10
1/15/1983,2,0,5,10,17
1/16/1983,7,0,3,12,22
1/17/1983,5,0,7,5,17
1/18/1983,4,0,8,4,16
1/19/1983,5,0,7,10,22
1/20/1983,5,0,4,13,22
1/21/1983,6,0,7,11,24
1/22/1983,3,0,3,13,19
1/23/1983,6,0,5,1,12
1/24/1983,3,0,8,12,23
1/25/1983,6,0,4,5,15
1/26/1983,2,0,2,7,11
1/27/1983,5,0,8,1,14
1/28/1983,6,0,6,12,24
1/29/1983,5,0,3,10,18
1/30/1983,2,0,3,11,16
1/31/1983,3,0,8,2,13
2/1/1983,8,0,2,6,16
2/2/1983,6,0,4,9,19
2/3/1983,5,0,3,7,15
2/4/1983,2,0,7,8,17
2/5/1983,3,0,8,7,18
2/6/1983,5,0,5,1,11
2/7/1983,8,0,2,11,21
2/8/1983,7,0,8,9,24
2/9/1983,3,0,5,13,21
2/10/1983,6,0,8,6,20
2/11/1983,7,0,7,0,14
2/12/1983,5,0,7,7,19
2/13/1983,8,0,6,13,27
2/14/1983,6,0,8,12,26
2/15/1983,7,0,7,12,26
2/16/1983,2,0,3,6,11
2/17/1983,7,0,4,7,18
2/18/1983,5,0,2,8,15
2/19/1983,7,0,8,10,25
2/20/1983,2,0,8,3,13
2/21/1983,7,0,3,8,18
2/22/1983,6,0,2,2,10
2/23/1983,2,0,4,0,6
2/24/1983,6,0,6,9,21
2/25/1983,8,0,4,10,22
2/26/1983,8,0,3,0,11
2/27/1983,7,0,8,3,18
2/28/1983,6,0,6,10,22
3/1/1983,6,0,4,1,11
3/2/1983,4,0,7,9,20
3/3/1983,8,0,5,10,23
3/4/1983,7,0,4,13,24
3/5/1983,6,0,3,13,22
3/6/1983,5,0,2,3,10
3/7/1983,3,0,2,7,12
3/8/1983,4,0,2,10,16
3/9/1983,7,0,2,9,18
3/10/1983,8,0,8,10,26
3/11/1983,2,0,7,3,12
3/12/1983,5,0,2,1,8
3/13/1983,2,0,8,7,17
3/14/1983,4,0,4,5,13
3/15/1983,7,0,6,10,23
3/16/1983,7,0,5,1,13
3/17/1983,3,0,6,4,13
3/18/1983,5,0,6,2,13
3/19/1983,5,0,4,5,14
3/20/1983,6,0,3,3,12
3/21/1983,5,0,8,3,16
3/22/1983,2,0,8,12,22
3/23/1983,2,0,5,0,7
3/24/1983,7,0,3,7,17
3/25/1983,8,0,8,7,23
3/26/1983,7,0,6,13,26
3/27/1983,7,0,8,9,24
3/28/1983,3,0,4,2,9
3/29/1983,3,0,6,8,17
3/30/1983,7,0,3,12,22
3/31/1983,7,0,7,6,20
4/1/1983,5,0,2,4,11
4/2/1983,7,0,2,13,22
4/3/1983,5,0,5,13,23
4/4/1983,3,0,5,10,18
4/5/1983,8,0,4,7,19
4/6/1983,2,0,8,8,18
4/7/1983,4,0,8,4,16
4/8/1983,6,0,8,9,23
4/9/1983,3,0,3,7,13
4/10/1983,7,0,4,12,23
4/11/1983,5,0,2,11,18
4/12/1983,3,0,8,0,11
4/13/1983,3,0,7,2,12
4/14/1983,5,0,2,2,9
4/15/1983,4,0,5,5,14
4/16/1983,3,0,3,9,15
4/17/1983,2,0,7,1,10
4/18/1983,3,0,7,6,16
4/19/1983,6,0,3,8,17
4/20/1983,7,0,5,0,12
4/21/1983,3,0,7,1,11
4/22/1983,7,0,3,11,21
4/23/1983,5,0,7,3,15
4/24/1983,8,0,5,8,21
4/25/1983,5,0,6,8,19
4/26/1983,3,0,4,13,20
4/27/1983,4,0,6,11,21
4/28/1983,3,0,4,9,16
4/29/1983,4,0,7,5,16
4/30/1983,8,0,2,5,15
5/1/1983,8,0,6,13,27
5/2/1983,7,0,7,10,24
5/3/1983,4,0,6,6,16
5/4/1983,5,0,7,10,22
5/5/1983,4,0,6,0,10
5/6/1983,3,0,4,8,15
5/7/1983,8,0,3,12,23
5/8/1983,7,0,2,12,21
5/9/1983,8,0,4,5,17
5/10/1983,5,0,7,5,17
5/11/1983,8,0,5,10,23
5/12/1983,3,0,2,10,15
5/13/1983,8,0,4,11,23
5/14/1983,7,0,7,3,17
5/15/1983,3,0,7,13,23
5/16/1983,7,0,8,7,22
5/17/1983,3,0,3,0,6
5/18/1983,7,0,7,2,16
5/19/1983,4,0,3,4,11
5/20/1983,6,0,2,5,13
5/21/1983,3,0,7,10,20
5/22/1983,7,0,7,13,27
5/23/1983,8,0,2,9,19
5/24/1983,6,0,6,9,21
5/25/1983,2,0,8,9,19
5/26/1983,3,0,5,8,16
5/27/1983,6,0,3,7,16
5/28/1983,5,0,4,10,19
5/29/1983,8,0,8,1,17
5/30/1983,4,0,8,11,23
5/31/1983,6,0,3,2,11
6/1/1983,3,0,7,4,14
6/2/1983,2,0,5,3,10
6/3/1983,7,0,3,9,19
6/4/1983,5,0,4,12,21
6/5/1983,6,0,3,9,18
6/6/1983,6,0,6,1,13
6/7/1983,5,0,4,13,22
6/8/1983,2,0,7,8,17
6/9/1983,7,0,3,4,14
6/10/1983,4,0,8,1,13
6/11/1983,3,0,7,13,23
6/12/1983,5,0,7,7,19
6/13/1983,7,0,2,10,19
6/14/1983,3,0,4,9,16
6/15/1983,7,0,8,2,17
6/16/1983,2,0,2,3,7
6/17/1983,2,0,3,13,18
6/18/1983,2,0,8,1,11
6/19/1983,2,0,2,8,12
6/20/1983,5,0,7,7,19
6/21/1983,4,0,8,10,22
6/22/1983,5,0,2,2,9
6/23/1983,3,0,2,10,15
6/24/1983,3,0,2,12,17
6/25/1983,3,0,6,1,10
6/26/1983,3,0,2,12,17
6/27/1983,8,0,2,2,12
6/28/1983,6,0,2,13,21
6/29/1983,4,0,4,5,13
6/30/1983,7,0,2,9,18
7/1/1983,6,0,5,10,21
7/2/1983,7,0,2,5,14
7/3/1983,3,0,5,2,10
7/4/1983,5,0,8,8,21
7/5/1983,7,0,2,1,10
7/6/1983,5,0,7,5,17
7/7/1983,6,0,5,1,12
7/8/1983,2,0,5,9,16
7/9/1983,5,0,7,9,21
7/10/1983,2,0,8,13,23
7/11/1983,7,0,4,3,14
7/12/1983,4,0,2,13,19
7/13/1983,8,0,4,3,15
7/14/1983,3,0,7,1,11
7/15/1983,6,0,7,11,24
7/16/1983,5,0,5,9,19
7/17/1983,7,0,5,12,24
7/18/1983,3,0,7,2,12
7/19/1983,8,0,8,11,27
7/20/1983,2,0,2,3,7
7/21/1983,7,0,2,10,19
7/22/1983,2,0,7,9,18
7/23/1983,8,0,4,12,24
7/24/1983,2,0,8,11,21
7/25/1983,3,0,2,1,6
7/26/1983,3,0,8,2,13
7/27/1983,3,0,7,1,11
7/28/1983,2,0,6,7,15
7/29/1983,2,0,7,12,21
7/30/1983,8,0,3,7,18
7/31/1983,7,0,8,5,20
8/1/1983,7,0,3,2,12
8/2/1983,4,0,2,5,11
8/3/1983,2,0,3,1,6
8/4/1983,4,0,2,6,12
8/5/1983,7,0,5,6,18
8/6/1983,3,0,5,10,18
8/7/1983,7,0,3,4,14
8/8/1983,6,0,5,0,11
8/9/1983,2,0,4,0,6
8/10/1983,7,0,7,3,17
8/11/1983,7,0,7,4,18
8/12/1983,3,0,8,2,13
8/13/1983,2,0,2,0,4
8/14/1983,6,0,5,0,11
8/15/1983,6,0,3,13,22
8/16/1983,4,0,3,2,9
8/17/1983,3,0,7,4,14
8/18/1983,5,0,7,3,15
8/19/1983,8,0,6,5,19
8/20/1983,7,0,2,11,20
8/21/1983,6,0,8,6,20
8/22/1983,4,0,5,1,10
8/23/1983,5,0,6,6,17
8/24/1983,8,0,8,12,28
8/25/1983,8,0,8,10,26
8/26/1983,7,0,8,5,20
8/27/1983,7,0,2,6,15
8/28/1983,8,0,4,0,12
8/29/1983,8,0,7,11,26
8/30/1983,7,0,7,7,21
8/31/1983,4,0,3,1,8
9/1/1983,7,0,6,8,21
9/2/1983,5,0,2,0,7
9/3/1983,5,0,6,6,17
9/4/1983,8,0,6,9,23
9/5/1983,4,0,7,0,11
9/6/1983,5,0,4,10,19
9/7/1983,6,0,6,10,22
9/8/1983,2,0,8,7,17
9/9/1983,6,0,2,7,15
9/10/1983,8,0,4,5,17
9/11/1983,7,0,5,1,13
9/12/1983,5,0,8,4,17
9/13/1983,8,0,7,12,27
9/14/1983,3,0,4,7,14
9/15/1983,2,0,4,3,9
9/16/1983,6,0,2,12,20
9/17/1983,4,0,8,2,14
9/18/1983,8,0,2,6,16
9/19/1983,5,0,3,4,12
9/20/1983,3,0,6,10,19
9/21/1983,3,0,7,5,15
9/22/1983,7,0,7,5,19
9/23/1983,6,0,4,6,16
9/24/1983,3,0,7,12,22
9/25/1983,2,0,4,5,11
9/26/1983,3,0,4,11,18
9/27/1983,5,0,3,11,19
9/28/1983,7,0,3,10,20
9/29/1983,8,0,8,4,20
9/30/1983,4,0,2,4,10
10/1/1983,5,0,8,12,25
10/2/1983,2,0,4,0,6
10/3/1983,2,0,8,5,15
10/4/1983,7,0,2,4,13
10/5/1983,6,0,2,13,21
10/6/1983,6,0,5,3,14
10/7/1983,7,0,2,10,19
10/8/1983,3,0,6,7,16
10/9/1983,8,0,4,11,23
10/10/1983,5,0,5,4,14
10/11/1983,3,0,4,2,9
10/12/1983,3,0,2,11,16
10/13/1983,8,0,4,9,21
10/14/1983,8,0,6,8,22
10/15/1983,5,0,5,10,20
10/16/1983,4,0,3,4,11
10/17/1983,8,0,5,13,26
10/18/1983,2,0,6,10,18
10/19/1983,8,0,5,9,22
10/20/1983,3,0,5,5,13
10/21/1983,2,0,2,1,5
10/22/1983,4,0,7,5,16
10/23/1983,2,0,2,9,13
10/24/1983,4,0,6,13,23
10/25/1983,5,0,2,1,8
10/26/1983,2,0,4,0,6
10/27/1983,5,0,7,5,17
10/28/1983,7,0,2,10,19
10/29/1983,3,0,4,12,19
10/30/1983,4,0,2,5,11
10/31/1983,4,0,5,3,12
11/1/1983,2,0,5,9,16
11/2/1983,2,0,6,3,11
11/3/1983,8,0,6,4,18
11/4/1983,5,0,2,13,20
11/5/1983,6,0,4,3,13
11/6/1983,6,0,6,11,23
11/7/1983,3,0,8,4,15
11/8/1983,4,0,7,13,24
11/9/1983,8,0,6,6,20
11/10/1983,6,0,7,2,15
11/11/1983,2,0,4,4,10
11/12/1983,4,0,4,9,17
11/13/1983,5,0,5,11,21
11/14/1983,5,0,6,0,11
11/15/1983,2,0,7,11,20
11/16/1983,2,0,5,2,9
11/17/1983,3,0,7,10,20
11/18/1983,8,0,7,1,16
11/19/1983,5,0,5,7,17
11/20/1983,2,0,3,9,14
11/21/1983,8,0,5,13,26
11/22/1983,5,0,5,2,12
11/23/1983,4,0,7,8,19
11/24/1983,8,0,7,7,22
11/25/1983,5,0,6,2,13
11/26/1983,2,0,2,8,12
11/27/1983,2,0,2,11,15
11/28/1983,2,0,3,11,16
11/29/1983,8,0,2,3,13
11/30/1983,3,0,7,11,21
12/1/1983,3,0,2,11,16
12/2/1983,8,0,4,8,20
12/3/1983,2,0,6,0,8
12/4/1983,3,0,8,8,19
12/5/1983,8,0,7,8,23
12/6/1983,6,0,8,1,15
12/7/1983,5,0,8,0,13
12/8/1983,4,0,6,4,14
12/9/1983,8,0,2,5,15
12/10/1983,8,0,3,0,11
12/11/1983,8,0,4,10,22
12/12/1983,2,0,2,3,7
12/13/1983,2,0,3,11,16
12/14/1983,5,0,2,13,20
12/15/1983,5,0,3,2,10
12/16/1983,3,0,7,8,18
12/17/1983,2,0,5,0,7
12/18/1983,2,0,5,12,19
12/19/1983,6,0,2,3,11
12/20/1983,3,0,7,11,21
12/21/1983,6,0,8,3,17
12/22/1983,4,0,8,4,16
12/23/1983,2,0,7,8,17
12/24/1983,4,0,3,11,18
12/25/1983,2,0,8,2,12
12/26/1983,2,0,2,4,8
12/27/1983,5,0,8,6,19
12/28/1983,2,0,2,1,5
12/29/1983,6,0,3,13,22
12/30/1983,3,0,8,6,17
12/31/1983,8,0,3,3,14
1/1/1984,4,0,4,6,14
1/2/1984,5,0,2,7,14
1/3/1984,4,0,8,2,14
1/4/1984,8,0,6,3,17
1/5/1984,7,0,4,11,22
1/6/1984,2,0,8,2,12
1/7/1984,2,0,6,2,10
1/8/1984,8,0,4,7,19
1/9/1984,6,0,4,10,20
1/10/1984,8,0,2,10,20
1/11/1984,2,0,7,0,9
1/12/1984,3,0,6,11,20
1/13/1984,3,0,7,13,23
1/14/1984,4,0,7,10,21
1/15/1984,8,0,5,1,14
1/16/1984,6,0,2,9,17
1/17/1984,8,0,6,6,20
1/18/1984,3,0,2,7,12
1/19/1984,7,0,7,5,19
1/20/1984,4,0,8,13,25
1/21/1984,4,0,4,9,17
1/22/1984,4,0,4,6,14
1/23/1984,2,0,3,7,12
1/24/1984,5,0,6,0,11
1/25/1984,4,0,6,0,10
1/26/1984,4,0,7,2,13
1/27/1984,8,0,4,12,24
1/28/1984,2,0,2,11,15
1/29/1984,7,0,7,11,25
1/30/1984,7,0,6,13,26
1/31/1984,6,0,2,10,18
2/1/1984,8,0,7,6,21
2/2/1984,5,0,4,4,13
2/3/1984,3,0,6,7,16
2/4/1984,8,0,4,4,16
2/5/1984,8,0,2,10,20
2/6/1984,5,0,7,13,25
2/7/1984,4,0,8,11,23
2/8/1984,5,0,5,10,20
2/9/1984,3,0,8,0,11
2/10/1984,4,0,8,13,25
2/11/1984,2,0,7,2,11
2/12/1984,7,0,7,7,21
2/13/1984,5,0,8,5,18
2/14/1984,6,0,4,10,20
2/15/1984,7,0,3,10,20
2/16/1984,8,0,2,9,19
2/17/1984,6,0,3,7,16
2/18/1984,8,0,3,11,22
2/19/1984,6,0,8,6,20
2/20/1984,4,0,6,6,16
2/21/1984,4,0,8,5,17
2/22/1984,7,0,2,9,18
2/23/1984,2,0,2,13,17
2/24/1984,7,0,3,2,12
2/25/1984,4,0,6,1,11
2/26/1984,6,0,2,11,19
2/27/1984,5,0,6,8,19
2/28/1984,7,0,5,11,23
2/29/1984,3,0,5,1,9
3/1/1984,3,0,8,10,21
3/2/1984,6,0,7,1,14
3/3/1984,4,0,7,4,15
3/4/1984,5,0,6,5,16
3/5/1984,4,0,2,10,16
3/6/1984,5,0,6,5,16
3/7/1984,2,0,6,12,20
3/8/1984,2,0,8,12,22
3/9/1984,4,0,3,0,7
3/10/1984,2,0,7,6,15
3/11/1984,3,0,4,8,15
3/12/1984,5,0,7,3,15
3/13/1984,5,0,3,12,20
3/14/1984,5,0,3,12,20
3/15/1984,4,0,7,0,11
3/16/1984,4,0,3,1,8
3/17/1984,5,0,7,4,16
3/18/1984,5,0,6,12,23
3/19/1984,8,0,8,6,22
3/20/1984,4,0,7,7,18
3/21/1984,2,0,8,4,14
3/22/1984,2,0,8,13,23
3/23/1984,5,0,3,10,18
3/24/1984,5,0,3,3,11
3/25/1984,5,0,3,2,10
3/26/1984,8,0,4,10,22
3/27/1984,6,0,6,9,21
3/28/1984,7,0,8,9,24
3/29/1984,4,0,6,4,14
3/30/1984,3,0,5,8,16
3/31/1984,6,0,7,9,22
4/1/1984,6,0,8,13,27
4/2/1984,4,0,3,8,15
4/3/1984,3,0,3,10,16
4/4/1984,2,0,2,11,15
4/5/1984,6,0,5,1,12
4/6/1984,7,0,5,8,20
4/7/1984,4,0,3,8,15
4/8/1984,8,0,2,10,20
4/9/1984,8,0,2,1,11
4/10/1984,5,0,7,7,19
4/11/1984,4,0,7,12,23
4/12/1984,6,0,6,0,12
4/13/1984,5,0,6,10,21
4/14/1984,7,0,8,13,28
4/15/1984,2,0,7,9,18
4/16/1984,3,0,7,2,12
4/17/1984,7,0,8,2,17
4/18/1984,4,0,7,1,12
4/19/1984,4,0,2,0,6
4/20/1984,4,0,5,3,12
4/21/1984,7,0,7,13,27
4/22/1984,8,0,2,10,20
4/23/1984,7,0,7,9,23
4/24/1984,5,0,2,2,9
4/25/1984,2,0,2,3,7
4/26/1984,3,0,8,11,22
4/27/1984,8,0,6,4,18
4/28/1984,6,0,2,9,17
4/29/1984,4,0,3,12,19
4/30/1984,7,0,7,5,19
5/1/1984,4,0,8,3,15
5/2/1984,5,0,2,11,18
5/3/1984,2,0,3,0,5
5/4/1984,4,0,5,10,19
5/5/1984,2,0,8,7,17
5/6/1984,7,0,5,9,21
5/7/1984,6,0,3,9,18
5/8/1984,3,0,3,2,8
5/9/1984,6,0,3,13,22
5/10/1984,3,0,3,1,7
5/11/1984,3,0,4,1,8
5/12/1984,3,0,4,11,18
5/13/1984,5,0,6,0,11
5/14/1984,5,0,6,1,12
5/15/1984,4,0,4,4,12
5/16/1984,5,0,2,2,9
5/17/1984,4,0,3,12,19
5/18/1984,5,0,4,12,21
5/19/1984,4,0,4,6,14
5/20/1984,4,0,3,5,12
5/21/1984,2,0,5,13,20
5/22/1984,6,0,6,12,24
5/23/1984,2,0,4,3,9
5/24/1984,7,0,8,8,23
5/25/1984,7,0,8,7,22
5/26/1984,2,0,5,3,10
5/27/1984,5,0,2,3,10
5/28/1984,2,0,4,12,18
5/29/1984,7,0,4,7,18
5/30/1984,3,0,2,2,7
5/31/1984,5,0,7,0,12
6/1/1984,6,0,5,5,16
6/2/1984,7,0,7,9,23
6/3/1984,5,0,3,9,17
6/4/1984,6,0,5,9,20
6/5/1984,8,0,2,12,22
6/6/1984,5,0,5,0,10
6/7/1984,7,0,2,9,18
6/8/1984,7,0,6,9,22
6/9/1984,6,0,4,10,20
6/10/1984,8,0,6,3,17
6/11/1984,7,0,6,9,22
6/12/1984,6,0,7,12,25
6/13/1984,5,0,8,1,14
6/14/1984,7,0,3,11,21
6/15/1984,2,0,4,2,8
6/16/1984,6,0,4,10,20
6/17/1984,2,0,3,2,7
6/18/1984,2,0,3,2,7
6/19/1984,5,0,3,3,11
6/20/1984,6,0,3,0,9
6/21/1984,4,0,4,1,9
6/22/1984,5,0,8,12,25
6/23/1984,5,0,8,4,17
6/24/1984,2,0,5,7,14
6/25/1984,8,0,2,6,16
6/26/1984,3,0,2,1,6
6/27/1984,2,0,7,13,22
6/28/1984,8,0,5,4,17
6/29/1984,4,0,4,12,20
6/30/1984,7,0,8,7,22
7/1/1984,2,0,2,13,17
7/2/1984,5,0,8,3,16
7/3/1984,3,0,4,4,11
7/4/1984,3,0,7,4,14
7/5/1984,4,0,5,7,16
7/6/1984,5,0,8,5,18
7/7/1984,2,0,2,2,6
7/8/1984,5,0,2,12,19
7/9/1984,7,0,6,0,13
7/10/1984,6,0,6,10,22
7/11/1984,8,0,5,11,24
7/12/1984,6,0,7,8,21
7/13/1984,8,0,7,0,15
7/14/1984,7,0,6,0,13
7/15/1984,6,0,4,12,22
7/16/1984,4,0,7,4,15
7/17/1984,6,0,6,13,25
7/18/1984,6,0,2,4,12
7/19/1984,7,0,7,12,26
7/20/1984,5,0,6,6,17
7/21/1984,8,0,7,4,19
7/22/1984,4,0,6,13,23
7/23/1984,6,0,4,9,19
7/24/1984,4,0,3,11,18
7/25/1984,4,0,4,9,17
7/26/1984,8,0,7,3,18
7/27/1984,2,0,3,9,14
7/28/1984,7,0,3,6,16
7/29/1984,7,0,4,6,17
7/30/1984,7,0,4,6,17
7/31/1984,7,0,7,13,27
8/1/1984,6,0,7,9,22
8/2/1984,7,0,2,1,10
8/3/1984,6,0,2,9,17
8/4/1984,4,0,6,7,17
8/5/1984,8,0,3,10,21
8/6/1984,6,0,4,4,14
8/7/1984,5,0,2,6,13
8/8/1984,4,0,3,8,15
8/9/1984,4,0,6,2,12
8/10/1984,2,0,3,3,8
8/11/1984,4,0,5,4,13
8/12/1984,5,0,7,6,18
8/13/1984,8,0,2,5,15
8/14/1984,7,0,3,11,21
8/15/1984,5,0,4,5,14
8/16/1984,5,0,4,3,12
8/17/1984,6,0,5,13,24
8/18/1984,2,0,7,8,17
8/19/1984,5,0,3,2,10
8/20/1984,8,0,6,12,26
8/21/1984,8,0,5,0,13
8/22/1984,2,0,3,13,18
8/23/1984,2,0,2,3,7
8/24/1984,7,0,3,4,14
8/25/1984,3,0,2,4,9
8/26/1984,5,0,7,1,13
8/27/1984,5,0,7,9,21
8/28/1984,4,0,5,0,9
8/29/1984,6,0,4,11,21
8/30/1984,3,0,8,4,15
8/31/1984,6,0,4,10,20
9/1/1984,6,0,7,7,20
9/2/1984,4,0,3,11,18
9/3/1984,7,0,5,3,15
9/4/1984,2,0,4,11,17
9/5/1984,7,0,6,7,20
9/6/1984,4,0,2,2,8
9/7/1984,3,0,2,1,6
9/8/1984,6,0,3,5,14
9/9/1984,8,0,5,11,24
9/10/1984,2,0,2,4,8
9/11/1984,6,0,6,9,21
9/12/1984,8,0,7,11,26
9/13/1984,6,0,4,2,12
9/14/1984,4,0,3,10,17
9/15/1984,2,0,7,7,16
9/16/1984,4,0,6,5,15
9/17/1984,2,0,3,5,10
9/18/1984,7,0,3,6,16
9/19/1984,2,0,4,0,6
9/20/1984,3,0,6,8,17
9/21/1984,2,0,6,13,21
9/22/1984,2,0,7,10,19
9/23/1984,7,0,6,10,23
9/24/1984,5,0,2,1,8
9/25/1984,5,0,5,6,16
9/26/1984,7,0,6,6,19
9/27/1984,8,0,3,5,16
9/28/1984,5,0,2,13,20
9/29/1984,6,0,5,12,23
9/30/1984,3,0,8,11,22
10/1/1984,2,0,7,12,21
10/2/1984,5,0,3,1,9
10/3/1984,8,0,5,0,13
10/4/1984,3,0,3,9,15
10/5/1984,5,0,8,5,18
10/6/1984,2,0,4,6,12
10/7/1984,5,0,4,2,11
10/8/1984,5,0,2,5,12
10/9/1984,2,0,4,10,16
10/10/1984,6,0,5,5,16
10/11/1984,7,0,8,7,22
10/12/1984,6,0,8,10,24
10/13/1984,5,0,7,5,17
10/14/1984,6,0,2,6,14
10/15/1984,2,0,5,4,11
10/16/1984,8,0,3,13,24
10/17/1984,3,0,5,13,21
10/18/1984,2,0,6,4,12
10/19/1984,7,0,7,9,23
10/20/1984,6,0,4,5,15
10/21/1984,6,0,8,3,17
10/22/1984,7,0,4,10,21
10/23/1984,8,0,2,7,17
10/24/1984,6,0,5,8,19
10/25/1984,3,0,5,4,12
10/26/1984,3,0,5,13,21
10/27/1984,5,0,8,4,17
10/28/1984,4,0,6,10,20
10/29/1984,7,0,8,13,28
10/30/1984,3,0,4,6,13
10/31/1984,3,0,4,10,17
11/1/1984,7,0,4,3,14
11/2/1984,4,0,6,9,19
11/3/1984,2,0,2,11,15
11/4/1984,7,0,4,2,13
11/5/1984,7,0,7,7,21
11/6/1984,4,0,6,5,15
11/7/1984,4,0,7,0,11
11/8/1984,7,0,8,8,23
11/9/1984,2,0,6,3,11
11/10/1984,4,0,6,12,22
11/11/1984,2,0,7,12,21
11/12/1984,8,0,2,4,14
11/13/1984,3,0,5,10,18
11/14/1984,4,0,3,11,18
11/15/1984,8,0,6,6,20
11/16/1984,3,0,2,1,6
11/17/1984,3,0,6,9,18
11/18/1984,3,0,8,7,18
11/19/1984,4,0,5,12,21
11/20/1984,7,0,8,12,27
11/21/1984,6,0,7,3,16
11/22/1984,4,0,3,13,20
11/23/1984,8,0,5,5,18
11/24/1984,6,0,7,8,21
11/25/1984,3,0,5,1,9
11/26/1984,3,0,7,1,11
11/27/1984,7,0,5,3,15
11/28/1984,8,0,8,0,16
11/29/1984,8,0,8,0,16
11/30/1984,8,0,4,13,25
12/1/1984,4,0,4,5,13
12/2/1984,3,0,5,8,16
12/3/1984,3,0,8,2,13
12/4/1984,4,0,7,12,23
12/5/1984,7,0,6,2,15
12/6/1984,5,0,3,0,8
12/7/1984,7,0,8,8,23
12/8/1984,5,0,5,4,14
12/9/1984,7,0,3,0,10
12/10/1984,5,0,5,1,11
12/11/1984,4,0,8,13,25
12/12/1984,7,0,4,2,13
12/13/1984,2,0,3,12,17
12/14/1984,2,0,6,6,14
12/15/1984,6,0,2,12,20
12/16/1984,2,0,7,5,14
12/17/1984,6,0,3,13,22
12/18/1984,8,0,5,6,19
12/19/1984,4,0,2,12,18
12/20/1984,2,0,5,12,19
12/21/1984,4,0,5,4,13
12/22/1984,4,0,3,5,12
12/23/1984,8,0,7,0,15
12/24/1984,3,0,8,12,23
12/25/1984,8,0,7,4,19
12/26/1984,3,0,8,9,20
12/27/1984,4,0,7,12,23
12/28/1984,5,0,5,8,18
12/29/1984,2,0,4,5,11
12/30/1984,8,0,7,9,24
12/31/1984,2,0,4,7,13
1/1/1985,8,0,4,13,25
1/2/1985,2,0,3,8,13
1/3/1985,2,0,5,1,8
1/4/1985,7,0,3,3,13
1/5/1985,6,0,4,3,13
1/6/1985,5,0,7,8,20
1/7/1985,4,0,8,13,25
1/8/1985,6,0,8,1,15
1/9/1985,3,0,4,6,13
1/10/1985,2,0,5,11,18
1/11/1985,7,0,2,10,19
1/12/1985,8,0,3,11,22
1/13/1985,8,0,8,11,27
1/14/1985,2,0,3,12,17
1/15/1985,8,0,5,5,18
1/16/1985,4,0,5,8,17
1/17/1985,3,0,7,13,23
1/18/1985,2,0,7,0,9
1/19/1985,4,0,5,12,21
1/20/1985,5,0,7,11,23
1/21/1985,6,0,8,0,14
1/22/1985,2,0,5,0,7
1/23/1985,8,0,7,7,22
1/24/1985,7,0,6,9,22
1/25/1985,7,0,5,12,24
1/26/1985,2,0,8,3,13
1/27/1985,3,0,5,3,11
1/28/1985,7,0,5,6,18
1/29/1985,6,0,3,10,19
1/30/1985,7,0,7,5,19
1/31/1985,6,0,6,9,21
2/1/1985,7,0,6,5,18
2/2/1985,8,0,8,5,21
2/3/1985,8,0,3,5,16
2/4/1985,4,0,4,8,16
2/5/1985,6,0,7,8,21
2/6/1985,5,0,8,4,17
2/7/1985,6,0,5,11,22
2/8/1985,5,0,8,9,22
2/9/1985,2,0,7,1,10
2/10/1985,2,0,3,1,6
2/11/1985,4,0,4,11,19
2/12/1985,8,0,4,13,25
2/13/1985,8,0,8,6,22
2/14/1985,7,0,7,9,23
2/15/1985,2,0,8,2,12
2/16/1985,8,0,8,10,26
2/17/1985,8,0,3,12,23
2/18/1985,7,0,6,13,26
2/19/1985,3,0,8,12,23
2/20/1985,2,0,8,13,23
2/21/1985,6,0,4,9,19
2/22/1985,3,0,4,5,12
2/23/1985,4,0,5,9,18
2/24/1985,8,0,6,0,14
2/25/1985,6,0,4,1,11
2/26/1985,6,0,2,1,9
2/27/1985,2,0,3,6,11
2/28/1985,3,0,6,5,14
3/1/1985,7,0,5,12,24
3/2/1985,4,0,6,6,16
3/3/1985,2,0,2,12,16
3/4/1985,8,0,3,1,12
3/5/1985,6,0,3,6,15
3/6/1985,4,0,6,8,18
3/7/1985,4,0,8,1,13
3/8/1985,8,0,3,1,12
3/9/1985,4,0,5,8,17
3/10/1985,8,0,7,11,26
3/11/1985,7,0,8,5,20
3/12/1985,5,0,2,4,11
3/13/1985,8,0,5,9,22
3/14/1985,4,0,3,13,20
3/15/1985,5,0,3,7,15
3/16/1985,7,0,3,8,18
3/17/1985,3,0,4,13,20
3/18/1985,7,0,3,10,20
3/19/1985,6,0,4,10,20
3/20/1985,7,0,6,6,19
3/21/1985,3,0,7,13,23
3/22/1985,7,0,4,6,17
3/23/1985,2,0,4,13,19
3/24/1985,8,0,8,0,16
3/25/1985,6,0,5,13,24
3/26/1985,4,0,4,12,20
3/27/1985,6,0,2,9,17
3/28/1985,4,0,5,1,10
3/29/1985,5,0,4,0,9
3/30/1985,7,0,8,0,15
3/31/1985,2,0,3,10,15
4/1/1985,7,0,8,9,24
4/2/1985,7,0,8,7,22
4/3/1985,4,0,4,7,15
4/4/1985,4,0,6,1,11
4/5/1985,3,0,3,6,12
4/6/1985,7,0,5,0,12
4/7/1985,8,0,3,2,13
4/8/1985,4,0,8,8,20
4/9/1985,2,0,8,2,12
4/10/1985,2,0,5,8,15
4/11/1985,5,0,4,0,9
4/12/1985,2,0,3,4,9
4/13/1985,8,0,5,1,14
4/14/1985,5,0,8,13,26
4/15/1985,3,0,7,5,15
4/16/1985,5,0,6,10,21
4/17/1985,7,0,3,12,22
4/18/1985,2,0,6,7,15
4/19/1985,3,0,5,5,13
4/20/1985,3,0,3,2,8
4/21/1985,8,0,7,8,23
4/22/1985,5,0,8,1,14
4/23/1985,7,0,2,0,9
4/24/1985,6,0,2,4,12
4/25/1985,4,0,2,1,7
4/26/1985,2,0,6,4,12
4/27/1985,5,0,8,4,17
4/28/1985,8,0,7,0,15
4/29/1985,6,0,5,3,14
4/30/1985,7,0,5,6,18
5/1/1985,7,0,6,2,15
5/2/1985,7,0,8,9,24
5/3/1985,7,0,7,4,18
5/4/1985,7,0,6,1,14
5/5/1985,8,0,5,6,19
5/6/1985,8,0,5,0,13
5/7/1985,4,0,2,4,10
5/8/1985,6,0,8,1,15
5/9/1985,6,0,2,3,11
5/10/1985,8,0,5,13,26
5/11/1985,2,0,4,12,18
5/12/1985,3,0,4,7,14
5/13/1985,4,0,5,10,19
5/14/1985,2,0,5,8,15
5/15/1985,5,0,7,3,15
5/16/1985,6,0,6,9,21
5/17/1985,4,0,4,11,19
5/18/1985,5,0,5,13,23
5/19/1985,3,0,2,2,7
5/20/1985,6,0,3,1,10
5/21/1985,4,0,4,11,19
5/22/1985,4,0,4,7,15
5/23/1985,4,0,4,7,15
5/24/1985,8,0,3,13,24
5/25/1985,7,0,4,10,21
5/26/1985,8,0,4,5,17
5/27/1985,3,0,7,8,18
5/28/1985,5,0,4,10,19
5/29/1985,5,0,6,13,24
5/30/1985,7,0,8,3,18
5/31/1985,7,0,7,3,17
6/1/1985,2,0,2,11,15
6/2/1985,7,0,4,8,19
6/3/1985,3,0,4,12,19
6/4/1985,6,0,7,5,18
6/5/1985,5,0,4,7,16
6/6/1985,8,0,4,1,13
6/7/1985,7,0,6,8,21
6/8/1985,8,0,8,11,27
6/9/1985,5,0,4,2,11
6/10/1985,7,0,3,1,11
6/11/1985,5,0,5,4,14
6/12/1985,2,0,7,2,11
6/13/1985,4,0,2,0,6
6/14/1985,7,0,8,2,17
6/15/1985,8,0,7,7,22
6/16/1985,7,0,6,1,14
6/17/1985,5,0,5,2,12
6/18/1985,4,0,5,9,18
6/19/1985,6,0,7,1,14
6/20/1985,5,0,2,12,19
6/21/1985,6,0,3,3,12
6/22/1985,4,0,8,4,16
6/23/1985,6,0,7,8,21
6/24/1985,2,0,4,2,8
6/25/1985,3,0,2,3,8
6/26/1985,3,0,3,11,17
6/27/1985,3,0,8,7,18
6/28/1985,6,0,5,3,14
6/29/1985,7,0,4,5,16
6/30/1985,4,0,2,5,11
7/1/1985,5,0,5,10,20
7/2/1985,4,0,2,7,13
7/3/1985,5,0,7,12,24
7/4/1985,2,0,8,3,13
7/5/1985,7,0,3,3,13
7/6/1985,2,0,5,5,12
7/7/1985,3,0,7,11,21
7/8/1985,5,0,3,11,19
7/9/1985,6,0,5,13,24
7/10/1985,6,0,5,6,17
7/11/1985,2,0,8,7,17
7/12/1985,3,0,6,2,11
7/13/1985,8,0,7,10,25
7/14/1985,5,0,4,6,15
7/15/1985,8,0,2,3,13
7/16/1985,7,0,3,0,10
7/17/1985,5,0,4,1,10
7/18/1985,5,0,2,9,16
7/19/1985,8,0,7,0,15
7/20/1985,4,0,5,12,21
7/21/1985,3,0,8,2,13
7/22/1985,8,0,2,3,13
7/23/1985,4,0,8,7,19
7/24/1985,2,0,3,2,7
7/25/1985,3,0,6,1,10
7/26/1985,7,0,7,4,18
7/27/1985,8,0,6,7,21
7/28/1985,7,0,2,1,10
7/29/1985,6,0,3,5,14
7/30/1985,5,0,8,9,22
7/31/1985,2,0,7,0,9
8/1/1985,7,0,6,13,26
8/2/1985,2,0,8,8,18
8/3/1985,5,0,4,0,9
8/4/1985,8,0,5,9,22
8/5/1985,2,0,2,6,10
8/6/1985,6,0,2,1,9
8/7/1985,7,0,3,6,16
8/8/1985,5,0,4,0,9
8/9/1985,5,0,2,2,9
8/10/1985,6,0,3,13,22
8/11/1985,7,0,3,3,13
8/12/1985,5,0,7,10,22
8/13/1985,7,0,7,11,25
8/14/1985,8,0,5,10,23
8/15/1985,8,0,7,4,19
8/16/1985,4,0,7,7,18
8/17/1985,4,0,8,9,21
8/18/1985,8,0,3,6,17
8/19/1985,6,0,5,3,14
8/20/1985,2,0,6,1,9
8/21/1985,5,0,2,0,7
8/22/1985,2,0,6,10,18
8/23/1985,3,0,2,10,15
8/24/1985,2,0,5,7,14
8/25/1985,2,0,8,1,11
8/26/1985,8,0,2,1,11
8/27/1985,7,0,7,4,18
8/28/1985,8,0,6,7,21
8/29/1985,7,0,3,7,17
8/30/1985,3,0,6,4,13
8/31/1985,2,0,2,7,11
9/1/1985,6,0,5,4,15
9/2/1985,2,0,4,4,10
9/3/1985,4,0,7,13,24
9/4/1985,7,0,7,0,14
9/5/1985,8,0,8,12,28
9/6/1985,7,0,5,5,17
9/7/1985,2,0,6,1,9
9/8/1985,3,0,3,12,18
9/9/1985,3,0,2,3,8
9/10/1985,5,0,3,11,19
9/11/1985,6,0,5,5,16
9/12/1985,8,0,8,4,20
9/13/1985,6,0,8,0,14
9/14/1985,7,0,2,9,18
9/15/1985,6,0,2,12,20
9/16/1985,3,0,6,5,14
9/17/1985,6,0,2,9,17
9/18/1985,2,0,4,10,16
9/19/1985,4,0,7,0,11
9/20/1985,7,0,6,0,13
9/21/1985,6,0,8,0,14
9/22/1985,2,0,6,13,21
9/23/1985,8,0,5,2,15
9/24/1985,8,0,8,5,21
9/25/1985,3,0,7,2,12
9/26/1985,2,0,5,11,18
9/27/1985,5,0,6,4,15
9/28/1985,8,0,5,3,16
9/29/1985,7,0,2,11,20
9/30/1985,4,0,5,10,19
10/1/1985,7,0,7,10,24
10/2/1985,6,0,6,4,16
10/3/1985,5,0,2,9,16
10/4/1985,5,0,6,12,23
10/5/1985,6,0,5,11,22
10/6/1985,6,0,2,9,17
10/7/1985,6,0,5,10,21
10/8/1985,8,0,4,0,12
10/9/1985,8,0,8,4,20
10/10/1985,3,0,3,8,14
10/11/1985,7,0,8,9,24
10/12/1985,4,0,4,10,18
10/13/1985,6,0,6,7,19
10/14/1985,6,0,7,10,23
10/15/1985,3,0,7,6,16
10/16/1985,3,0,8,13,24
10/17/1985,6,0,8,10,24
10/18/1985,2,0,3,13,18
10/19/1985,8,0,8,8,24
10/20/1985,6,0,7,5,18
10/21/1985,2,0,6,3,11
10/22/1985,4,0,4,11,19
10/23/1985,4,0,3,3,10
10/24/1985,2,0,8,5,15
10/25/1985,2,0,7,11,20
10/26/1985,7,0,5,4,16
10/27/1985,6,0,4,5,15
10/28/1985,5,0,5,7,17
10/29/1985,6,0,2,9,17
10/30/1985,3,0,8,3,14
10/31/1985,7,0,3,12,22
11/1/1985,7,0,4,0,11
11/2/1985,8,0,5,1,14
11/3/1985,3,0,2,8,13
11/4/1985,4,0,3,1,8
11/5/1985,2,0,7,8,17
11/6/1985,2,0,7,4,13
11/7/1985,5,0,8,7,20
11/8/1985,6,0,8,11,25
11/9/1985,5,0,7,10,22
11/10/1985,7,0,5,1,13
11/11/1985,4,0,3,13,20
11/12/1985,5,0,4,12,21
11/13/1985,8,0,4,9,21
11/14/1985,5,0,2,4,11
11/15/1985,2,0,8,9,19
11/16/1985,7,0,2,12,21
11/17/1985,6,0,2,11,19
11/18/1985,3,0,3,8,14
11/19/1985,3,0,3,9,15
11/20/1985,4,0,4,3,11
11/21/1985,6,0,8,12,26
11/22/1985,4,0,6,7,17
11/23/1985,4,0,5,9,18
11/24/1985,5,0,3,13,21
11/25/1985,8,0,3,4,15
11/26/1985,3,0,4,1,8
11/27/1985,3,0,6,10,19
11/28/1985,6,0,4,13,23
11/29/1985,8,0,3,7,18
11/30/1985,6,0,7,0,13
12/1/1985,3,0,6,8,17
12/2/1985,4,0,5,6,15
12/3/1985,3,0,5,7,15
12/4/1985,2,0,7,6,15
12/5/1985,2,0,5,8,15
12/6/1985,5,0,7,9,21
12/7/1985,4,0,8,7,19
12/8/1985,7,0,7,1,15
12/9/1985,5,0,8,5,18
12/10/1985,6,0,5,12,23
12/11/1985,2,0,7,6,15
12/12/1985,4,0,6,12,22
12/13/1985,4,0,4,1,9
12/14/1985,3,0,3,5,11
12/15/1985,4,0,3,5,12
12/16/1985,3,0,5,6,14
12/17/1985,5,0,3,13,21
12/18/1985,5,0,3,12,20
12/19/1985,5,0,2,1,8
12/20/1985,6,0,3,13,22
12/21/1985,4,0,2,1,7
12/22/1985,7,0,8,6,21
12/23/1985,4,0,7,6,17
12/24/1985,4,0,7,11,22
12/25/1985,5,0,6,7,18
12/26/1985,5,0,5,0,10
12/27/1985,8,0,2,8,18
12/28/1985,5,0,8,5,18
12/29/1985,4,0,4,12,20
12/30/1985,5,0,5,1,11
12/31/1985,5,0,6,0,11
1/1/1986,5,0,4,5,14
1/2/1986,4,0,8,13,25
1/3/1986,6,0,5,13,24
1/4/1986,7,0,2,7,16
1/5/1986,3,0,3,9,15
1/6/1986,2,0,2,5,9
1/7/1986,7,0,4,12,23
1/8/1986,2,0,8,7,17
1/9/1986,2,0,6,4,12
1/10/1986,4,0,3,12,19
1/11/1986,6,0,6,4,16
1/12/1986,3,0,4,3,10
1/13/1986,2,0,4,5,11
1/14/1986,8,0,6,4,18
1/15/1986,6,0,7,13,26
1/16/1986,6,0,4,11,21
1/17/1986,6,0,2,7,15
1/18/1986,7,0,7,6,20
1/19/1986,5,0,5,1,11
1/20/1986,6,0,3,5,14
1/21/1986,2,0,7,9,18
1/22/1986,6,0,4,12,22
1/23/1986,8,0,6,0,14
1/24/1986,8,0,4,13,25
1/25/1986,2,0,6,8,16
1/26/1986,5,0,5,9,19
1/27/1986,5,0,2,12,19
1/28/1986,3,0,8,6,17
1/29/1986,5,0,8,13,26
1/30/1986,7,0,7,1,15
1/31/1986,3,0,2,5,10
2/1/1986,5,0,2,4,11
2/2/1986,5,0,4,9,18
2/3/1986,3,0,3,4,10
2/4/1986,8,0,6,9,23
2/5/1986,5,0,3,11,19
2/6/1986,6,0,7,5,18
2/7/1986,3,0,4,3,10
2/8/1986,5,0,8,11,24
2/9/1986,7,0,2,13,22
2/10/1986,3,0,8,9,20
2/11/1986,6,0,2,9,17
2/12/1986,8,0,7,4,19
2/13/1986,5,0,3,10,18
2/14/1986,5,0,4,6,15
2/15/1986,8,0,5,9,22
2/16/1986,3,0,8,6,17
2/17/1986,7,0,2,4,13
2/18/1986,8,0,5,8,21
2/19/1986,8,0,8,10,26
2/20/1986,7,0,2,9,18
2/21/1986,6,0,3,7,16
2/22/1986,2,0,6,7,15
2/23/1986,3,0,8,5,16
2/24/1986,5,0,7,2,14
2/25/1986,6,0,3,2,11
2/26/1986,7,0,4,11,22
2/27/1986,8,0,5,4,17
2/28/1986,2,0,2,7,11
3/1/1986,8,0,3,12,23
3/2/1986,3,0,7,4,14
3/3/1986,4,0,2,5,11
3/4/1986,7,0,8,10,25
3/5/1986,6,0,8,0,14
3/6/1986,2,0,2,9,13
3/7/1986,8,0,2,6,16
3/8/1986,3,0,6,10,19
3/9/1986,4,0,8,13,25
3/10/1986,6,0,6,9,21
3/11/1986,5,0,3,2,10
3/12/1986,8,0,5,6,19
3/13/1986,8,0,7,1,16
3/14/1986,2,0,8,3,13
3/15/1986,4,0,5,7,16
3/16/1986,6,0,2,13,21
3/17/1986,5,0,6,8,19
3/18/1986,6,0,4,8,18
3/19/1986,3,0,5,2,10
3/20/1986,7,0,6,4,17
3/21/1986,5,0,3,4,12
3/22/1986,5,0,6,0,11
3/23/1986,7,0,2,10,19
3/24/1986,8,0,6,2,16
3/25/1986,3,0,4,12,19
3/26/1986,5,0,7,10,22
3/27/1986,5,0,2,7,14
3/28/1986,3,0,3,8,14
3/29/1986,6,0,8,5,19
3/30/1986,7,0,2,11,20
3/31/1986,4,0,5,5,14
4/1/1986,3,0,8,10,21
4/2/1986,4,0,8,13,25
4/3/1986,4,0,7,11,22
4/4/1986,5,0,3,6,14
4/5/1986,5,0,5,0,10
4/6/1986,5,0,4,0,9
4/7/1986,8,0,6,4,18
4/8/1986,6,0,7,6,19
4/9/1986,6,0,8,10,24
4/10/1986,2,0,8,13,23
4/11/1986,5,0,8,6,19
4/12/1986,5,0,4,10,19
4/13/1986,6,0,5,6,17
4/14/1986,6,0,3,8,17
4/15/1986,4,0,7,2,13
4/16/1986,3,0,6,13,22
4/17/1986,4,0,6,5,15
4/18/1986,5,0,8,0,13
4/19/1986,6,0,2,6,14
4/20/1986,7,0,2,0,9
4/21/1986,8,0,5,4,17
4/22/1986,4,0,3,1,8
4/23/1986,2,0,8,2,12
4/24/1986,8,0,6,9,23
4/25/1986,8,0,6,8,22
4/26/1986,2,0,4,13,19
4/27/1986,5,0,3,4,12
4/28/1986,2,0,7,0,9
4/29/1986,5,0,8,2,15
4/30/1986,2,0,2,12,16
5/1/1986,3,0,5,7,15
5/2/1986,4,0,8,8,20
5/3/1986,3,0,6,7,16
5/4/1986,5,0,3,13,21
5/5/1986,6,0,8,7,21
5/6/1986,4,0,3,1,8
5/7/1986,5,0,5,10,20
5/8/1986,7,0,3,12,22
5/9/1986,2,0,2,0,4
5/10/1986,7,0,2,13,22
5/11/1986,8,0,4,2,14
5/12/1986,2,0,8,9,19
5/13/1986,7,0,3,11,21
5/14/1986,3,0,2,0,5
5/15/1986,4,0,7,13,24
5/16/1986,5,0,3,13,21
5/17/1986,4,0,6,10,20
5/18/1986,8,0,6,7,21
5/19/1986,6,0,8,13,27
5/20/1986,8,0,2,5,15
5/21/1986,8,0,4,4,16
5/22/1986,3,0,4,12,19
5/23/1986,2,0,4,9,15
5/24/1986,4,0,5,13,22
5/25/1986,5,0,3,11,19
5/26/1986,2,0,5,6,13
5/27/1986,4,0,8,9,21
5/28/1986,2,0,3,6,11
5/29/1986,6,0,2,0,8
5/30/1986,8,0,2,4,14
5/31/1986,8,0,5,13,26
6/1/1986,5,0,3,4,12
6/2/1986,3,0,2,10,15
6/3/1986,8,0,6,0,14
6/4/1986,3,0,4,11,18
6/5/1986,2,0,7,8,17
6/6/1986,3,0,5,5,13
6/7/1986,4,0,4,5,13
6/8/1986,2,0,8,2,12
6/9/1986,6,0,8,0,14
6/10/1986,6,0,7,11,24
6/11/1986,4,0,5,6,15
6/12/1986,6,0,5,10,21
6/13/1986,6,0,3,6,15
6/14/1986,5,0,6,11,22
6/15/1986,5,0,5,0,10
6/16/1986,5,0,4,10,19
6/17/1986,2,0,4,5,11
6/18/1986,6,0,6,4,16
6/19/1986,8,0,4,13,25
6/20/1986,6,0,3,7,16
6/21/1986,2,0,8,0,10
6/22/1986,2,0,5,10,17
6/23/1986,2,0,2,11,15
6/24/1986,2,0,8,4,14
6/25/1986,8,0,5,9,22
6/26/1986,8,0,5,5,18
6/27/1986,8,0,4,7,19
6/28/1986,5,0,7,8,20
6/29/1986,6,0,8,5,19
6/30/1986,2,0,6,7,15
7/1/1986,7,0,4,2,13
7/2/1986,4,0,5,3,12
7/3/1986,5,0,4,13,22
7/4/1986,5,0,8,11,24
7/5/1986,6,0,6,9,21
7/6/1986,8,0,3,7,18
7/7/1986,7,0,7,0,14
7/8/1986,4,0,6,7,17
7/9/1986,5,0,2,1,8
7/10/1986,5,0,3,10,18
7/11/1986,2,0,3,11,16
7/12/1986,3,0,2,12,17
7/13/1986,8,0,5,9,22
7/14/1986,7,0,8,10,25
7/15/1986,3,0,6,5,14
7/16/1986,8,0,3,3,14
7/17/1986,7,0,3,0,10
7/18/1986,6,0,8,2,16
7/19/1986,8,0,5,12,25
7/20/1986,7,0,8,9,24
7/21/1986,7,0,2,9,18
7/22/1986,4,0,4,10,18
7/23/1986,2,0,7,11,20
7/24/1986,8,0,2,8,18
7/25/1986,5,0,7,5,17
7/26/1986,6,0,4,4,14
7/27/1986,4,0,5,2,11
7/28/1986,6,0,5,6,17
7/29/1986,7,0,4,12,23
7/30/1986,5,0,8,10,23
7/31/1986,3,0,4,1,8
8/1/1986,8,0,5,0,13
8/2/1986,2,0,8,2,12
8/3/1986,5,0,8,0,13
8/4/1986,7,0,5,6,18
8/5/1986,6,0,8,2,16
8/6/1986,7,0,7,10,24
8/7/1986,5,0,2,5,12
8/8/1986,6,0,7,6,19
8/9/1986,6,0,8,9,23
8/10/1986,6,0,8,4,18
8/11/1986,3,0,8,3,14
8/12/1986,2,0,2,8,12
8/13/1986,2,0,7,10,19
8/14/1986,2,0,6,4,12
8/15/1986,6,0,5,0,11
8/16/1986,5,0,8,8,21
8/17/1986,5,0,3,11,19
8/18/1986,4,0,2,6,12
8/19/1986,6,0,6,3,15
8/20/1986,3,0,2,12,17
8/21/1986,2,0,7,3,12
8/22/1986,5,0,7,0,12
8/23/1986,2,0,5,2,9
8/24/1986,5,0,4,10,19
8/25/1986,2,0,4,4,10
8/26/1986,6,0,6,11,23
8/27/1986,4,0,6,11,21
8/28/1986,8,0,5,12,25
8/29/1986,7,0,4,2,13
8/30/1986,8,0,6,1,15
8/31/1986,7,0,8,6,21
9/1/1986,4,0,8,7,19
9/2/1986,2,0,4,4,10
9/3/1986,4,0,3,12,19
9/4/1986,8,0,4,10,22
9/5/1986,5,0,4,4,13
9/6/1986,4,0,3,2,9
9/7/1986,6,0,5,2,13
9/8/1986,2,0,4,4,10
9/9/1986,6,0,7,0,13
9/10/1986,7,0,6,6,19
9/11/1986,8,0,3,9,20
9/12/1986,3,0,3,7,13
9/13/1986,3,0,4,12,19
9/14/1986,2,0,7,5,14
9/15/1986,7,0,2,2,11
9/16/1986,6,0,4,11,21
9/17/1986,4,0,6,10,20
9/18/1986,6,0,3,9,18
9/19/1986,2,0,2,1,5
9/20/1986,5,0,5,13,23
9/21/1986,7,0,4,1,12
9/22/1986,3,0,2,5,10
9/23/1986,4,0,5,4,13
9/24/1986,7,0,3,0,10
9/25/1986,8,0,3,12,23
9/26/1986,7,0,4,2,13
9/27/1986,7,0,6,13,26
9/28/1986,5,0,8,11,24
9/29/1986,8,0,7,8,23
9/30/1986,8,0,7,7,22
10/1/1986,2,0,7,7,16
10/2/1986,2,0,2,3,7
10/3/1986,5,0,2,2,9
10/4/1986,6,0,8,9,23
10/5/1986,5,0,5,0,10
10/6/1986,5,0,8,7,20
10/7/1986,7,0,3,8,18
10/8/1986,3,0,6,13,22
10/9/1986,2,0,3,11,16
10/10/1986,5,0,3,11,19
10/11/1986,7,0,7,6,20
10/12/1986,2,0,6,7,15
10/13/1986,6,0,2,6,14
10/14/1986,3,0,2,12,17
10/15/1986,5,0,7,7,19
10/16/1986,7,0,2,1,10
10/17/1986,4,0,5,9,18
10/18/1986,8,0,2,5,15
10/19/1986,7,0,2,1,10
10/20/1986,2,0,2,10,14
10/21/1986,2,0,2,12,16
10/22/1986,7,0,2,6,15
10/23/1986,7,0,3,0,10
10/24/1986,4,0,6,2,12
10/25/1986,6,0,3,8,17
10/26/1986,3,0,7,12,22
10/27/1986,4,0,6,12,22
10/28/1986,8,0,6,10,24
10/29/1986,3,0,6,12,21
10/30/1986,6,0,7,3,16
10/31/1986,6,0,3,7,16
11/1/1986,2,0,4,1,7
11/2/1986,3,0,5,5,13
11/3/1986,2,0,2,3,7
11/4/1986,6,0,3,6,15
11/5/1986,4,0,2,13,19
11/6/1986,6,0,3,13,22
11/7/1986,8,0,6,0,14
11/8/1986,6,0,8,11,25
11/9/1986,7,0,3,10,20
11/10/1986,2,0,3,11,16
11/11/1986,8,0,6,9,23
11/12/1986,5,0,6,12,23
11/13/1986,8,0,8,8,24
11/14/1986,7,0,3,4,14
11/15/1986,8,0,2,3,13
11/16/1986,6,0,2,6,14
11/17/1986,5,0,4,12,21
11/18/1986,8,0,7,11,26
11/19/1986,5,0,4,10,19
11/20/1986,2,0,4,2,8
11/21/1986,4,0,2,9,15
11/22/1986,3,0,8,2,13
11/23/1986,2,0,7,10,19
11/24/1986,7,0,8,2,17
11/25/1986,6,0,4,1,11
11/26/1986,4,0,6,7,17
11/27/1986,3,0,2,10,15
11/28/1986,6,0,2,0,8
11/29/1986,7,0,4,13,24
11/30/1986,6,0,6,8,20
12/1/1986,3,0,4,8,15
12/2/1986,3,0,5,4,12
12/3/1986,2,0,8,11,21
12/4/1986,7,0,7,2,16
12/5/1986,2,0,7,1,10
12/6/1986,8,0,2,12,22
12/7/1986,7,0,7,12,26
12/8/1986,6,0,6,13,25
12/9/1986,5,0,8,10,23
12/10/1986,5,0,6,4,15
12/11/1986,3,0,2,11,16
12/12/1986,4,0,6,0,10
12/13/1986,6,0,2,1,9
12/14/1986,4,0,7,11,22
12/15/1986,8,0,6,2,16
12/16/1986,2,0,8,12,22
12/17/1986,8,0,2,2,12
12/18/1986,4,0,8,6,18
12/19/1986,7,0,8,2,17
12/20/1986,2,0,6,12,20
12/21/1986,5,0,4,2,11
12/22/1986,5,0,7,9,21
12/23/1986,5,0,2,11,18
12/24/1986,6,0,6,4,16
12/25/1986,6,0,2,13,21
12/26/1986,8,0,8,2,18
12/27/1986,5,0,5,11,21
12/28/1986,5,0,5,3,13
12/29/1986,2,0,8,9,19
12/30/1986,2,0,7,7,16
12/31/1986,5,0,6,13,24
1/1/1987,7,0,2,5,14
1/2/1987,8,0,4,10,22
1/3/1987,3,0,6,5,14
1/4/1987,5,0,2,11,18
1/5/1987,4,0,8,4,16
1/6/1987,4,0,6,2,12
1/7/1987,8,0,4,0,12
1/8/1987,4,0,8,0,12
1/9/1987,7,0,5,8,20
1/10/1987,4,0,8,13,25
1/11/1987,8,0,6,3,17
1/12/1987,3,0,2,11,16
1/13/1987,7,0,4,12,23
1/14/1987,4,0,5,1,10
1/15/1987,3,0,3,10,16
1/16/1987,6,0,4,1,11
1/17/1987,7,0,5,3,15
1/18/1987,6,0,5,13,24
1/19/1987,8,0,2,4,14
1/20/1987,3,0,5,13,21
1/21/1987,2,0,8,10,20
1/22/1987,6,0,4,2,12
1/23/1987,2,0,8,9,19
1/24/1987,5,0,7,11,23
1/25/1987,5,0,8,3,16
1/26/1987,4,0,3,6,13
1/27/1987,6,0,4,7,17
1/28/1987,2,0,3,4,9
1/29/1987,4,0,7,5,16
1/30/1987,6,0,2,4,12
1/31/1987,7,0,8,8,23
2/1/1987,3,0,7,2,12
2/2/1987,3,0,6,11,20
2/3/1987,2,0,7,7,16
2/4/1987,3,0,7,1,11
2/5/1987,3,0,4,3,10
2/6/1987,2,0,6,5,13
2/7/1987,2,0,2,2,6
2/8/1987,5,0,7,12,24
2/9/1987,7,0,8,3,18
2/10/1987,6,0,5,6,17
2/11/1987,8,0,3,11,22
2/12/1987,5,0,6,13,24
2/13/1987,4,0,7,7,18
2/14/1987,3,0,2,4,9
2/15/1987,7,0,8,11,26
2/16/1987,4,0,4,9,17
2/17/1987,6,0,4,7,17
2/18/1987,8,0,7,5,20
2/19/1987,8,0,3,1,12
2/20/1987,2,0,5,3,10
2/21/1987,8,0,4,8,20
2/22/1987,8,0,6,11,25
2/23/1987,6,0,6,12,24
2/24/1987,8,0,5,12,25
2/25/1987,7,0,7,11,25
2/26/1987,7,0,8,3,18
2/27/1987,6,0,4,12,22
2/28/1987,2,0,5,10,17
3/1/1987,7,0,6,11,24
3/2/1987,5,0,6,12,23
3/3/1987,2,0,6,5,13
3/4/1987,6,0,8,2,16
3/5/1987,8,0,5,10,23
3/6/1987,6,0,8,12,26
3/7/1987,6,0,3,7,16
3/8/1987,8,0,8,8,24
3/9/1987,4,0,3,8,15
3/10/1987,5,0,3,7,15
3/11/1987,3,0,2,6,11
3/12/1987,3,0,6,13,22
3/13/1987,5,0,5,12,22
3/14/1987,5,0,4,1,10
3/15/1987,2,0,8,9,19
3/16/1987,3,0,8,9,20
3/17/1987,6,0,7,4,17
3/18/1987,3,0,8,2,13
3/19/1987,8,0,2,4,14
3/20/1987,3,0,7,3,13
3/21/1987,5,0,5,12,22
3/22/1987,4,0,6,8,18
3/23/1987,4,0,2,8,14
3/24/1987,2,0,7,0,9
3/25/1987,8,0,6,4,18
3/26/1987,4,0,6,5,15
3/27/1987,7,0,3,7,17
3/28/1987,6,0,2,9,17
3/29/1987,7,0,5,6,18
3/30/1987,7,0,2,7,16
3/31/1987,3,0,8,3,14
4/1/1987,8,0,6,9,23
4/2/1987,6,0,6,5,17
4/3/1987,2,0,6,13,21
4/4/1987,5,0,3,1,9
4/5/1987,5,0,8,9,22
4/6/1987,7,0,7,1,15
4/7/1987,2,0,6,7,15
4/8/1987,8,0,4,10,22
4/9/1987,5,0,6,7,18
4/10/1987,2,0,7,9,18
4/11/1987,5,0,2,13,20
4/12/1987,4,0,8,13,25
4/13/1987,8,0,7,3,18
4/14/1987,6,0,8,0,14
4/15/1987,8,0,8,3,19
4/16/1987,6,0,3,6,15
4/17/1987,5,0,5,13,23
4/18/1987,8,0,3,2,13
4/19/1987,5,0,6,2,13
4/20/1987,8,0,4,10,22
4/21/1987,3,0,3,10,16
4/22/1987,3,0,4,10,17
4/23/1987,5,0,6,1,12
4/24/1987,4,0,7,9,20
4/25/1987,4,0,2,13,19
4/26/1987,4,0,8,5,17
4/27/1987,2,0,4,6,12
4/28/1987,7,0,2,3,12
4/29/1987,6,0,2,5,13
4/30/1987,5,0,6,10,21
5/1/1987,3,0,8,1,12
5/2/1987,2,0,3,12,17
5/3/1987,2,0,8,10,20
5/4/1987,7,0,3,9,19
5/5/1987,7,0,2,9,18
5/6/1987,6,0,8,1,15
5/7/1987,7,0,3,8,18
5/8/1987,6,0,5,9,20
5/9/1987,8,0,5,4,17
5/10/1987,2,0,4,4,10
5/11/1987,3,0,4,4,11
5/12/1987,8,0,7,8,23
5/13/1987,2,0,5,4,11
5/14/1987,5,0,3,7,15
5/15/1987,3,0,5,0,8
5/16/1987,2,0,6,4,12
5/17/1987,7,0,5,5,17
5/18/1987,4,0,6,8,18
5/19/1987,4,0,2,3,9
5/20/1987,4,0,7,1,12
5/21/1987,2,0,3,8,13
5/22/1987,7,0,2,5,14
5/23/1987,2,0,8,13,23
5/24/1987,5,0,6,12,23
5/25/1987,7,0,8,10,25
5/26/1987,3,0,4,13,20
5/27/1987,3,0,6,9,18
5/28/1987,4,0,3,12,19
5/29/1987,7,0,8,4,19
5/30/1987,6,0,6,3,15
5/31/1987,2,0,6,12,20
6/1/1987,2,0,7,3,12
6/2/1987,4,0,6,7,17
6/3/1987,6,0,2,9,17
6/4/1987,8,0,7,7,22
6/5/1987,5,0,7,2,14
6/6/1987,6,0,3,11,20
6/7/1987,4,0,5,8,17
6/8/1987,4,0,8,12,24
6/9/1987,7,0,7,3,17
6/10/1987,2,0,6,6,14
6/11/1987,4,0,6,0,10
6/12/1987,2,0,4,8,14
6/13/1987,7,0,2,8,17
6/14/1987,7,0,3,5,15
6/15/1987,5,0,4,0,9
6/16/1987,5,0,5,6,16
6/17/1987,6,0,6,13,25
6/18/1987,2,0,5,2,9
6/19/1987,2,0,6,13,21
6/20/1987,6,0,2,1,9
6/21/1987,7,0,4,2,13
6/22/1987,8,0,8,11,27
6/23/1987,6,0,8,8,22
6/24/1987,6,0,3,2,11
6/25/1987,2,0,5,10,17
6/26/1987,2,0,4,4,10
6/27/1987,2,0,8,13,23
6/28/1987,3,0,5,3,11
6/29/1987,6,0,7,11,24
6/30/1987,4,0,2,13,19
7/1/1987,3,0,8,1,12
7/2/1987,5,0,8,11,24
7/3/1987,4,0,5,5,14
7/4/1987,6,0,2,10,18
7/5/1987,6,0,3,13,22
7/6/1987,2,0,8,1,11
7/7/1987,8,0,7,5,20
7/8/1987,4,0,7,3,14
7/9/1987,3,0,6,4,13
7/10/1987,6,0,6,8,20
7/11/1987,2,0,3,6,11
7/12/1987,7,0,8,10,25
7/13/1987,2,0,5,11,18
7/14/1987,8,0,4,2,14
7/15/1987,8,0,3,13,24
7/16/1987,8,0,6,10,24
7/17/1987,3,0,3,4,10
7/18/1987,3,0,4,11,18
7/19/1987,2,0,3,9,14
7/20/1987,5,0,7,6,18
7/21/1987,6,0,3,10,19
7/22/1987,8,0,8,9,25
7/23/1987,5,0,3,0,8
7/24/1987,7,0,4,2,13
7/25/1987,6,0,7,2,15
7/26/1987,5,0,2,0,7
7/27/1987,6,0,5,6,17
7/28/1987,3,0,5,13,21
7/29/1987,5,0,5,9,19
7/30/1987,8,0,8,11,27
7/31/1987,2,0,8,7,17
8/1/1987,5,0,8,11,24
8/2/1987,5,0,3,12,20
8/3/1987,3,0,6,6,15
8/4/1987,5,0,4,3,12
8/5/1987,4,0,8,7,19
8/6/1987,7,0,7,2,16
8/7/1987,5,0,5,2,12
8/8/1987,8,0,3,5,16
8/9/1987,5,0,2,10,17
8/10/1987,3,0,2,12,17
8/11/1987,6,0,5,9,20
8/12/1987,3,0,7,4,14
8/13/1987,6,0,2,4,12
8/14/1987,3,0,8,7,18
8/15/1987,3,0,4,10,17
8/16/1987,4,0,8,2,14
8/17/1987,2,0,6,13,21
8/18/1987,7,0,8,1,16
8/19/1987,5,0,3,1,9
8/20/1987,7,0,2,0,9
8/21/1987,2,0,5,10,17
8/22/1987,7,0,2,6,15
8/23/1987,8,0,5,6,19
8/24/1987,7,0,7,4,18
8/25/1987,7,0,8,0,15
8/26/1987,6,0,8,3,17
8/27/1987,8,0,3,6,17
8/28/1987,3,0,4,3,10
8/29/1987,3,0,4,7,14
8/30/1987,5,0,3,10,18
8/31/1987,8,0,3,3,14
9/1/1987,7,0,4,13,24
9/2/1987,3,0,6,2,11
9/3/1987,5,0,8,2,15
9/4/1987,7,0,4,4,15
9/5/1987,5,0,2,12,19
9/6/1987,6,0,2,12,20
9/7/1987,8,0,4,6,18
9/8/1987,6,0,7,13,26
9/9/1987,7,0,3,13,23
9/10/1987,4,0,3,6,13
9/11/1987,3,0,5,9,17
9/12/1987,2,0,4,6,12
9/13/1987,7,0,6,4,17
9/14/1987,3,0,3,3,9
9/15/1987,7,0,3,10,20
9/16/1987,8,0,3,0,11
9/17/1987,3,0,4,1,8
9/18/1987,5,0,6,3,14
9/19/1987,6,0,4,0,10
9/20/1987,6,0,5,2,13
9/21/1987,4,0,2,4,10
9/22/1987,3,0,6,9,18
9/23/1987,4,0,5,12,21
9/24/1987,6,0,2,12,20
9/25/1987,4,0,3,9,16
9/26/1987,7,0,7,0,14
9/27/1987,6,0,3,5,14
9/28/1987,2,0,7,2,11
9/29/1987,5,0,5,0,10
9/30/1987,2,0,7,4,13
10/1/1987,5,0,3,11,19
10/2/1987,7,0,7,6,20
10/3/1987,8,0,8,0,16
10/4/1987,2,0,4,3,9
10/5/1987,5,0,2,7,14
10/6/1987,6,0,4,1,11
10/7/1987,2,0,8,4,14
10/8/1987,3,0,6,6,15
10/9/1987,7,0,4,4,15
10/10/1987,2,0,5,9,16
10/11/1987,3,0,2,13,18
10/12/1987,2,0,4,7,13
10/13/1987,7,0,5,3,15
10/14/1987,7,0,6,7,20
10/15/1987,6,0,4,12,22
10/16/1987,4,0,2,10,16
10/17/1987,4,0,8,1,13
10/18/1987,7,0,3,12,22
10/19/1987,3,0,3,0,6
10/20/1987,2,0,3,11,16
10/21/1987,5,0,4,8,17
10/22/1987,3,0,8,3,14
10/23/1987,4,0,2,4,10
10/24/1987,5,0,4,4,13
10/25/1987,6,0,4,13,23
10/26/1987,5,0,3,2,10
10/27/1987,2,0,5,13,20
10/28/1987,5,0,7,1,13
10/29/1987,8,0,5,12,25
10/30/1987,8,0,3,9,20
10/31/1987,3,0,8,8,19
11/1/1987,2,0,2,6,10
11/2/1987,7,0,6,0,13
11/3/1987,5,0,2,8,15
11/4/1987,3,0,3,4,10
11/5/1987,6,0,7,0,13
11/6/1987,5,0,6,0,11
11/7/1987,3,0,2,7,12
11/8/1987,2,0,5,3,10
11/9/1987,3,0,5,9,17
11/10/1987,7,0,2,3,12
11/11/1987,8,0,5,7,20
11/12/1987,2,0,6,9,17
11/13/1987,7,0,2,12,21
11/14/1987,8,0,3,11,22
11/15/1987,5,0,4,4,13
11/16/1987,2,0,4,5,11
11/17/1987,8,0,4,1,13
11/18/1987,4,0,3,11,18
11/19/1987,5,0,3,4,12
11/20/1987,8,0,7,0,15
11/21/1987,5,0,4,7,16
11/22/1987,3,0,6,3,12
11/23/1987,3,0,3,3,9
11/24/1987,7,0,7,10,24
11/25/1987,7,0,8,8,23
11/26/1987,4,0,8,11,23
11/27/1987,5,0,8,13,26
11/28/1987,5,0,3,6,14
11/29/1987,7,0,8,5,20
11/30/1987,5,0,8,6,19
12/1/1987,5,0,8,11,24
12/2/1987,4,0,7,0,11
12/3/1987,4,0,8,9,21
12/4/1987,2,0,4,1,7
12/5/1987,3,0,8,12,23
12/6/1987,6,0,4,7,17
12/7/1987,4,0,6,3,13
12/8/1987,2,0,5,0,7
12/9/1987,2,0,5,11,18
12/10/1987,4,0,8,12,24
12/11/1987,7,0,4,3,14
12/12/1987,4,0,3,8,15
12/13/1987,8,0,2,5,15
12/14/1987,5,0,4,1,10
12/15/1987,7,0,8,8,23
12/16/1987,2,0,8,3,13
12/17/1987,8,0,4,7,19
12/18/1987,4,0,6,2,12
12/19/1987,6,0,3,7,16
12/20/1987,5,0,5,6,16
12/21/1987,2,0,8,7,17
12/22/1987,3,0,5,7,15
12/23/1987,5,0,6,1,12
12/24/1987,5,0,5,2,12
12/25/1987,5,0,7,10,22
12/26/1987,2,0,4,8,14
12/27/1987,5,0,6,12,23
12/28/1987,7,0,5,11,23
12/29/1987,6,0,5,7,18
12/30/1987,6,0,5,1,12
12/31/1987,6,0,3,8,17
1/1/1988,8,0,6,9,23
1/2/1988,8,0,5,6,19
1/3/1988,4,0,2,1,7
1/4/1988,2,0,5,7,14
1/5/1988,4,0,8,2,14
1/6/1988,6,0,2,0,8
1/7/1988,2,0,6,3,11
1/8/1988,5,0,5,11,21
1/9/1988,8,0,7,10,25
1/10/1988,4,0,8,6,18
1/11/1988,8,0,2,10,20
1/12/1988,7,0,2,7,16
1/13/1988,7,0,8,5,20
1/14/1988,3,0,8,3,14
1/15/1988,2,0,6,7,15
1/16/1988,7,0,2,0,9
1/17/1988,7,0,4,4,15
1/18/1988,8,0,4,13,25
1/19/1988,3,0,2,8,13
1/20/1988,2,0,6,8,16
1/21/1988,2,0,7,9,18
1/22/1988,8,0,5,9,22
1/23/1988,8,0,2,0,10
1/24/1988,5,0,2,5,12
1/25/1988,7,0,2,7,16
1/26/1988,8,0,3,8,19
1/27/1988,8,0,2,11,21
1/28/1988,3,0,7,5,15
1/29/1988,2,0,7,3,12
1/30/1988,2,0,2,6,10
1/31/1988,7,0,3,13,23
2/1/1988,8,0,8,4,20
2/2/1988,7,0,7,12,26
2/3/1988,8,0,8,7,23
2/4/1988,5,0,8,9,22
2/5/1988,7,0,8,13,28
2/6/1988,5,0,6,13,24
2/7/1988,4,0,6,12,22
2/8/1988,2,0,7,2,11
2/9/1988,7,0,2,12,21
2/10/1988,2,0,8,5,15
2/11/1988,3,0,7,4,14
2/12/1988,5,0,5,4,14
2/13/1988,4,0,5,12,21
2/14/1988,6,0,4,13,23
2/15/1988,3,0,8,6,17
2/16/1988,7,0,2,4,13
2/17/1988,5,0,2,10,17
2/18/1988,2,0,2,13,17
2/19/1988,2,0,2,6,10
2/20/1988,4,0,2,4,10
2/21/1988,7,0,7,10,24
2/22/1988,8,0,2,12,22
2/23/1988,8,0,5,2,15
2/24/1988,8,0,3,7,18
2/25/1988,8,0,8,3,19
2/26/1988,5,0,4,10,19
2/27/1988,3,0,2,12,17
2/28/1988,2,0,2,3,7
2/29/1988,7,0,8,10,25
3/1/1988,7,0,5,13,25
3/2/1988,5,0,7,13,25
3/3/1988,4,0,8,6,18
3/4/1988,4,0,8,5,17
3/5/1988,4,0,7,3,14
3/6/1988,3,0,8,12,23
3/7/1988,3,0,5,9,17
3/8/1988,8,0,2,9,19
3/9/1988,5,0,3,1,9
3/10/1988,6,0,4,12,22
3/11/1988,8,0,2,1,11
3/12/1988,5,0,3,0,8
3/13/1988,7,0,5,10,22
3/14/1988,2,0,7,13,22
3/15/1988,5,0,8,1,14
3/16/1988,8,0,8,5,21
3/17/1988,5,0,2,10,17
3/18/1988,7,0,7,0,14
3/19/1988,8,0,3,9,20
3/20/1988,5,0,5,9,19
3/21/1988,7,0,5,11,23
3/22/1988,6,0,2,3,11
3/23/1988,4,0,3,12,19
3/24/1988,8,0,5,7,20
3/25/1988,7,0,8,0,15
3/26/1988,6,0,2,13,21
3/27/1988,6,0,4,2,12
3/28/1988,4,0,2,8,14
3/29/1988,2,0,4,5,11
3/30/1988,7,0,4,3,14
3/31/1988,3,0,6,11,20
4/1/1988,7,0,6,13,26
4/2/1988,8,0,2,9,19
4/3/1988,6,0,4,1,11
4/4/1988,6,0,5,0,11
4/5/1988,5,0,2,7,14
4/6/1988,3,0,7,4,14
4/7/1988,3,0,7,6,16
4/8/1988,8,0,3,6,17
4/9/1988,3,0,5,5,13
4/10/1988,5,0,5,3,13
4/11/1988,5,0,8,7,20
4/12/1988,4,0,7,4,15
4/13/1988,7,0,3,5,15
4/14/1988,2,0,2,4,8
4/15/1988,6,0,5,5,16
4/16/1988,7,0,6,8,21
4/17/1988,5,0,4,5,14
4/18/1988,8,0,2,10,20
4/19/1988,5,0,4,8,17
4/20/1988,4,0,6,5,15
4/21/1988,4,0,3,8,15
4/22/1988,4,0,3,0,7
4/23/1988,3,0,7,3,13
4/24/1988,4,0,6,2,12
4/25/1988,5,0,5,10,20
4/26/1988,8,0,2,2,12
4/27/1988,8,0,5,0,13
4/28/1988,8,0,8,1,17
4/29/1988,4,0,3,1,8
4/30/1988,5,0,2,3,10
5/1/1988,6,0,3,1,10
5/2/1988,4,0,6,6,16
5/3/1988,4,0,2,3,9
5/4/1988,8,0,8,7,23
5/5/1988,5,0,7,9,21
5/6/1988,5,0,4,1,10
5/7/1988,7,0,2,9,18
5/8/1988,7,0,3,4,14
5/9/1988,7,0,4,13,24
5/10/1988,2,0,6,6,14
5/11/1988,4,0,6,9,19
5/12/1988,2,0,7,10,19
5/13/1988,8,0,2,8,18
5/14/1988,2,0,5,3,10
5/15/1988,5,0,5,6,16
5/16/1988,3,0,3,7,13
5/17/1988,7,0,2,11,20
5/18/1988,2,0,5,6,13
5/19/1988,3,0,6,13,22
5/20/1988,7,0,6,4,17
5/21/1988,5,0,2,1,8
5/22/1988,6,0,5,8,19
5/23/1988,4,0,7,4,15
5/24/1988,6,0,3,10,19
5/25/1988,5,0,7,9,21
5/26/1988,6,0,6,5,17
5/27/1988,7,0,7,8,22
5/28/1988,3,0,5,0,8
5/29/1988,5,0,4,7,16
5/30/1988,4,0,2,9,15
5/31/1988,2,0,4,5,11
6/1/1988,2,0,8,9,19
6/2/1988,7,0,7,12,26
6/3/1988,4,0,4,1,9
6/4/1988,8,0,8,4,20
6/5/1988,4,0,2,10,16
6/6/1988,3,0,6,9,18
6/7/1988,5,0,5,13,23
6/8/1988,3,0,4,10,17
6/9/1988,7,0,3,7,17
6/10/1988,4,0,3,6,13
6/11/1988,7,0,3,0,10
6/12/1988,8,0,3,10,21
6/13/1988,7,0,7,6,20
6/14/1988,4,0,5,7,16
6/15/1988,6,0,2,10,18
6/16/1988,6,0,3,7,16
6/17/1988,4,0,7,12,23
6/18/1988,5,0,3,2,10
6/19/1988,3,0,7,8,18
6/20/1988,3,0,8,3,14
6/21/1988,4,0,7,0,11
6/22/1988,7,0,8,9,24
6/23/1988,3,0,8,12,23
6/24/1988,3,0,2,10,15
6/25/1988,8,0,3,10,21
6/26/1988,8,0,6,10,24
6/27/1988,4,0,4,3,11
6/28/1988,7,0,3,7,17
6/29/1988,4,0,6,3,13
6/30/1988,5,0,5,11,21
7/1/1988,6,0,5,11,22
7/2/1988,8,0,4,13,25
7/3/1988,5,0,7,12,24
7/4/1988,6,0,7,11,24
7/5/1988,7,0,5,10,22
7/6/1988,3,0,7,1,11
7/7/1988,2,0,8,8,18
7/8/1988,4,0,3,6,13
7/9/1988,3,0,6,1,10
7/10/1988,2,0,3,3,8
7/11/1988,6,0,2,2,10
7/12/1988,7,0,5,9,21
7/13/1988,8,0,8,7,23
7/14/1988,8,0,2,7,17
7/15/1988,4,0,3,4,11
7/16/1988,3,0,8,1,12
7/17/1988,6,0,4,0,10
7/18/1988,6,0,4,10,20
7/19/1988,2,0,5,13,20
7/20/1988,3,0,2,10,15
7/21/1988,4,0,7,5,16
7/22/1988,2,0,8,12,22
7/23/1988,7,0,6,9,22
7/24/1988,2,0,2,10,14
7/25/1988,7,0,4,4,15
7/26/1988,8,0,7,9,24
7/27/1988,4,0,3,4,11
7/28/1988,7,0,4,9,20
7/29/1988,3,0,7,7,17
7/30/1988,2,0,8,5,15
7/31/1988,8,0,4,11,23
8/1/1988,6,0,4,6,16
8/2/1988,8,0,3,3,14
8/3/1988,4,0,4,5,13
8/4/1988,3,0,5,12,20
8/5/1988,8,0,7,3,18
8/6/1988,2,0,8,11,21
8/7/1988,4,0,3,7,14
8/8/1988,5,0,5,1,11
8/9/1988,5,0,3,11,19
8/10/1988,2,0,4,0,6
8/11/1988,2,0,4,5,11
8/12/1988,4,0,8,6,18
8/13/1988,2,0,3,7,12
8/14/1988,6,0,4,12,22
8/15/1988,8,0,6,3,17
8/16/1988,7,0,2,5,14
8/17/1988,3,0,3,4,10
8/18/1988,7,0,2,3,12
8/19/1988,7,0,6,11,24
8/20/1988,2,0,3,10,15
8/21/1988,8,0,3,5,16
8/22/1988,2,0,8,12,22
8/23/1988,2,0,3,6,11
8/24/1988,3,0,2,8,13
8/25/1988,5,0,4,9,18
8/26/1988,3,0,3,5,11
8/27/1988,8,0,3,3,14
8/28/1988,7,0,5,12,24
8/29/1988,3,0,5,2,10
8/30/1988,3,0,6,4,13
8/31/1988,8,0,2,12,22
9/1/1988,5,0,4,8,17
9/2/1988,7,0,8,13,28
9/3/1988,4,0,3,2,9
9/4/1988,7,0,4,7,18
9/5/1988,5,0,4,9,18
9/6/1988,3,0,4,13,20
9/7/1988,2,0,4,6,12
9/8/1988,6,0,7,10,23
9/9/1988,5,0,7,9,21
9/10/1988,3,0,8,2,13
9/11/1988,6,0,4,5,15
9/12/1988,3,0,3,8,14
9/13/1988,5,0,2,6,13
9/14/1988,2,0,3,7,12
9/15/1988,6,0,4,6,16
9/16/1988,8,0,5,4,17
9/17/1988,7,0,5,6,18
9/18/1988,8,0,2,6,16
9/19/1988,2,0,5,2,9
9/20/1988,7,0,4,13,24
9/21/1988,3,0,2,5,10
9/22/1988,3,0,6,7,16
9/23/1988,7,0,8,10,25
9/24/1988,3,0,2,3,8
9/25/1988,3,0,2,5,10
9/26/1988,4,0,3,4,11
9/27/1988,6,0,5,0,11
9/28/1988,2,0,4,10,16
9/29/1988,2,0,8,8,18
9/30/1988,6,0,3,1,10
10/1/1988,8,0,2,6,16
10/2/1988,7,0,5,12,24
10/3/1988,2,0,7,13,22
10/4/1988,6,0,2,11,19
10/5/1988,6,0,3,8,17
10/6/1988,3,0,6,10,19
10/7/1988,3,0,5,10,18
10/8/1988,4,0,5,7,16
10/9/1988,4,0,3,11,18
10/10/1988,5,0,5,2,12
10/11/1988,5,0,7,4,16
10/12/1988,8,0,4,5,17
10/13/1988,2,0,4,5,11
10/14/1988,6,0,2,4,12
10/15/1988,7,0,4,6,17
10/16/1988,8,0,8,7,23
10/17/1988,4,0,4,13,21
10/18/1988,8,0,4,12,24
10/19/1988,3,0,6,4,13
10/20/1988,2,0,5,9,16
10/21/1988,3,0,5,13,21
10/22/1988,8,0,2,4,14
10/23/1988,3,0,4,1,8
10/24/1988,4,0,7,2,13
10/25/1988,3,0,6,11,20
10/26/1988,7,0,7,7,21
10/27/1988,3,0,5,13,21
10/28/1988,3,0,8,5,16
10/29/1988,2,0,6,0,8
10/30/1988,7,0,8,2,17
10/31/1988,7,0,3,12,22
11/1/1988,8,0,6,2,16
11/2/1988,2,0,2,5,9
11/3/1988,2,0,3,0,5
11/4/1988,3,0,4,0,7
11/5/1988,8,0,5,11,24
11/6/1988,8,0,5,1,14
11/7/1988,2,0,2,3,7
11/8/1988,4,0,7,12,23
11/9/1988,6,0,3,11,20
11/10/1988,2,0,2,3,7
11/11/1988,2,0,6,5,13
11/12/1988,8,0,3,10,21
11/13/1988,2,0,8,8,18
11/14/1988,7,0,3,4,14
11/15/1988,6,0,3,9,18
11/16/1988,6,0,7,2,15
11/17/1988,2,0,8,10,20
11/18/1988,2,0,2,1,5
11/19/1988,4,0,6,4,14
11/20/1988,2,0,6,10,18
11/21/1988,8,0,7,0,15
11/22/1988,4,0,8,7,19
11/23/1988,5,0,3,5,13
11/24/1988,3,0,8,0,11
11/25/1988,3,0,7,8,18
11/26/1988,3,0,5,13,21
11/27/1988,7,0,6,10,23
11/28/1988,2,0,4,6,12
11/29/1988,6,0,2,8,16
11/30/1988,2,0,2,8,12
12/1/1988,8,0,2,3,13
12/2/1988,2,0,7,9,18
12/3/1988,3,0,6,7,16
12/4/1988,7,0,2,0,9
12/5/1988,4,0,8,2,14
12/6/1988,5,0,8,5,18
12/7/1988,7,0,7,4,18
12/8/1988,5,0,5,1,11
12/9/1988,4,0,2,11,17
12/10/1988,6,0,4,13,23
12/11/1988,3,0,5,7,15
12/12/1988,8,0,2,2,12
12/13/1988,2,0,7,11,20
12/14/1988,6,0,5,8,19
12/15/1988,2,0,3,3,8
12/16/1988,8,0,4,2,14
12/17/1988,7,0,8,11,26
12/18/1988,3,0,2,8,13
12/19/1988,8,0,7,9,24
12/20/1988,7,0,8,6,21
12/21/1988,8,0,6,0,14
12/22/1988,7,0,5,2,14
12/23/1988,3,0,4,7,14
12/24/1988,5,0,6,12,23
12/25/1988,2,0,4,0,6
12/26/1988,4,0,4,7,15
12/27/1988,4,0,5,13,22
12/28/1988,2,0,3,6,11
12/29/1988,6,0,2,9,17
12/30/1988,3,0,5,8,16
12/31/1988,5,0,7,12,24
1/1/1989,4,0,7,12,23
1/2/1989,7,0,2,8,17
1/3/1989,3,0,6,13,22
1/4/1989,5,0,7,0,12
1/5/1989,4,0,3,5,12
1/6/1989,7,0,4,9,20
1/7/1989,7,0,3,13,23
1/8/1989,2,0,8,9,19
1/9/1989,5,0,4,5,14
1/10/1989,8,0,2,9,19
1/11/1989,8,0,2,4,14
1/12/1989,4,0,6,11,21
1/13/1989,4,0,8,6,18
1/14/1989,6,0,3,13,22
1/15/1989,2,0,6,3,11
1/16/1989,4,0,3,4,11
1/17/1989,2,0,3,7,12
1/18/1989,5,0,6,6,17
1/19/1989,3,0,8,13,24
1/20/1989,6,0,2,0,8
1/21/1989,4,0,8,1,13
1/22/1989,8,0,5,12,25
1/23/1989,5,0,7,6,18
1/24/1989,6,0,3,3,12
1/25/1989,7,0,3,12,22
1/26/1989,2,0,5,1,8
1/27/1989,8,0,5,13,26
1/28/1989,5,0,5,12,22
1/29/1989,3,0,6,4,13
1/30/1989,4,0,3,2,9
1/31/1989,3,0,4,7,14
2/1/1989,4,0,2,7,13
2/2/1989,2,0,4,2,8
2/3/1989,3,0,7,3,13
2/4/1989,8,0,7,1,16
2/5/1989,2,0,2,13,17
2/6/1989,7,0,8,6,21
2/7/1989,5,0,6,4,15
2/8/1989,2,0,8,4,14
2/9/1989,5,0,2,5,12
2/10/1989,2,0,5,4,11
2/11/1989,5,0,8,1,14
2/12/1989,8,0,5,12,25
2/13/1989,6,0,7,10,23
2/14/1989,3,0,2,8,13
2/15/1989,7,0,5,5,17
2/16/1989,8,0,5,10,23
2/17/1989,2,0,6,7,15
2/18/1989,4,0,8,8,20
2/19/1989,8,0,5,12,25
2/20/1989,8,0,3,9,20
2/21/1989,5,0,6,2,13
2/22/1989,6,0,4,1,11
2/23/1989,4,0,2,10,16
2/24/1989,3,0,6,11,20
2/25/1989,6,0,4,4,14
2/26/1989,5,0,7,10,22
2/27/1989,5,0,6,4,15
2/28/1989,7,0,5,2,14
3/1/1989,5,0,5,6,16
3/2/1989,6,0,7,9,22
3/3/1989,8,0,6,9,23
3/4/1989,6,0,3,7,16
3/5/1989,2,0,8,11,21
3/6/1989,4,0,6,8,18
3/7/1989,4,0,5,9,18
3/8/1989,2,0,5,12,19
3/9/1989,3,0,3,5,11
3/10/1989,7,0,8,10,25
3/11/1989,7,0,4,7,18
3/12/1989,8,0,4,0,12
3/13/1989,7,0,3,3,13
3/14/1989,6,0,2,8,16
3/15/1989,6,0,6,13,25
3/16/1989,3,0,8,12,23
3/17/1989,5,0,6,4,15
3/18/1989,6,0,5,12,23
3/19/1989,3,0,6,11,20
3/20/1989,5,0,7,3,15
3/21/1989,7,0,2,13,22
3/22/1989,6,0,2,0,8
3/23/1989,4,0,8,6,18
3/24/1989,6,0,3,8,17
3/25/1989,4,0,6,13,23
3/26/1989,8,0,3,5,16
3/27/1989,4,0,6,4,14
3/28/1989,7,0,3,3,13
3/29/1989,7,0,8,13,28
3/30/1989,6,0,8,10,24
3/31/1989,3,0,2,1,6
4/1/1989,3,0,2,12,17
4/2/1989,4,0,2,5,11
4/3/1989,2,0,4,13,19
4/4/1989,5,0,5,7,17
4/5/1989,3,0,5,4,12
4/6/1989,6,0,3,11,20
4/7/1989,7,0,5,1,13
4/8/1989,5,0,6,3,14
4/9/1989,2,0,4,1,7
4/10/1989,2,0,4,7,13
4/11/1989,3,0,5,1,9
4/12/1989,8,0,4,13,25
4/13/1989,5,0,4,4,13
4/14/1989,5,0,4,4,13
4/15/1989,2,0,6,12,20
4/16/1989,2,0,4,10,16
4/17/1989,7,0,6,7,20
4/18/1989,2,0,6,12,20
4/19/1989,3,0,3,3,9
4/20/1989,4,0,5,11,20
4/21/1989,6,0,6,2,14
4/22/1989,7,0,8,9,24
4/23/1989,2,0,4,5,11
4/24/1989,8,0,4,7,19
4/25/1989,2,0,5,0,7
4/26/1989,2,0,4,10,16
4/27/1989,6,0,4,7,17
4/28/1989,5,0,4,6,15
4/29/1989,7,0,8,3,18
4/30/1989,7,0,2,3,12
5/1/1989,3,0,7,10,20
5/2/1989,6,0,4,5,15
5/3/1989,7,0,4,7,18
5/4/1989,7,0,3,0,10
5/5/1989,7,0,4,8,19
5/6/1989,6,0,7,4,17
5/7/1989,6,0,3,12,21
5/8/1989,5,0,5,12,22
5/9/1989,7,0,2,7,16
5/10/1989,4,0,5,0,9
5/11/1989,5,0,3,0,8
5/12/1989,7,0,6,4,17
5/13/1989,4,0,5,1,10
5/14/1989,4,0,6,4,14
5/15/1989,5,0,4,3,12
5/16/1989,5,0,7,1,13
5/17/1989,7,0,5,2,14
5/18/1989,8,0,6,6,20
5/19/1989,2,0,8,5,15
5/20/1989,3,0,3,7,13
5/21/1989,6,0,8,4,18
5/22/1989,6,0,5,13,24
5/23/1989,2,0,4,6,12
5/24/1989,5,0,5,0,10
5/25/1989,6,0,8,2,16
5/26/1989,3,0,7,13,23
5/27/1989,5,0,2,1,8
5/28/1989,4,0,5,8,17
5/29/1989,3,0,7,9,19
5/30/1989,8,0,6,10,24
5/31/1989,8,0,6,9,23
6/1/1989,3,0,8,12,23
6/2/1989,7,0,3,12,22
6/3/1989,2,0,6,13,21
6/4/1989,4,0,5,1,10
6/5/1989,4,0,4,5,13
6/6/1989,3,0,6,11,20
6/7/1989,3,0,5,5,13
6/8/1989,4,0,2,4,10
6/9/1989,3,0,4,1,8
6/10/1989,7,0,5,4,16
6/11/1989,8,0,8,5,21
6/12/1989,5,0,4,11,20
6/13/1989,3,0,6,2,11
6/14/1989,3,0,3,2,8
6/15/1989,4,0,6,0,10
6/16/1989,5,0,5,7,17
6/17/1989,4,0,8,10,22
6/18/1989,8,0,7,3,18
6/19/1989,6,0,2,7,15
6/20/1989,4,0,6,9,19
6/21/1989,6,0,5,9,20
6/22/1989,6,0,4,9,19
6/23/1989,4,0,2,1,7
6/24/1989,7,0,5,4,16
6/25/1989,6,0,5,1,12
6/26/1989,8,0,3,10,21
6/27/1989,2,0,4,5,11
6/28/1989,2,0,4,10,16
6/29/1989,8,0,4,8,20
6/30/1989,2,0,2,3,7
7/1/1989,6,0,2,3,11
7/2/1989,5,0,6,1,12
7/3/1989,3,0,3,8,14
7/4/1989,4,0,8,4,16
7/5/1989,7,0,7,1,15
7/6/1989,2,0,3,6,11
7/7/1989,4,0,2,1,7
7/8/1989,7,0,8,12,27
7/9/1989,6,0,8,8,22
7/10/1989,7,0,5,12,24
7/11/1989,3,0,5,5,13
7/12/1989,4,0,8,6,18
7/13/1989,4,0,7,13,24
7/14/1989,6,0,4,2,12
7/15/1989,3,0,3,11,17
7/16/1989,3,0,4,4,11
7/17/1989,4,0,3,4,11
7/18/1989,5,0,6,5,16
7/19/1989,3,0,7,12,22
7/20/1989,2,0,2,2,6
7/21/1989,7,0,8,8,23
7/22/1989,5,0,3,12,20
7/23/1989,8,0,2,7,17
7/24/1989,4,0,7,5,16
7/25/1989,4,0,3,8,15
7/26/1989,2,0,8,9,19
7/27/1989,6,0,2,4,12
7/28/1989,8,0,2,4,14
7/29/1989,2,0,8,2,12
7/30/1989,3,0,5,8,16
7/31/1989,5,0,8,7,20
8/1/1989,6,0,5,2,13
8/2/1989,2,0,3,6,11
8/3/1989,8,0,7,0,15
8/4/1989,3,0,2,0,5
8/5/1989,4,0,5,7,16
8/6/1989,4,0,6,13,23
8/7/1989,5,0,2,9,16
8/8/1989,6,0,8,9,23
8/9/1989,4,0,6,2,12
8/10/1989,4,0,4,11,19
8/11/1989,3,0,3,10,16
8/12/1989,4,0,8,1,13
8/13/1989,6,0,6,9,21
8/14/1989,8,0,7,0,15
8/15/1989,6,0,5,6,17
8/16/1989,7,0,2,10,19
8/17/1989,3,0,8,11,22
8/18/1989,8,0,3,2,13
8/19/1989,7,0,4,13,24
8/20/1989,3,0,6,5,14
8/21/1989,5,0,7,3,15
8/22/1989,4,0,6,7,17
8/23/1989,6,0,6,5,17
8/24/1989,4,0,4,11,19
8/25/1989,8,0,7,4,19
8/26/1989,2,0,4,2,8
8/27/1989,5,0,8,8,21
8/28/1989,5,0,8,5,18
8/29/1989,8,0,4,0,12
8/30/1989,6,0,4,9,19
8/31/1989,4,0,4,8,16
9/1/1989,2,0,7,8,17
9/2/1989,6,0,7,7,20
9/3/1989,6,0,6,4,16
9/4/1989,4,0,4,13,21
9/5/1989,4,0,7,0,11
9/6/1989,2,0,2,0,4
9/7/1989,7,0,2,10,19
9/8/1989,7,0,7,3,17
9/9/1989,2,0,6,7,15
9/10/1989,8,0,8,13,29
9/11/1989,5,0,7,11,23
9/12/1989,2,0,8,7,17
9/13/1989,8,0,3,5,16
9/14/1989,7,0,7,5,19
9/15/1989,3,0,8,3,14
9/16/1989,4,0,3,11,18
9/17/1989,7,0,5,3,15
9/18/1989,2,0,7,4,13
9/19/1989,2,0,2,11,15
9/20/1989,5,0,8,12,25
9/21/1989,7,0,5,3,15
9/22/1989,8,0,6,0,14
9/23/1989,2,0,6,4,12
9/24/1989,2,0,7,9,18
9/25/1989,7,0,2,9,18
9/26/1989,7,0,7,2,16
9/27/1989,2,0,5,4,11
9/28/1989,8,0,8,1,17
9/29/1989,8,0,6,1,15
9/30/1989,5,0,3,11,19
10/1/1989,3,0,7,2,12
10/2/1989,2,0,7,11,20
10/3/1989,4,0,5,7,16
10/4/1989,6,0,8,12,26
10/5/1989,4,0,5,3,12
10/6/1989,3,0,3,0,6
10/7/1989,3,0,8,13,24
10/8/1989,7,0,8,3,18
10/9/1989,2,0,4,12,18
10/10/1989,7,0,5,0,12
10/11/1989,8,0,4,8,20
10/12/1989,5,0,2,12,19
10/13/1989,4,0,8,12,24
10/14/1989,2,0,4,12,18
10/15/1989,7,0,5,8,20
10/16/1989,3,0,5,4,12
10/17/1989,5,0,5,13,23
10/18/1989,8,0,8,4,20
10/19/1989,4,0,8,4,16
10/20/1989,7,0,7,13,27
10/21/1989,2,0,3,6,11
10/22/1989,2,0,7,4,13
10/23/1989,7,0,2,0,9
10/24/1989,3,0,8,8,19
10/25/1989,7,0,4,0,11
10/26/1989,6,0,2,7,15
10/27/1989,4,0,4,7,15
10/28/1989,5,0,4,11,20
10/29/1989,8,0,5,11,24
10/30/1989,6,0,8,7,21
10/31/1989,7,0,3,6,16
11/1/1989,3,0,2,9,14
11/2/1989,7,0,6,8,21
11/3/1989,6,0,6,2,14
11/4/1989,6,0,8,13,27
11/5/1989,2,0,2,3,7
11/6/1989,5,0,3,13,21
11/7/1989,5,0,8,3,16
11/8/1989,2,0,2,13,17
11/9/1989,8,0,3,2,13
11/10/1989,8,0,2,3,13
11/11/1989,7,0,3,10,20
11/12/1989,4,0,5,3,12
11/13/1989,6,0,6,7,19
11/14/1989,5,0,6,0,11
11/15/1989,4,0,6,12,22
11/16/1989,7,0,5,1,13
11/17/1989,4,0,5,13,22
11/18/1989,8,0,8,4,20
11/19/1989,8,0,2,10,20
11/20/1989,4,0,4,2,10
11/21/1989,7,0,4,5,16
11/22/1989,4,0,2,8,14
11/23/1989,8,0,6,12,26
11/24/1989,5,0,6,10,21
11/25/1989,2,0,4,6,12
11/26/1989,2,0,8,7,17
11/27/1989,6,0,4,7,17
11/28/1989,7,0,5,6,18
11/29/1989,6,0,8,5,19
11/30/1989,3,0,6,0,9
12/1/1989,6,0,8,9,23
12/2/1989,8,0,6,7,21
12/3/1989,8,0,7,1,16
12/4/1989,7,0,2,8,17
12/5/1989,8,0,3,8,19
12/6/1989,6,0,4,7,17
12/7/1989,6,0,8,9,23
12/8/1989,8,0,4,7,19
12/9/1989,8,0,4,13,25
12/10/1989,7,0,3,5,15
12/11/1989,4,0,6,4,14
12/12/1989,3,0,3,0,6
12/13/1989,4,0,2,11,17
12/14/1989,8,0,3,13,24
12/15/1989,3,0,5,9,17
12/16/1989,8,0,3,6,17
12/17/1989,6,0,5,9,20
12/18/1989,4,0,2,9,15
12/19/1989,6,0,5,0,11
12/20/1989,2,0,2,12,16
12/21/1989,6,0,7,11,24
12/22/1989,3,0,8,3,14
12/23/1989,7,0,8,2,17
12/24/1989,8,0,7,6,21
12/25/1989,3,0,8,0,11
12/26/1989,2,0,6,0,8
12/27/1989,8,0,2,7,17
12/28/1989,3,0,2,3,8
12/29/1989,5,0,4,1,10
12/30/1989,4,0,8,3,15
12/31/1989,5,0,5,6,16
1/1/1990,8,0,2,10,20
1/2/1990,7,0,3,8,18
1/3/1990,3,0,3,10,16
1/4/1990,4,0,7,0,11
1/5/1990,7,0,3,5,15
1/6/1990,5,0,2,4,11
1/7/1990,8,0,5,5,18
1/8/1990,7,0,5,10,22
1/9/1990,8,0,6,11,25
1/10/1990,7,0,6,2,15
1/11/1990,8,0,3,1,12
1/12/1990,4,0,4,2,10
1/13/1990,8,0,7,3,18
1/14/1990,6,0,5,4,15
1/15/1990,8,0,7,1,16
1/16/1990,6,0,5,4,15
1/17/1990,6,0,7,6,19
1/18/1990,3,0,5,3,11
1/19/1990,3,0,3,4,10
1/20/1990,2,0,6,9,17
1/21/1990,8,0,8,13,29
1/22/1990,8,0,3,6,17
1/23/1990,2,0,5,8,15
1/24/1990,8,0,7,6,21
1/25/1990,3,0,4,9,16
1/26/1990,2,0,2,12,16
1/27/1990,2,0,3,8,13
1/28/1990,3,0,3,13,19
1/29/1990,3,0,2,3,8
1/30/1990,2,0,3,0,5
1/31/1990,6,0,8,1,15
2/1/1990,2,0,7,4,13
2/2/1990,7,0,6,6,19
2/3/1990,7,0,5,8,20
2/4/1990,7,0,8,9,24
2/5/1990,5,0,4,13,22
2/6/1990,6,0,2,13,21
2/7/1990,4,0,6,5,15
2/8/1990,3,0,7,8,18
2/9/1990,4,0,5,2,11
2/10/1990,7,0,4,13,24
2/11/1990,8,0,8,9,25
2/12/1990,4,0,7,8,19
2/13/1990,6,0,3,7,16
2/14/1990,4,0,5,11,20
2/15/1990,4,0,5,2,11
2/16/1990,8,0,2,3,13
2/17/1990,5,0,6,9,20
2/18/1990,6,0,4,5,15
2/19/1990,2,0,5,13,20
2/20/1990,2,0,8,11,21
2/21/1990,7,0,3,3,13
2/22/1990,6,0,3,2,11
2/23/1990,7,0,6,7,20
2/24/1990,8,0,5,7,20
2/25/1990,2,0,2,11,15
2/26/1990,6,0,3,4,13
2/27/1990,3,0,7,5,15
2/28/1990,3,0,6,7,16
3/1/1990,8,0,6,9,23
3/2/1990,5,0,3,12,20
3/3/1990,7,0,3,6,16
3/4/1990,8,0,7,3,18
3/5/1990,5,0,8,2,15
3/6/1990,2,0,8,7,17
3/7/1990,7,0,6,0,13
3/8/1990,5,0,8,8,21
3/9/1990,4,0,7,13,24
3/10/1990,6,0,6,0,12
3/11/1990,8,0,2,7,17
3/12/1990,3,0,6,11,20
3/13/1990,2,0,6,11,19
3/14/1990,3,0,8,2,13
3/15/1990,7,0,7,2,16
3/16/1990,4,0,6,7,17
3/17/1990,3,0,6,8,17
3/18/1990,8,0,3,4,15
3/19/1990,5,0,6,11,22
3/20/1990,2,0,3,12,17
3/21/1990,3,0,3,8,14
3/22/1990,6,0,3,13,22
3/23/1990,5,0,8,6,19
3/24/1990,2,0,3,7,12
3/25/1990,5,0,6,1,12
3/26/1990,7,0,5,7,19
3/27/1990,8,0,4,6,18
3/28/1990,6,0,6,1,13
3/29/1990,6,0,7,3,16
3/30/1990,7,0,6,6,19
3/31/1990,4,0,4,1,9
4/1/1990,3,0,7,2,12
4/2/1990,8,0,5,6,19
4/3/1990,2,0,7,2,11
4/4/1990,2,0,2,6,10
4/5/1990,2,0,2,6,10
4/6/1990,5,0,2,10,17
4/7/1990,3,0,4,6,13
4/8/1990,2,0,5,6,13
4/9/1990,6,0,4,13,23
4/10/1990,5,0,2,8,15
4/11/1990,7,0,2,6,15
4/12/1990,6,0,8,2,16
4/13/1990,4,0,2,10,16
4/14/1990,2,0,6,8,16
4/15/1990,2,0,7,7,16
4/16/1990,4,0,7,11,22
4/17/1990,3,0,7,10,20
4/18/1990,7,0,5,11,23
4/19/1990,6,0,6,11,23
4/20/1990,7,0,3,4,14
4/21/1990,3,0,3,10,16
4/22/1990,6,0,7,8,21
4/23/1990,5,0,7,4,16
4/24/1990,7,0,2,13,22
4/25/1990,4,0,5,2,11
4/26/1990,5,0,5,4,14
4/27/1990,3,0,3,2,8
4/28/1990,4,0,7,10,21
4/29/1990,6,0,8,0,14
4/30/1990,3,0,8,7,18
5/1/1990,8,0,6,7,21
5/2/1990,5,0,2,13,20
5/3/1990,8,0,5,10,23
5/4/1990,3,0,2,8,13
5/5/1990,6,0,7,0,13
5/6/1990,6,0,3,4,13
5/7/1990,3,0,6,0,9
5/8/1990,4,0,6,12,22
5/9/1990,6,0,4,5,15
5/10/1990,5,0,7,1,13
5/11/1990,3,0,4,2,9
5/12/1990,3,0,8,11,22
5/13/1990,7,0,8,12,27
5/14/1990,6,0,3,10,19
5/15/1990,6,0,5,11,22
5/16/1990,2,0,5,5,12
5/17/1990,4,0,3,1,8
5/18/1990,8,0,4,7,19
5/19/1990,4,0,3,2,9
5/20/1990,7,0,4,13,24
5/21/1990,3,0,4,5,12
5/22/1990,2,0,6,12,20
5/23/1990,8,0,7,0,15
5/24/1990,8,0,2,0,10
5/25/1990,7,0,2,9,18
5/26/1990,4,0,8,8,20
5/27/1990,8,0,2,11,21
5/28/1990,7,0,6,1,14
5/29/1990,2,0,6,7,15
5/30/1990,3,0,6,0,9
5/31/1990,8,0,5,3,16
6/1/1990,5,0,3,3,11
6/2/1990,3,0,5,4,12
6/3/1990,8,0,3,1,12
6/4/1990,8,0,4,12,24
6/5/1990,7,0,5,0,12
6/6/1990,2,0,2,4,8
6/7/1990,7,0,4,4,15
6/8/1990,5,0,4,10,19
6/9/1990,3,0,6,10,19
6/10/1990,7,0,3,1,11
6/11/1990,2,0,7,4,13
6/12/1990,7,0,3,4,14
6/13/1990,4,0,6,9,19
6/14/1990,7,0,3,6,16
6/15/1990,2,0,2,9,13
6/16/1990,5,0,8,11,24
6/17/1990,7,0,4,10,21
6/18/1990,7,0,7,13,27
6/19/1990,8,0,5,4,17
6/20/1990,4,0,6,7,17
6/21/1990,4,0,7,3,14
6/22/1990,3,0,3,4,10
6/23/1990,6,0,5,5,16
6/24/1990,7,0,5,7,19
6/25/1990,2,0,2,6,10
6/26/1990,4,0,3,11,18
6/27/1990,8,0,6,3,17
6/28/1990,7,0,4,3,14
6/29/1990,2,0,2,4,8
6/30/1990,5,0,2,7,14
7/1/1990,4,0,2,6,12
7/2/1990,8,0,3,3,14
7/3/1990,7,0,5,1,13
7/4/1990,4,0,7,4,15
7/5/1990,5,0,8,13,26
7/6/1990,8,0,4,6,18
7/7/1990,5,0,2,4,11
7/8/1990,7,0,2,3,12
7/9/1990,7,0,8,10,25
7/10/1990,2,0,8,9,19
7/11/1990,8,0,8,6,22
7/12/1990,6,0,7,0,13
7/13/1990,8,0,2,7,17
7/14/1990,3,0,5,7,15
7/15/1990,7,0,2,12,21
7/16/1990,7,0,4,7,18
7/17/1990,2,0,7,2,11
7/18/1990,7,0,8,9,24
7/19/1990,8,0,5,12,25
7/20/1990,7,0,4,4,15
7/21/1990,7,0,7,11,25
7/22/1990,3,0,7,9,19
7/23/1990,3,0,6,10,19
7/24/1990,8,0,7,9,24
7/25/1990,8,0,8,1,17
7/26/1990,2,0,5,1,8
7/27/1990,5,0,2,0,7
7/28/1990,6,0,5,11,22
7/29/1990,8,0,2,3,13
7/30/1990,5,0,8,4,17
7/31/1990,2,0,3,13,18
8/1/1990,2,0,5,11,18
8/2/1990,2,0,4,5,11
8/3/1990,8,0,6,1,15
8/4/1990,4,0,3,0,7
8/5/1990,4,0,5,9,18
8/6/1990,3,0,4,0,7
8/7/1990,3,0,4,12,19
8/8/1990,8,0,6,0,14
8/9/1990,5,0,7,13,25
8/10/1990,4,0,4,4,12
8/11/1990,5,0,8,12,25
8/12/1990,6,0,2,11,19
8/13/1990,5,0,5,12,22
8/14/1990,4,0,2,13,19
8/15/1990,6,0,2,6,14
8/16/1990,6,0,8,10,24
8/17/1990,3,0,6,3,12
8/18/1990,8,0,7,10,25
8/19/1990,8,0,2,0,10
8/20/1990,2,0,6,9,17
8/21/1990,7,0,3,13,23
8/22/1990,2,0,4,2,8
8/23/1990,6,0,8,4,18
8/24/1990,2,0,7,1,10
8/25/1990,2,0,3,3,8
8/26/1990,5,0,5,5,15
8/27/1990,2,0,7,4,13
8/28/1990,5,0,3,10,18
8/29/1990,5,0,7,6,18
8/30/1990,7,0,7,3,17
8/31/1990,7,0,4,0,11
9/1/1990,2,0,4,8,14
9/2/1990,7,0,5,1,13
9/3/1990,4,0,7,7,18
9/4/1990,5,0,5,8,18
9/5/1990,3,0,6,10,19
9/6/1990,4,0,5,4,13
9/7/1990,8,0,6,0,14
9/8/1990,4,0,5,8,17
9/9/1990,8,0,3,7,18
9/10/1990,3,0,7,10,20
9/11/1990,8,0,3,0,11
9/12/1990,5,0,6,8,19
9/13/1990,7,0,8,0,15
9/14/1990,8,0,4,10,22
9/15/1990,8,0,8,5,21
9/16/1990,2,0,6,2,10
9/17/1990,5,0,3,11,19
9/18/1990,7,0,4,5,16
9/19/1990,7,0,5,10,22
9/20/1990,5,0,3,1,9
9/21/1990,8,0,7,12,27
9/22/1990,4,0,5,11,20
9/23/1990,5,0,8,11,24
9/24/1990,6,0,8,8,22
9/25/1990,7,0,2,7,16
9/26/1990,8,0,7,5,20
9/27/1990,2,0,2,10,14
9/28/1990,8,0,5,1,14
9/29/1990,2,0,6,9,17
9/30/1990,3,0,2,2,7
10/1/1990,4,0,8,3,15
10/2/1990,2,0,8,5,15
10/3/1990,3,0,2,8,13
10/4/1990,3,0,7,4,14
10/5/1990,2,0,4,11,17
10/6/1990,2,0,6,1,9
10/7/1990,3,0,7,5,15
10/8/1990,4,0,6,5,15
10/9/1990,5,0,8,9,22
10/10/1990,7,0,5,5,17
10/11/1990,6,0,6,0,12
10/12/1990,2,0,2,11,15
10/13/1990,2,0,6,11,19
10/14/1990,2,0,4,7,13
10/15/1990,5,0,6,3,14
10/16/1990,5,0,2,10,17
10/17/1990,2,0,5,11,18
10/18/1990,7,0,4,7,18
10/19/1990,4,0,2,4,10
10/20/1990,6,0,8,7,21
10/21/1990,3,0,7,5,15
10/22/1990,6,0,4,5,15
10/23/1990,8,0,6,10,24
10/24/1990,7,0,8,8,23
10/25/1990,4,0,2,8,14
10/26/1990,2,0,7,3,12
10/27/1990,7,0,2,5,14
10/28/1990,6,0,8,8,22
10/29/1990,2,0,6,8,16
10/30/1990,2,0,3,7,12
10/31/1990,4,0,5,13,22
11/1/1990,6,0,4,13,23
11/2/1990,7,0,6,11,24
11/3/1990,8,0,2,13,23
11/4/1990,2,0,2,9,13
11/5/1990,7,0,2,13,22
11/6/1990,2,0,5,13,20
11/7/1990,3,0,6,0,9
11/8/1990,2,0,3,7,12
11/9/1990,7,0,7,10,24
11/10/1990,8,0,4,10,22
11/11/1990,3,0,2,10,15
11/12/1990,8,0,4,0,12
11/13/1990,7,0,8,10,25
11/14/1990,6,0,3,7,16
11/15/1990,7,0,8,12,27
11/16/1990,5,0,4,9,18
11/17/1990,3,0,3,6,12
11/18/1990,4,0,4,5,13
11/19/1990,4,0,8,10,22
11/20/1990,3,0,7,11,21
11/21/1990,6,0,2,3,11
11/22/1990,7,0,3,13,23
11/23/1990,4,0,6,12,22
11/24/1990,2,0,2,2,6
11/25/1990,3,0,8,11,22
11/26/1990,8,0,6,0,14
11/27/1990,3,0,5,3,11
11/28/1990,8,0,7,5,20
11/29/1990,4,0,5,7,16
11/30/1990,8,0,2,2,12
12/1/1990,5,0,6,9,20
12/2/1990,3,0,7,9,19
12/3/1990,4,0,8,0,12
12/4/1990,4,0,8,13,25
12/5/1990,7,0,2,6,15
12/6/1990,5,0,4,5,14
12/7/1990,8,0,8,1,17
12/8/1990,6,0,7,11,24
12/9/1990,4,0,5,3,12
12/10/1990,8,0,2,4,14
12/11/1990,8,0,5,3,16
12/12/1990,4,0,4,5,13
12/13/1990,4,0,2,0,6
12/14/1990,7,0,5,10,22
12/15/1990,3,0,6,12,21
12/16/1990,7,0,3,8,18
12/17/1990,6,0,8,4,18
12/18/1990,2,0,7,1,10
12/19/1990,3,0,7,11,21
12/20/1990,2,0,4,11,17
12/21/1990,8,0,3,8,19
12/22/1990,4,0,8,13,25
12/23/1990,8,0,7,7,22
12/24/1990,8,0,2,2,12
12/25/1990,4,0,4,5,13
12/26/1990,6,0,5,4,15
12/27/1990,6,0,8,12,26
12/28/1990,4,0,7,13,24
12/29/1990,2,0,3,1,6
12/30/1990,7,0,6,2,15
12/31/1990,2,0,4,8,14
1/1/1991,2,0,3,0,5
1/2/1991,3,0,5,5,13
1/3/1991,4,0,5,6,15
1/4/1991,4,0,5,8,17
1/5/1991,7,0,7,6,20
1/6/1991,6,0,4,0,10
1/7/1991,3,0,7,5,15
1/8/1991,2,0,4,9,15
1/9/1991,6,0,6,3,15
1/10/1991,3,0,3,6,12
1/11/1991,6,0,3,1,10
1/12/1991,5,0,5,1,11
1/13/1991,8,0,7,12,27
1/14/1991,4,0,5,13,22
1/15/1991,3,0,4,7,14
1/16/1991,7,0,5,10,22
1/17/1991,2,0,5,1,8
1/18/1991,5,0,8,4,17
1/19/1991,4,0,2,1,7
1/20/1991,5,0,7,5,17
1/21/1991,4,0,4,13,21
1/22/1991,8,0,2,10,20
1/23/1991,6,0,3,3,12
1/24/1991,6,0,2,2,10
1/25/1991,8,0,2,10,20
1/26/1991,2,0,6,4,12
1/27/1991,5,0,4,7,16
1/28/1991,3,0,4,10,17
1/29/1991,7,0,8,3,18
1/30/1991,7,0,6,8,21
1/31/1991,2,0,5,9,16
2/1/1991,6,0,4,1,11
2/2/1991,8,0,6,12,26
2/3/1991,7,0,6,1,14
2/4/1991,8,0,6,9,23
2/5/1991,7,0,8,3,18
2/6/1991,5,0,5,13,23
2/7/1991,2,0,3,0,5
2/8/1991,5,0,8,7,20
2/9/1991,3,0,6,0,9
2/10/1991,3,0,8,12,23
2/11/1991,2,0,8,2,12
2/12/1991,3,0,4,11,18
2/13/1991,6,0,3,10,19
2/14/1991,2,0,5,4,11
2/15/1991,2,0,8,12,22
2/16/1991,8,0,6,4,18
2/17/1991,8,0,5,9,22
2/18/1991,5,0,2,1,8
2/19/1991,3,0,5,9,17
2/20/1991,2,0,8,13,23
2/21/1991,8,0,4,3,15
2/22/1991,8,0,2,6,16
2/23/1991,6,0,8,13,27
2/24/1991,4,0,5,2,11
2/25/1991,3,0,8,11,22
2/26/1991,5,0,7,10,22
2/27/1991,3,0,3,9,15
2/28/1991,3,0,7,7,17
3/1/1991,2,0,6,9,17
3/2/1991,7,0,8,11,26
3/3/1991,5,0,7,1,13
3/4/1991,2,0,8,11,21
3/5/1991,8,0,2,2,12
3/6/1991,5,0,5,1,11
3/7/1991,3,0,4,8,15
3/8/1991,3,0,4,8,15
3/9/1991,5,0,4,0,9
3/10/1991,7,0,2,12,21
3/11/1991,3,0,8,1,12
3/12/1991,4,0,2,7,13
3/13/1991,8,0,2,11,21
3/14/1991,6,0,7,5,18
3/15/1991,7,0,7,4,18
3/16/1991,6,0,5,5,16
3/17/1991,5,0,2,9,16
3/18/1991,4,0,2,9,15
3/19/1991,6,0,5,2,13
3/20/1991,6,0,6,10,22
3/21/1991,5,0,4,7,16
3/22/1991,4,0,2,7,13
3/23/1991,6,0,8,9,23
3/24/1991,2,0,6,10,18
3/25/1991,4,0,8,13,25
3/26/1991,7,0,4,3,14
3/27/1991,3,0,8,1,12
3/28/1991,4,0,7,13,24
3/29/1991,6,0,2,10,18
3/30/1991,6,0,8,8,22
3/31/1991,2,0,6,6,14
4/1/1991,8,0,7,5,20
4/2/1991,3,0,8,12,23
4/3/1991,5,0,7,10,22
4/4/1991,7,0,3,12,22
4/5/1991,7,0,2,1,10
4/6/1991,8,0,5,6,19
4/7/1991,3,0,3,7,13
4/8/1991,8,0,3,8,19
4/9/1991,4,0,2,6,12
4/10/1991,4,0,3,7,14
4/11/1991,5,0,4,2,11
4/12/1991,5,0,3,5,13
4/13/1991,7,0,2,7,16
4/14/1991,8,0,2,5,15
4/15/1991,2,0,8,10,20
4/16/1991,5,0,8,12,25
4/17/1991,6,0,7,12,25
4/18/1991,8,0,3,5,16
4/19/1991,8,0,5,12,25
4/20/1991,7,0,2,1,10
4/21/1991,3,0,8,9,20
4/22/1991,7,0,3,5,15
4/23/1991,6,0,7,12,25
4/24/1991,3,0,7,13,23
4/25/1991,3,0,6,7,16
4/26/1991,7,0,5,6,18
4/27/1991,7,0,5,13,25
4/28/1991,4,0,2,8,14
4/29/1991,4,0,2,12,18
4/30/1991,6,0,3,9,18
5/1/1991,6,0,4,2,12
5/2/1991,7,0,7,5,19
5/3/1991,3,0,2,5,10
5/4/1991,4,0,2,4,10
5/5/1991,3,0,4,4,11
5/6/1991,4,0,3,10,17
5/7/1991,8,0,2,6,16
5/8/1991,6,0,7,11,24
5/9/1991,8,0,8,4,20
5/10/1991,6,0,3,5,14
5/11/1991,2,0,3,7,12
5/12/1991,7,0,8,10,25
5/13/1991,6,0,2,6,14
5/14/1991,7,0,2,1,10
5/15/1991,6,0,3,13,22
5/16/1991,7,0,5,1,13
5/17/1991,6,0,6,2,14
5/18/1991,2,0,8,4,14
5/19/1991,4,0,2,7,13
5/20/1991,4,0,3,8,15
5/21/1991,4,0,8,1,13
5/22/1991,4,0,8,11,23
5/23/1991,8,0,8,9,25
5/24/1991,3,0,3,2,8
5/25/1991,7,0,3,3,13
5/26/1991,5,0,2,3,10
5/27/1991,3,0,8,2,13
5/28/1991,4,0,8,2,14
5/29/1991,8,0,8,8,24
5/30/1991,5,0,3,3,11
5/31/1991,8,0,5,8,21
6/1/1991,5,0,8,4,17
6/2/1991,2,0,6,7,15
6/3/1991,2,0,8,10,20
6/4/1991,5,0,4,13,22
6/5/1991,2,0,5,0,7
6/6/1991,2,0,3,1,6
6/7/1991,6,0,8,4,18
6/8/1991,7,0,7,5,19
6/9/1991,4,0,3,9,16
6/10/1991,6,0,7,3,16
6/11/1991,3,0,4,0,7
6/12/1991,8,0,5,11,24
6/13/1991,5,0,2,3,10
6/14/1991,2,0,4,6,12
6/15/1991,6,0,8,11,25
6/16/1991,3,0,6,11,20
6/17/1991,6,0,5,3,14
6/18/1991,6,0,6,9,21
6/19/1991,6,0,8,9,23
6/20/1991,4,0,2,1,7
6/21/1991,7,0,5,8,20
6/22/1991,5,0,5,2,12
6/23/1991,5,0,6,0,11
6/24/1991,6,0,8,3,17
6/25/1991,6,0,7,4,17
6/26/1991,2,0,8,8,18
6/27/1991,5,0,6,12,23
6/28/1991,7,0,2,0,9
6/29/1991,8,0,7,5,20
6/30/1991,4,0,5,8,17
7/1/1991,3,0,8,6,17
7/2/1991,8,0,4,1,13
7/3/1991,8,0,2,0,10
7/4/1991,7,0,2,0,9
7/5/1991,8,0,5,11,24
7/6/1991,4,0,7,13,24
7/7/1991,8,0,8,13,29
7/8/1991,5,0,2,9,16
7/9/1991,5,0,8,11,24
7/10/1991,7,0,8,6,21
7/11/1991,2,0,6,6,14
7/12/1991,3,0,8,2,13
7/13/1991,8,0,3,9,20
7/14/1991,7,0,2,10,19
7/15/1991,4,0,2,7,13
7/16/1991,4,0,3,1,8
7/17/1991,5,0,4,9,18
7/18/1991,6,0,6,7,19
7/19/1991,3,0,6,5,14
7/20/1991,8,0,4,4,16
7/21/1991,6,0,8,1,15
7/22/1991,4,0,7,12,23
7/23/1991,6,0,4,9,19
7/24/1991,7,0,7,13,27
7/25/1991,6,0,4,9,19
7/26/1991,3,0,8,11,22
7/27/1991,4,0,5,8,17
7/28/1991,7,0,6,5,18
7/29/1991,4,0,6,13,23
7/30/1991,4,0,2,13,19
7/31/1991,5,0,7,13,25
8/1/1991,3,0,2,9,14
8/2/1991,6,0,2,0,8
8/3/1991,3,0,4,12,19
8/4/1991,4,0,7,0,11
8/5/1991,4,0,8,13,25
8/6/1991,5,0,6,11,22
8/7/1991,3,0,2,2,7
8/8/1991,5,0,5,12,22
8/9/1991,8,0,8,2,18
8/10/1991,6,0,6,4,16
8/11/1991,2,0,6,0,8
8/12/1991,2,0,6,0,8
8/13/1991,7,0,6,8,21
8/14/1991,5,0,7,12,24
8/15/1991,8,0,3,10,21
8/16/1991,6,0,6,12,24
8/17/1991,4,0,7,2,13
8/18/1991,3,0,6,11,20
8/19/1991,2,0,7,13,22
8/20/1991,7,0,3,2,12
8/21/1991,4,0,6,6,16
8/22/1991,2,0,5,4,11
8/23/1991,4,0,6,5,15
8/24/1991,2,0,6,9,17
8/25/1991,5,0,7,0,12
8/26/1991,5,0,3,7,15
8/27/1991,4,0,7,8,19
8/28/1991,7,0,7,8,22
8/29/1991,2,0,3,10,15
8/30/1991,8,0,7,13,28
8/31/1991,7,0,3,7,17
9/1/1991,5,0,3,12,20
9/2/1991,3,0,7,0,10
9/3/1991,2,0,2,9,13
9/4/1991,3,0,3,1,7
9/5/1991,2,0,4,7,13
9/6/1991,4,0,6,5,15
9/7/1991,2,0,5,5,12
9/8/1991,6,0,8,12,26
9/9/1991,7,0,3,6,16
9/10/1991,2,0,5,12,19
9/11/1991,6,0,5,3,14
9/12/1991,8,0,3,10,21
9/13/1991,8,0,8,6,22
9/14/1991,4,0,5,13,22
9/15/1991,4,0,5,4,13
9/16/1991,6,0,3,7,16
9/17/1991,5,0,7,5,17
9/18/1991,3,0,3,11,17
9/19/1991,4,0,6,1,11
9/20/1991,8,0,8,1,17
9/21/1991,2,0,7,9,18
9/22/1991,7,0,4,7,18
9/23/1991,6,0,4,5,15
9/24/1991,7,0,5,13,25
9/25/1991,5,0,5,10,20
9/26/1991,5,0,8,13,26
9/27/1991,6,0,4,10,20
9/28/1991,4,0,2,13,19
9/29/1991,6,0,3,10,19
9/30/1991,4,0,4,11,19
10/1/1991,6,0,3,11,20
10/2/1991,5,0,7,13,25
10/3/1991,6,0,3,5,14
10/4/1991,4,0,6,11,21
10/5/1991,4,0,5,7,16
10/6/1991,3,0,2,13,18
10/7/1991,7,0,4,5,16
10/8/1991,4,0,4,1,9
10/9/1991,4,0,6,12,22
10/10/1991,4,0,3,4,11
10/11/1991,3,0,4,9,16
10/12/1991,7,0,3,12,22
10/13/1991,3,0,8,7,18
10/14/1991,5,0,4,13,22
10/15/1991,6,0,5,12,23
10/16/1991,7,0,7,1,15
10/17/1991,2,0,6,2,10
10/18/1991,7,0,7,0,14
10/19/1991,3,0,4,0,7
10/20/1991,2,0,3,10,15
10/21/1991,7,0,2,2,11
10/22/1991,2,0,8,8,18
10/23/1991,3,0,5,3,11
10/24/1991,6,0,7,6,19
10/25/1991,5,0,4,11,20
10/26/1991,8,0,2,13,23
10/27/1991,3,0,5,3,11
10/28/1991,5,0,8,3,16
10/29/1991,4,0,8,5,17
10/30/1991,5,0,2,6,13
10/31/1991,8,0,3,1,12
11/1/1991,7,0,7,4,18
11/2/1991,5,0,4,9,18
11/3/1991,3,0,5,3,11
11/4/1991,2,0,6,6,14
11/5/1991,4,0,5,0,9
11/6/1991,5,0,7,7,19
11/7/1991,5,0,5,13,23
11/8/1991,7,0,6,1,14
11/9/1991,7,0,5,11,23
11/10/1991,5,0,6,11,22
11/11/1991,8,0,3,12,23
11/12/1991,4,0,4,8,16
11/13/1991,2,0,8,10,20
11/14/1991,4,0,4,1,9
11/15/1991,4,0,8,3,15
11/16/1991,6,0,8,12,26
11/17/1991,5,0,5,8,18
11/18/1991,6,0,4,11,21
11/19/1991,3,0,4,6,13
11/20/1991,7,0,6,12,25
11/21/1991,6,0,8,2,16
11/22/1991,2,0,7,0,9
11/23/1991,6,0,4,2,12
11/24/1991,8,0,2,4,14
11/25/1991,6,0,2,4,12
11/26/1991,3,0,5,12,20
11/27/1991,3,0,7,12,22
11/28/1991,6,0,2,11,19
11/29/1991,8,0,6,4,18
11/30/1991,3,0,3,2,8
12/1/1991,5,0,5,10,20
12/2/1991,2,0,3,9,14
12/3/1991,2,0,6,2,10
12/4/1991,4,0,2,12,18
12/5/1991,7,0,6,6,19
12/6/1991,2,0,4,6,12
12/7/1991,5,0,4,7,16
12/8/1991,7,0,3,0,10
12/9/1991,7,0,6,8,21
12/10/1991,4,0,5,8,17
12/11/1991,8,0,2,8,18
12/12/1991,4,0,5,3,12
12/13/1991,6,0,6,6,18
12/14/1991,3,0,3,4,10
12/15/1991,6,0,3,5,14
12/16/1991,6,0,5,1,12
12/17/1991,4,0,3,13,20
12/18/1991,7,0,4,3,14
12/19/1991,5,0,7,7,19
12/20/1991,4,0,3,2,9
12/21/1991,4,0,4,12,20
12/22/1991,8,0,4,13,25
12/23/1991,7,0,4,4,15
12/24/1991,8,0,8,4,20
12/25/1991,6,0,3,4,13
12/26/1991,8,0,4,8,20
12/27/1991,8,0,3,11,22
12/28/1991,6,0,6,4,16
12/29/1991,4,0,4,9,17
12/30/1991,8,0,6,4,18
12/31/1991,2,0,7,5,14
1/1/1992,7,0,8,11,26
1/2/1992,2,0,3,7,12
1/3/1992,5,0,3,5,13
1/4/1992,4,0,8,6,18
1/5/1992,2,0,2,12,16
1/6/1992,2,0,5,2,9
1/7/1992,7,0,2,9,18
1/8/1992,3,0,8,3,14
1/9/1992,2,0,2,6,10
1/10/1992,3,0,5,2,10
1/11/1992,3,0,8,0,11
1/12/1992,3,0,7,5,15
1/13/1992,4,0,4,13,21
1/14/1992,5,0,2,7,14
1/15/1992,5,0,6,9,20
1/16/1992,2,0,3,0,5
1/17/1992,6,0,2,0,8
1/18/1992,7,0,4,2,13
1/19/1992,8,0,6,8,22
1/20/1992,5,0,6,6,17
1/21/1992,7,0,2,7,16
1/22/1992,2,0,2,2,6
1/23/1992,6,0,3,11,20
1/24/1992,7,0,5,3,15
1/25/1992,5,0,5,11,21
1/26/1992,4,0,5,13,22
1/27/1992,8,0,4,7,19
1/28/1992,8,0,8,8,24
1/29/1992,3,0,6,1,10
1/30/1992,7,0,7,3,17
1/31/1992,2,0,8,10,20
2/1/1992,6,0,2,0,8
2/2/1992,8,0,4,5,17
2/3/1992,3,0,6,2,11
2/4/1992,2,0,6,1,9
2/5/1992,3,0,4,5,12
2/6/1992,5,0,6,10,21
2/7/1992,6,0,7,0,13
2/8/1992,3,0,4,11,18
2/9/1992,2,0,6,1,9
2/10/1992,6,0,3,6,15
2/11/1992,5,0,7,6,18
2/12/1992,4,0,8,10,22
2/13/1992,8,0,7,3,18
2/14/1992,6,0,3,9,18
2/15/1992,5,0,2,5,12
2/16/1992,7,0,6,6,19
2/17/1992,5,0,4,5,14
2/18/1992,3,0,3,2,8
2/19/1992,5,0,5,3,13
2/20/1992,2,0,3,4,9
2/21/1992,7,0,3,13,23
2/22/1992,2,0,4,13,19
2/23/1992,8,0,4,2,14
2/24/1992,4,0,7,7,18
2/25/1992,4,0,3,7,14
2/26/1992,7,0,2,1,10
2/27/1992,6,0,7,11,24
2/28/1992,5,0,4,8,17
2/29/1992,4,0,2,7,13
3/1/1992,2,0,8,9,19
3/2/1992,4,0,2,0,6
3/3/1992,2,0,8,12,22
3/4/1992,7,0,3,4,14
3/5/1992,5,0,3,3,11
3/6/1992,5,0,7,10,22
3/7/1992,8,0,3,8,19
3/8/1992,8,0,8,0,16
3/9/1992,5,0,3,2,10
3/10/1992,8,0,5,2,15
3/11/1992,8,0,4,0,12
3/12/1992,2,0,4,12,18
3/13/1992,2,0,8,11,21
3/14/1992,3,0,4,7,14
3/15/1992,2,0,2,2,6
3/16/1992,5,0,6,10,21
3/17/1992,7,0,3,10,20
3/18/1992,2,0,3,0,5
3/19/1992,2,0,5,5,12
3/20/1992,2,0,7,0,9
3/21/1992,6,0,4,1,11
3/22/1992,8,0,7,6,21
3/23/1992,2,0,7,3,12
3/24/1992,2,0,3,13,18
3/25/1992,5,0,5,0,10
3/26/1992,7,0,5,2,14
3/27/1992,3,0,6,12,21
3/28/1992,8,0,2,1,11
3/29/1992,4,0,3,11,18
3/30/1992,6,0,5,10,21
3/31/1992,8,0,2,0,10
4/1/1992,7,0,3,6,16
4/2/1992,2,0,4,11,17
4/3/1992,4,0,8,11,23
4/4/1992,8,0,5,11,24
4/5/1992,8,0,2,7,17
4/6/1992,2,0,5,1,8
4/7/1992,4,0,7,0,11
4/8/1992,8,0,4,6,18
4/9/1992,3,0,4,11,18
4/10/1992,2,0,4,8,14
4/11/1992,8,0,4,12,24
4/12/1992,5,0,8,12,25
4/13/1992,5,0,2,13,20
4/14/1992,5,0,5,6,16
4/15/1992,3,0,6,3,12
4/16/1992,2,0,8,8,18
4/17/1992,2,0,2,12,16
4/18/1992,8,0,8,12,28
4/19/1992,2,0,3,1,6
4/20/1992,3,0,6,4,13
4/21/1992,6,0,5,11,22
4/22/1992,3,0,7,5,15
4/23/1992,6,0,3,2,11
4/24/1992,8,0,5,3,16
4/25/1992,8,0,4,12,24
4/26/1992,2,0,4,13,19
4/27/1992,4,0,2,9,15
4/28/1992,8,0,3,3,14
4/29/1992,4,0,6,7,17
4/30/1992,5,0,3,6,14
5/1/1992,8,0,4,11,23
5/2/1992,2,0,3,5,10
5/3/1992,4,0,8,7,19
5/4/1992,6,0,4,7,17
5/5/1992,3,0,7,8,18
5/6/1992,5,0,6,7,18
5/7/1992,5,0,8,11,24
5/8/1992,2,0,3,8,13
5/9/1992,2,0,8,3,13
5/10/1992,5,0,6,8,19
5/11/1992,3,0,4,8,15
5/12/1992,4,0,3,5,12
5/13/1992,8,0,3,6,17
5/14/1992,3,0,3,4,10
5/15/1992,2,0,4,12,18
5/16/1992,8,0,7,1,16
5/17/1992,7,0,5,11,23
5/18/1992,4,0,2,6,12
5/19/1992,6,0,6,0,12
5/20/1992,6,0,7,5,18
5/21/1992,5,0,7,12,24
5/22/1992,6,0,7,3,16
5/23/1992,5,0,8,13,26
5/24/1992,4,0,8,0,12
5/25/1992,2,0,8,9,19
5/26/1992,7,0,7,8,22
5/27/1992,8,0,5,1,14
5/28/1992,4,0,8,2,14
5/29/1992,4,0,8,3,15
5/30/1992,5,0,6,10,21
5/31/1992,6,0,6,4,16
6/1/1992,2,0,7,7,16
6/2/1992,5,0,4,11,20
6/3/1992,4,0,8,11,23
6/4/1992,3,0,7,12,22
6/5/1992,2,0,2,1,5
6/6/1992,7,0,3,3,13
6/7/1992,5,0,4,10,19
6/8/1992,2,0,6,12,20
6/9/1992,4,0,6,12,22
6/10/1992,6,0,7,3,16
6/11/1992,4,0,6,1,11
6/12/1992,5,0,3,3,11
6/13/1992,8,0,4,12,24
6/14/1992,7,0,8,7,22
6/15/1992,4,0,5,2,11
6/16/1992,8,0,8,12,28
6/17/1992,8,0,4,9,21
6/18/1992,5,0,7,2,14
6/19/1992,5,0,5,3,13
6/20/1992,6,0,3,4,13
6/21/1992,2,0,3,3,8
6/22/1992,4,0,3,9,16
6/23/1992,5,0,4,10,19
6/24/1992,6,0,4,2,12
6/25/1992,2,0,5,9,16
6/26/1992,4,0,2,12,18
6/27/1992,5,0,2,2,9
6/28/1992,6,0,4,8,18
6/29/1992,8,0,6,12,26
6/30/1992,6,0,8,5,19
7/1/1992,8,0,8,2,18
7/2/1992,5,0,6,6,17
7/3/1992,3,0,2,8,13
7/4/1992,2,0,7,13,22
7/5/1992,8,0,4,0,12
7/6/1992,3,0,4,7,14
7/7/1992,5,0,8,7,20
7/8/1992,8,0,6,4,18
7/9/1992,2,0,3,3,8
7/10/1992,5,0,4,1,10
7/11/1992,7,0,3,2,12
7/12/1992,8,0,8,8,24
7/13/1992,3,0,3,9,15
7/14/1992,5,0,4,12,21
7/15/1992,6,0,2,11,19
7/16/1992,6,0,4,4,14
7/17/1992,8,0,5,1,14
7/18/1992,8,0,3,1,12
7/19/1992,5,0,2,7,14
7/20/1992,7,0,2,3,12
7/21/1992,2,0,7,1,10
7/22/1992,4,0,5,0,9
7/23/1992,2,0,7,7,16
7/24/1992,5,0,2,1,8
7/25/1992,4,0,7,3,14
7/26/1992,3,0,8,3,14
7/27/1992,7,0,3,10,20
7/28/1992,7,0,4,0,11
7/29/1992,2,0,7,3,12
7/30/1992,6,0,6,13,25
7/31/1992,2,0,4,6,12
8/1/1992,5,0,2,1,8
8/2/1992,5,0,7,0,12
8/3/1992,2,0,4,9,15
8/4/1992,4,0,3,0,7
8/5/1992,6,0,6,5,17
8/6/1992,8,0,7,12,27
8/7/1992,2,0,3,4,9
8/8/1992,6,0,3,13,22
8/9/1992,8,0,8,9,25
8/10/1992,3,0,6,5,14
8/11/1992,2,0,6,9,17
8/12/1992,5,0,5,6,16
8/13/1992,3,0,2,6,11
8/14/1992,5,0,5,2,12
8/15/1992,8,0,2,4,14
8/16/1992,5,0,4,4,13
8/17/1992,5,0,4,9,18
8/18/1992,4,0,2,5,11
8/19/1992,4,0,3,8,15
8/20/1992,5,0,4,11,20
8/21/1992,4,0,3,0,7
8/22/1992,3,0,4,13,20
8/23/1992,4,0,2,13,19
8/24/1992,2,0,6,5,13
8/25/1992,8,0,7,12,27
8/26/1992,3,0,7,3,13
8/27/1992,2,0,7,10,19
8/28/1992,6,0,3,6,15
8/29/1992,5,0,6,12,23
8/30/1992,3,0,6,5,14
8/31/1992,7,0,5,5,17
9/1/1992,2,0,7,12,21
9/2/1992,7,0,6,7,20
9/3/1992,6,0,3,5,14
9/4/1992,6,0,3,13,22
9/5/1992,7,0,4,3,14
9/6/1992,2,0,3,4,9
9/7/1992,7,0,2,11,20
9/8/1992,7,0,5,13,25
9/9/1992,2,0,8,1,11
9/10/1992,3,0,2,4,9
9/11/1992,2,0,4,0,6
9/12/1992,4,0,8,1,13
9/13/1992,7,0,2,1,10
9/14/1992,3,0,2,7,12
9/15/1992,2,0,5,3,10
9/16/1992,2,0,3,12,17
9/17/1992,2,0,4,4,10
9/18/1992,6,0,3,1,10
9/19/1992,6,0,6,8,20
9/20/1992,2,0,5,0,7
9/21/1992,8,0,4,1,13
9/22/1992,3,0,2,10,15
9/23/1992,4,0,4,0,8
9/24/1992,3,0,4,3,10
9/25/1992,3,0,4,11,18
9/26/1992,7,0,6,8,21
9/27/1992,5,0,4,2,11
9/28/1992,4,0,6,1,11
9/29/1992,2,0,8,8,18
9/30/1992,6,0,3,2,11
10/1/1992,7,0,4,11,22
10/2/1992,5,0,5,11,21
10/3/1992,6,0,8,13,27
10/4/1992,8,0,3,3,14
10/5/1992,6,0,3,0,9
10/6/1992,8,0,4,5,17
10/7/1992,4,0,4,6,14
10/8/1992,8,0,6,9,23
10/9/1992,3,0,8,8,19
10/10/1992,2,0,4,8,14
10/11/1992,8,0,6,12,26
10/12/1992,5,0,5,6,16
10/13/1992,6,0,8,4,18
10/14/1992,6,0,7,7,20
10/15/1992,6,0,2,12,20
10/16/1992,5,0,5,2,12
10/17/1992,5,0,7,6,18
10/18/1992,5,0,4,6,15
10/19/1992,5,0,2,0,7
10/20/1992,5,0,8,1,14
10/21/1992,4,0,8,11,23
10/22/1992,8,0,5,12,25
10/23/1992,6,0,7,2,15
10/24/1992,4,0,5,5,14
10/25/1992,7,0,6,5,18
10/26/1992,6,0,6,7,19
10/27/1992,3,0,3,10,16
10/28/1992,2,0,7,13,22
10/29/1992,5,0,7,6,18
10/30/1992,7,0,7,5,19
10/31/1992,5,0,8,12,25
11/1/1992,2,0,6,1,9
11/2/1992,2,0,7,13,22
11/3/1992,2,0,4,4,10
11/4/1992,2,0,5,3,10
11/5/1992,8,0,8,9,25
11/6/1992,3,0,5,7,15
11/7/1992,8,0,4,6,18
11/8/1992,5,0,3,6,14
11/9/1992,5,0,3,5,13
11/10/1992,4,0,4,5,13
11/11/1992,3,0,5,4,12
11/12/1992,4,0,3,7,14
11/13/1992,5,0,7,9,21
11/14/1992,5,0,2,6,13
11/15/1992,6,0,7,0,13
11/16/1992,6,0,8,10,24
11/17/1992,3,0,6,13,22
11/18/1992,3,0,5,0,8
11/19/1992,6,0,7,9,22
11/20/1992,7,0,6,9,22
11/21/1992,3,0,6,3,12
11/22/1992,2,0,2,6,10
11/23/1992,6,0,7,10,23
11/24/1992,5,0,3,12,20
11/25/1992,2,0,8,0,10
11/26/1992,3,0,7,10,20
11/27/1992,8,0,4,8,20
11/28/1992,6,0,8,5,19
11/29/1992,3,0,3,11,17
11/30/1992,6,0,6,7,19
12/1/1992,6,0,6,3,15
12/2/1992,2,0,8,7,17
12/3/1992,5,0,2,5,12
12/4/1992,7,0,7,2,16
12/5/1992,2,0,4,6,12
12/6/1992,4,0,6,9,19
12/7/1992,6,0,5,0,11
12/8/1992,6,0,5,11,22
12/9/1992,2,0,4,12,18
12/10/1992,8,0,3,0,11
12/11/1992,8,0,2,9,19
12/12/1992,4,0,7,13,24
12/13/1992,3,0,4,1,8
12/14/1992,8,0,4,12,24
12/15/1992,5,0,3,7,15
12/16/1992,6,0,8,9,23
12/17/1992,5,0,3,12,20
12/18/1992,6,0,7,2,15
12/19/1992,2,0,2,0,4
12/20/1992,6,0,6,8,20
12/21/1992,8,0,7,3,18
12/22/1992,6,0,6,2,14
12/23/1992,3,0,7,13,23
12/24/1992,6,0,5,1,12
12/25/1992,6,0,3,10,19
12/26/1992,4,0,3,13,20
12/27/1992,6,0,5,12,23
12/28/1992,2,0,3,9,14
12/29/1992,2,0,3,12,17
12/30/1992,6,0,5,12,23
12/31/1992,7,0,6,11,24
1/1/1993,7,0,6,3,16
1/2/1993,5,0,5,13,23
1/3/1993,8,0,2,7,17
1/4/1993,3,0,5,9,17
1/5/1993,3,0,3,7,13
1/6/1993,5,0,8,0,13
1/7/1993,6,0,8,1,15
1/8/1993,7,0,7,13,27
1/9/1993,6,0,4,7,17
1/10/1993,3,0,7,7,17
1/11/1993,6,0,2,4,12
1/12/1993,2,0,3,3,8
1/13/1993,4,0,7,8,19
1/14/1993,8,0,4,11,23
1/15/1993,5,0,7,3,15
1/16/1993,5,0,6,12,23
1/17/1993,5,0,4,13,22
1/18/1993,3,0,2,12,17
1/19/1993,3,0,6,9,18
1/20/1993,7,0,7,12,26
1/21/1993,4,0,4,13,21
1/22/1993,4,0,6,7,17
1/23/1993,7,0,3,13,23
1/24/1993,7,0,6,5,18
1/25/1993,4,0,2,5,11
1/26/1993,7,0,3,3,13
1/27/1993,7,0,6,13,26
1/28/1993,5,0,5,7,17
1/29/1993,2,0,6,6,14
1/30/1993,8,0,4,3,15
1/31/1993,8,0,4,11,23
2/1/1993,6,0,7,5,18
2/2/1993,8,0,2,7,17
2/3/1993,2,0,6,11,19
2/4/1993,4,0,3,13,20
2/5/1993,6,0,6,10,22
2/6/1993,2,0,6,3,11
2/7/1993,8,0,5,1,14
2/8/1993,2,0,4,8,14
2/9/1993,7,0,4,3,14
2/10/1993,7,0,4,2,13
2/11/1993,8,0,2,8,18
2/12/1993,2,0,6,13,21
2/13/1993,4,0,7,0,11
2/14/1993,3,0,2,7,12
2/15/1993,4,0,6,2,12
2/16/1993,5,0,8,3,16
2/17/1993,3,0,3,7,13
2/18/1993,5,0,2,0,7
2/19/1993,5,0,8,7,20
2/20/1993,5,0,2,1,8
2/21/1993,2,0,5,3,10
2/22/1993,3,0,4,5,12
2/23/1993,6,0,7,0,13
2/24/1993,6,0,6,2,14
2/25/1993,4,0,4,5,13
2/26/1993,7,0,7,0,14
2/27/1993,3,0,6,8,17
2/28/1993,4,0,6,7,17
3/1/1993,7,0,8,2,17
3/2/1993,8,0,2,8,18
3/3/1993,8,0,4,5,17
3/4/1993,8,0,4,13,25
3/5/1993,3,0,3,7,13
3/6/1993,2,0,5,10,17
3/7/1993,2,0,8,0,10
3/8/1993,3,0,4,6,13
3/9/1993,4,0,3,10,17
3/10/1993,4,0,4,10,18
3/11/1993,8,0,8,11,27
3/12/1993,5,0,8,12,25
3/13/1993,5,0,2,6,13
3/14/1993,4,0,5,5,14
3/15/1993,3,0,6,6,15
3/16/1993,6,0,6,13,25
3/17/1993,8,0,2,4,14
3/18/1993,4,0,5,8,17
3/19/1993,4,0,2,0,6
3/20/1993,7,0,3,0,10
3/21/1993,8,0,4,10,22
3/22/1993,7,0,6,6,19
3/23/1993,3,0,7,0,10
3/24/1993,2,0,6,10,18
3/25/1993,6,0,5,13,24
3/26/1993,4,0,5,7,16
3/27/1993,8,0,7,7,22
3/28/1993,2,0,2,2,6
3/29/1993,8,0,7,4,19
3/30/1993,5,0,4,5,14
3/31/1993,2,0,8,12,22
4/1/1993,7,0,5,1,13
4/2/1993,4,0,4,13,21
4/3/1993,6,0,3,5,14
4/4/1993,7,0,8,9,24
4/5/1993,7,0,8,6,21
4/6/1993,6,0,7,5,18
4/7/1993,2,0,8,9,19
4/8/1993,3,0,4,4,11
4/9/1993,4,0,4,4,12
4/10/1993,8,0,3,1,12
4/11/1993,4,0,2,7,13
4/12/1993,5,0,2,11,18
4/13/1993,3,0,7,0,10
4/14/1993,2,0,5,4,11
4/15/1993,8,0,2,1,11
4/16/1993,5,0,6,12,23
4/17/1993,3,0,3,5,11
4/18/1993,6,0,2,12,20
4/19/1993,8,0,5,2,15
4/20/1993,8,0,2,8,18
4/21/1993,5,0,2,7,14
4/22/1993,2,0,8,2,12
4/23/1993,8,0,8,8,24
4/24/1993,8,0,8,4,20
4/25/1993,2,0,8,12,22
4/26/1993,7,0,8,1,16
4/27/1993,4,0,4,7,15
4/28/1993,6,0,8,11,25
4/29/1993,3,0,3,12,18
4/30/1993,2,0,6,12,20
5/1/1993,4,0,8,6,18
5/2/1993,4,0,8,8,20
5/3/1993,4,0,3,10,17
5/4/1993,5,0,4,5,14
5/5/1993,6,0,6,3,15
5/6/1993,8,0,3,7,18
5/7/1993,3,0,8,11,22
5/8/1993,8,0,4,3,15
5/9/1993,6,0,5,2,13
5/10/1993,6,0,7,5,18
5/11/1993,5,0,7,0,12
5/12/1993,5,0,6,11,22
5/13/1993,5,0,5,4,14
5/14/1993,7,0,8,5,20
5/15/1993,7,0,7,6,20
5/16/1993,7,0,6,9,22
5/17/1993,6,0,6,1,13
5/18/1993,8,0,8,1,17
5/19/1993,7,0,5,8,20
5/20/1993,6,0,4,9,19
5/21/1993,2,0,8,8,18
5/22/1993,4,0,4,13,21
5/23/1993,8,0,7,10,25
5/24/1993,5,0,4,2,11
5/25/1993,6,0,2,13,21
5/26/1993,5,0,8,13,26
5/27/1993,3,0,7,6,16
5/28/1993,2,0,5,13,20
5/29/1993,5,0,5,2,12
5/30/1993,8,0,7,10,25
5/31/1993,6,0,3,7,16
6/1/1993,6,0,8,8,22
6/2/1993,8,0,8,4,20
6/3/1993,4,0,5,13,22
6/4/1993,3,0,6,8,17
6/5/1993,4,0,5,2,11
6/6/1993,3,0,3,2,8
6/7/1993,2,0,4,11,17
6/8/1993,8,0,7,10,25
6/9/1993,5,0,8,9,22
6/10/1993,7,0,8,10,25
6/11/1993,5,0,8,5,18
6/12/1993,6,0,2,0,8
6/13/1993,8,0,3,1,12
6/14/1993,8,0,6,4,18
6/15/1993,6,0,6,12,24
6/16/1993,7,0,4,3,14
6/17/1993,8,0,5,10,23
6/18/1993,3,0,5,1,9
6/19/1993,7,0,6,7,20
6/20/1993,2,0,4,9,15
6/21/1993,4,0,4,2,10
6/22/1993,4,0,6,13,23
6/23/1993,8,0,7,10,25
6/24/1993,2,0,7,11,20
6/25/1993,7,0,7,5,19
6/26/1993,6,0,4,12,22
6/27/1993,7,0,3,0,10
6/28/1993,4,0,3,13,20
6/29/1993,6,0,5,8,19
6/30/1993,8,0,3,3,14
7/1/1993,7,0,2,11,20
7/2/1993,5,0,7,11,23
7/3/1993,6,0,6,13,25
7/4/1993,2,0,6,10,18
7/5/1993,7,0,2,1,10
7/6/1993,3,0,5,13,21
7/7/1993,4,0,2,13,19
7/8/1993,3,0,5,13,21
7/9/1993,3,0,7,3,13
7/10/1993,6,0,7,0,13
7/11/1993,6,0,3,9,18
7/12/1993,8,0,5,6,19
7/13/1993,8,0,2,0,10
7/14/1993,6,0,5,8,19
7/15/1993,7,0,3,11,21
7/16/1993,4,0,7,5,16
7/17/1993,7,0,2,12,21
7/18/1993,4,0,3,4,11
7/19/1993,5,0,8,11,24
7/20/1993,2,0,6,4,12
7/21/1993,7,0,4,3,14
7/22/1993,2,0,8,0,10
7/23/1993,4,0,2,13,19
7/24/1993,3,0,2,6,11
7/25/1993,4,0,3,6,13
7/26/1993,5,0,6,9,20
7/27/1993,3,0,7,9,19
7/28/1993,8,0,7,2,17
7/29/1993,5,0,4,11,20
7/30/1993,8,0,7,13,28
7/31/1993,6,0,6,7,19
8/1/1993,3,0,5,12,20
8/2/1993,2,0,4,4,10
8/3/1993,4,0,3,4,11
8/4/1993,3,0,5,5,13
8/5/1993,2,0,8,8,18
8/6/1993,8,0,6,4,18
8/7/1993,6,0,7,1,14
8/8/1993,4,0,7,7,18
8/9/1993,3,0,6,1,10
8/10/1993,6,0,3,6,15
8/11/1993,4,0,6,6,16
8/12/1993,3,0,5,6,14
8/13/1993,5,0,3,11,19
8/14/1993,3,0,4,11,18
8/15/1993,5,0,8,5,18
8/16/1993,4,0,7,13,24
8/17/1993,2,0,2,6,10
8/18/1993,6,0,6,12,24
8/19/1993,4,0,4,0,8
8/20/1993,3,0,6,3,12
8/21/1993,6,0,7,6,19
8/22/1993,2,0,6,9,17
8/23/1993,5,0,4,13,22
8/24/1993,7,0,7,6,20
8/25/1993,4,0,6,5,15
8/26/1993,7,0,3,3,13
8/27/1993,2,0,6,13,21
8/28/1993,6,0,4,12,22
8/29/1993,4,0,6,0,10
8/30/1993,7,0,3,9,19
8/31/1993,5,0,3,10,18
9/1/1993,3,0,3,5,11
9/2/1993,5,0,3,0,8
9/3/1993,6,0,2,0,8
9/4/1993,3,0,8,1,12
9/5/1993,5,0,4,9,18
9/6/1993,3,0,5,6,14
9/7/1993,4,0,4,5,13
9/8/1993,6,0,5,9,20
9/9/1993,2,0,4,2,8
9/10/1993,2,0,4,1,7
9/11/1993,2,0,2,0,4
9/12/1993,8,0,3,12,23
9/13/1993,7,0,8,10,25
9/14/1993,8,0,2,0,10
9/15/1993,2,0,4,2,8
9/16/1993,2,0,5,9,16
9/17/1993,4,0,2,8,14
9/18/1993,7,0,3,9,19
9/19/1993,5,0,6,2,13
9/20/1993,3,0,6,7,16
9/21/1993,5,0,8,0,13
9/22/1993,3,0,6,3,12
9/23/1993,8,0,3,12,23
9/24/1993,7,0,8,12,27
9/25/1993,6,0,2,13,21
9/26/1993,8,0,7,13,28
9/27/1993,2,0,4,0,6
9/28/1993,7,0,2,7,16
9/29/1993,5,0,6,12,23
9/30/1993,7,0,8,8,23
10/1/1993,6,0,7,10,23
10/2/1993,6,0,6,6,18
10/3/1993,2,0,8,13,23
10/4/1993,6,0,7,8,21
10/5/1993,2,0,5,3,10
10/6/1993,2,0,4,2,8
10/7/1993,8,0,5,8,21
10/8/1993,7,0,7,12,26
10/9/1993,8,0,3,5,16
10/10/1993,8,0,4,6,18
10/11/1993,4,0,3,8,15
10/12/1993,2,0,2,0,4
10/13/1993,5,0,3,7,15
10/14/1993,5,0,2,3,10
10/15/1993,5,0,5,10,20
10/16/1993,3,0,5,3,11
10/17/1993,7,0,7,0,14
10/18/1993,6,0,8,13,27
10/19/1993,3,0,5,8,16
10/20/1993,2,0,2,9,13
10/21/1993,8,0,4,5,17
10/22/1993,6,0,5,5,16
10/23/1993,4,0,2,0,6
10/24/1993,8,0,5,8,21
10/25/1993,8,0,8,0,16
10/26/1993,7,0,5,1,13
10/27/1993,4,0,3,12,19
10/28/1993,4,0,4,11,19
10/29/1993,2,0,2,5,9
10/30/1993,3,0,6,3,12
10/31/1993,6,0,4,7,17
11/1/1993,3,0,7,2,12
11/2/1993,3,0,7,4,14
11/3/1993,6,0,2,9,17
11/4/1993,3,0,4,10,17
11/5/1993,6,0,7,10,23
11/6/1993,7,0,3,1,11
11/7/1993,2,0,4,10,16
11/8/1993,5,0,3,3,11
11/9/1993,8,0,3,11,22
11/10/1993,5,0,6,11,22
11/11/1993,5,0,5,11,21
11/12/1993,4,0,6,2,12
11/13/1993,3,0,4,9,16
11/14/1993,2,0,6,1,9
11/15/1993,8,0,3,2,13
11/16/1993,6,0,7,9,22
11/17/1993,7,0,5,4,16
11/18/1993,4,0,5,9,18
11/19/1993,7,0,8,9,24
11/20/1993,8,0,4,6,18
11/21/1993,4,0,5,4,13
11/22/1993,3,0,2,5,10
11/23/1993,8,0,4,4,16
11/24/1993,4,0,4,12,20
11/25/1993,5,0,3,0,8
11/26/1993,6,0,8,2,16
11/27/1993,6,0,7,11,24
11/28/1993,3,0,8,7,18
11/29/1993,3,0,3,13,19
11/30/1993,2,0,3,8,13
12/1/1993,2,0,5,8,15
12/2/1993,4,0,8,11,23
12/3/1993,4,0,5,5,14
12/4/1993,5,0,3,13,21
12/5/1993,8,0,3,0,11
12/6/1993,2,0,6,5,13
12/7/1993,8,0,6,6,20
12/8/1993,2,0,3,1,6
12/9/1993,5,0,8,9,22
12/10/1993,8,0,2,12,22
12/11/1993,2,0,7,5,14
12/12/1993,5,0,4,10,19
12/13/1993,2,0,4,13,19
12/14/1993,3,0,8,7,18
12/15/1993,4,0,4,5,13
12/16/1993,2,0,5,1,8
12/17/1993,4,0,2,0,6
12/18/1993,7,0,7,4,18
12/19/1993,7,0,7,12,26
12/20/1993,4,0,6,1,11
12/21/1993,3,0,2,11,16
12/22/1993,5,0,6,11,22
12/23/1993,6,0,5,11,22
12/24/1993,4,0,3,2,9
12/25/1993,8,0,8,0,16
12/26/1993,6,0,7,3,16
12/27/1993,2,0,2,6,10
12/28/1993,5,0,2,5,12
12/29/1993,6,0,4,8,18
12/30/1993,8,0,3,4,15
12/31/1993,8,0,8,11,27
1/1/1994,2,0,2,1,5
1/2/1994,8,0,8,6,22
1/3/1994,6,0,3,11,20
1/4/1994,4,0,7,4,15
1/5/1994,4,0,2,10,16
1/6/1994,2,0,3,0,5
1/7/1994,7,0,8,10,25
1/8/1994,7,0,3,4,14
1/9/1994,8,0,6,11,25
1/10/1994,4,0,5,10,19
1/11/1994,6,0,6,8,20
1/12/1994,4,0,5,11,20
1/13/1994,3,0,5,8,16
1/14/1994,5,0,7,13,25
1/15/1994,5,0,2,11,18
1/16/1994,6,0,3,7,16
1/17/1994,4,0,2,12,18
1/18/1994,2,0,6,7,15
1/19/1994,6,0,6,7,19
1/20/1994,8,0,5,10,23
1/21/1994,8,0,4,11,23
1/22/1994,8,0,3,2,13
1/23/1994,6,0,6,8,20
1/24/1994,5,0,3,9,17
1/25/1994,8,0,7,12,27
1/26/1994,2,0,2,10,14
1/27/1994,5,0,4,9,18
1/28/1994,8,0,4,9,21
1/29/1994,7,0,6,2,15
1/30/1994,8,0,4,10,22
1/31/1994,3,0,6,1,10
2/1/1994,4,0,7,0,11
2/2/1994,3,0,8,0,11
2/3/1994,2,0,6,0,8
2/4/1994,8,0,8,3,19
2/5/1994,6,0,2,5,13
2/6/1994,8,0,8,10,26
2/7/1994,4,0,3,7,14
2/8/1994,4,0,8,5,17
2/9/1994,3,0,8,0,11
2/10/1994,5,0,2,8,15
2/11/1994,5,0,6,4,15
2/12/1994,2,0,6,10,18
2/13/1994,5,0,7,3,15
2/14/1994,2,0,6,11,19
2/15/1994,3,0,6,9,18
2/16/1994,5,0,3,7,15
2/17/1994,6,0,8,12,26
2/18/1994,4,0,2,6,12
2/19/1994,8,0,3,4,15
2/20/1994,4,0,3,4,11
2/21/1994,5,0,5,6,16
2/22/1994,2,0,7,10,19
2/23/1994,4,0,4,8,16
2/24/1994,8,0,4,13,25
2/25/1994,4,0,6,12,22
2/26/1994,7,0,2,5,14
2/27/1994,4,0,7,10,21
2/28/1994,8,0,8,1,17
3/1/1994,2,0,8,8,18
3/2/1994,7,0,3,13,23
3/3/1994,4,0,6,12,22
3/4/1994,8,0,3,7,18
3/5/1994,2,0,2,13,17
3/6/1994,5,0,3,1,9
3/7/1994,7,0,2,4,13
3/8/1994,5,0,7,9,21
3/9/1994,2,0,2,1,5
3/10/1994,2,0,3,3,8
3/11/1994,5,0,5,0,10
3/12/1994,7,0,2,7,16
3/13/1994,7,0,3,2,12
3/14/1994,4,0,7,10,21
3/15/1994,5,0,3,7,15
3/16/1994,4,0,6,9,19
3/17/1994,4,0,3,3,10
3/18/1994,6,0,7,10,23
3/19/1994,5,0,7,8,20
3/20/1994,7,0,5,12,24
3/21/1994,8,0,3,1,12
3/22/1994,7,0,3,0,10
3/23/1994,7,0,2,2,11
3/24/1994,6,0,4,10,20
3/25/1994,2,0,2,7,11
3/26/1994,3,0,4,2,9
3/27/1994,8,0,2,0,10
3/28/1994,6,0,6,10,22
3/29/1994,5,0,6,12,23
3/30/1994,5,0,2,7,14
3/31/1994,2,0,5,7,14
4/1/1994,7,0,4,7,18
4/2/1994,3,0,3,13,19
4/3/1994,7,0,6,2,15
4/4/1994,4,0,5,2,11
4/5/1994,7,0,7,12,26
4/6/1994,6,0,3,2,11
4/7/1994,7,0,6,10,23
4/8/1994,4,0,2,1,7
4/9/1994,6,0,4,5,15
4/10/1994,3,0,3,6,12
4/11/1994,8,0,3,2,13
4/12/1994,5,0,5,12,22
4/13/1994,4,0,3,8,15
4/14/1994,6,0,5,5,16
4/15/1994,6,0,8,2,16
4/16/1994,3,0,6,9,18
4/17/1994,7,0,3,3,13
4/18/1994,2,0,7,9,18
4/19/1994,5,0,3,8,16
4/20/1994,4,0,4,10,18
4/21/1994,4,0,8,5,17
4/22/1994,2,0,6,9,17
4/23/1994,8,0,3,4,15
4/24/1994,3,0,4,3,10
4/25/1994,8,0,7,6,21
4/26/1994,4,0,8,2,14
4/27/1994,5,0,6,7,18
4/28/1994,2,0,7,5,14
4/29/1994,8,0,3,8,19
4/30/1994,2,0,4,3,9
5/1/1994,3,0,7,5,15
5/2/1994,5,0,6,12,23
5/3/1994,6,0,3,2,11
5/4/1994,4,0,8,9,21
5/5/1994,2,0,2,4,8
5/6/1994,6,0,8,11,25
5/7/1994,2,0,5,7,14
5/8/1994,4,0,4,9,17
5/9/1994,5,0,6,8,19
5/10/1994,3,0,4,11,18
5/11/1994,5,0,8,5,18
5/12/1994,8,0,4,5,17
5/13/1994,5,0,5,9,19
5/14/1994,4,0,3,10,17
5/15/1994,2,0,8,7,17
5/16/1994,5,0,6,0,11
5/17/1994,5,0,8,13,26
5/18/1994,5,0,4,8,17
5/19/1994,5,0,8,6,19
5/20/1994,4,0,8,12,24
5/21/1994,4,0,6,11,21
5/22/1994,7,0,4,0,11
5/23/1994,4,0,2,3,9
5/24/1994,3,0,2,2,7
5/25/1994,6,0,6,11,23
5/26/1994,2,0,4,10,16
5/27/1994,3,0,4,1,8
5/28/1994,5,0,6,7,18
5/29/1994,3,0,7,5,15
5/30/1994,6,0,4,1,11
5/31/1994,2,0,5,5,12
6/1/1994,7,0,7,10,24
6/2/1994,2,0,5,7,14
6/3/1994,4,0,2,4,10
6/4/1994,6,0,6,4,16
6/5/1994,8,0,7,1,16
6/6/1994,6,0,7,2,15
6/7/1994,4,0,5,13,22
6/8/1994,7,0,8,7,22
6/9/1994,3,0,6,7,16
6/10/1994,3,0,4,2,9
6/11/1994,2,0,6,6,14
6/12/1994,5,0,7,12,24
6/13/1994,2,0,7,6,15
6/14/1994,2,0,3,2,7
6/15/1994,3,0,5,1,9
6/16/1994,8,0,5,12,25
6/17/1994,2,0,3,5,10
6/18/1994,4,0,3,12,19
6/19/1994,8,0,7,0,15
6/20/1994,3,0,4,8,15
6/21/1994,2,0,8,0,10
6/22/1994,5,0,8,11,24
6/23/1994,2,0,6,9,17
6/24/1994,3,0,4,9,16
6/25/1994,2,0,5,13,20
6/26/1994,4,0,4,3,11
6/27/1994,5,0,5,10,20
6/28/1994,2,0,3,7,12
6/29/1994,6,0,8,9,23
6/30/1994,5,0,3,0,8
7/1/1994,6,0,4,10,20
7/2/1994,6,0,3,10,19
7/3/1994,5,0,2,10,17
7/4/1994,5,0,4,3,12
7/5/1994,6,0,6,3,15
7/6/1994,8,0,3,3,14
7/7/1994,7,0,5,0,12
7/8/1994,2,0,6,7,15
7/9/1994,2,0,2,5,9
7/10/1994,3,0,7,6,16
7/11/1994,2,0,4,9,15
7/12/1994,3,0,2,10,15
7/13/1994,7,0,8,12,27
7/14/1994,4,0,2,5,11
7/15/1994,4,0,3,12,19
7/16/1994,8,0,3,12,23
7/17/1994,5,0,3,4,12
7/18/1994,3,0,3,6,12
7/19/1994,2,0,6,6,14
7/20/1994,5,0,6,9,20
7/21/1994,3,0,6,10,19
7/22/1994,7,0,8,7,22
7/23/1994,4,0,8,6,18
7/24/1994,4,0,3,0,7
7/25/1994,4,0,2,0,6
7/26/1994,5,0,6,5,16
7/27/1994,4,0,5,11,20
7/28/1994,8,0,4,5,17
7/29/1994,2,0,5,9,16
7/30/1994,7,0,6,6,19
7/31/1994,4,0,7,1,12
8/1/1994,3,0,6,9,18
8/2/1994,8,0,2,11,21
8/3/1994,7,0,3,7,17
8/4/1994,8,0,6,7,21
8/5/1994,4,0,5,1,10
8/6/1994,4,0,8,7,19
8/7/1994,8,0,7,13,28
8/8/1994,4,0,6,4,14
8/9/1994,6,0,7,11,24
8/10/1994,8,0,2,13,23
8/11/1994,7,0,2,11,20
8/12/1994,2,0,8,8,18
8/13/1994,8,0,7,4,19
8/14/1994,2,0,6,0,8
8/15/1994,2,0,8,4,14
8/16/1994,4,0,6,5,15
8/17/1994,8,0,8,2,18
8/18/1994,4,0,7,6,17
8/19/1994,8,0,6,5,19
8/20/1994,2,0,2,0,4
8/21/1994,2,0,5,10,17
8/22/1994,3,0,8,8,19
8/23/1994,2,0,7,5,14
8/24/1994,4,0,4,13,21
8/25/1994,3,0,4,4,11
8/26/1994,6,0,7,3,16
8/27/1994,2,0,8,3,13
8/28/1994,6,0,5,8,19
8/29/1994,2,0,3,2,7
8/30/1994,7,0,7,0,14
8/31/1994,6,0,3,4,13
9/1/1994,5,0,5,3,13
9/2/1994,6,0,3,6,15
9/3/1994,5,0,3,5,13
9/4/1994,2,0,3,8,13
9/5/1994,3,0,4,10,17
9/6/1994,8,0,7,6,21
9/7/1994,8,0,5,7,20
9/8/1994,7,0,8,0,15
9/9/1994,7,0,8,3,18
9/10/1994,7,0,2,7,16
9/11/1994,4,0,6,8,18
9/12/1994,6,0,6,8,20
9/13/1994,8,0,8,5,21
9/14/1994,8,0,2,13,23
9/15/1994,3,0,3,3,9
9/16/1994,4,0,3,9,16
9/17/1994,3,0,3,10,16
9/18/1994,2,0,4,3,9
9/19/1994,8,0,8,4,20
9/20/1994,6,0,4,1,11
9/21/1994,8,0,6,8,22
9/22/1994,6,0,8,11,25
9/23/1994,2,0,2,7,11
9/24/1994,5,0,4,0,9
9/25/1994,6,0,4,13,23
9/26/1994,3,0,8,13,24
9/27/1994,7,0,8,12,27
9/28/1994,5,0,6,7,18
9/29/1994,7,0,3,8,18
9/30/1994,3,0,7,8,18
10/1/1994,3,0,4,5,12
10/2/1994,2,0,8,3,13
10/3/1994,2,0,6,10,18
10/4/1994,3,0,7,10,20
10/5/1994,8,0,7,13,28
10/6/1994,5,0,4,11,20
10/7/1994,4,0,3,10,17
10/8/1994,2,0,4,13,19
10/9/1994,5,0,6,1,12
10/10/1994,3,0,5,3,11
10/11/1994,3,0,7,12,22
10/12/1994,6,0,6,8,20
10/13/1994,6,0,6,11,23
10/14/1994,7,0,7,13,27
10/15/1994,8,0,7,4,19
10/16/1994,6,0,5,2,13
10/17/1994,3,0,6,3,12
10/18/1994,8,0,2,7,17
10/19/1994,6,0,5,12,23
10/20/1994,4,0,3,5,12
10/21/1994,4,0,2,2,8
10/22/1994,6,0,2,5,13
10/23/1994,6,0,4,2,12
10/24/1994,2,0,4,1,7
10/25/1994,2,0,2,4,8
10/26/1994,7,0,2,13,22
10/27/1994,3,0,4,4,11
10/28/1994,5,0,7,6,18
10/29/1994,6,0,4,6,16
10/30/1994,8,0,8,4,20
10/31/1994,3,0,6,7,16
11/1/1994,4,0,3,1,8
11/2/1994,6,0,7,0,13
11/3/1994,8,0,2,6,16
11/4/1994,8,0,4,0,12
11/5/1994,2,0,4,11,17
11/6/1994,3,0,7,3,13
11/7/1994,7,0,4,10,21
11/8/1994,3,0,4,7,14
11/9/1994,6,0,5,8,19
11/10/1994,4,0,4,11,19
11/11/1994,2,0,7,3,12
11/12/1994,8,0,7,8,23
11/13/1994,4,0,6,13,23
11/14/1994,8,0,4,7,19
11/15/1994,3,0,3,7,13
11/16/1994,2,0,4,0,6
11/17/1994,8,0,2,9,19
11/18/1994,2,0,5,5,12
11/19/1994,7,0,8,10,25
11/20/1994,5,0,2,6,13
11/21/1994,2,0,6,2,10
11/22/1994,8,0,6,3,17
11/23/1994,8,0,4,11,23
11/24/1994,7,0,4,2,13
11/25/1994,4,0,6,2,12
11/26/1994,8,0,7,3,18
11/27/1994,8,0,7,0,15
11/28/1994,2,0,5,8,15
11/29/1994,3,0,4,13,20
11/30/1994,2,0,8,12,22
12/1/1994,5,0,8,12,25
12/2/1994,3,0,8,11,22
12/3/1994,2,0,5,5,12
12/4/1994,6,0,4,3,13
12/5/1994,8,0,7,8,23
12/6/1994,7,0,4,2,13
12/7/1994,7,0,7,4,18
12/8/1994,3,0,8,10,21
12/9/1994,8,0,6,11,25
12/10/1994,8,0,2,5,15
12/11/1994,8,0,5,4,17
12/12/1994,2,0,7,6,15
12/13/1994,8,0,6,5,19
12/14/1994,3,0,5,4,12
12/15/1994,5,0,5,10,20
12/16/1994,3,0,5,12,20
12/17/1994,2,0,7,12,21
12/18/1994,5,0,3,5,13
12/19/1994,4,0,6,3,13
12/20/1994,6,0,8,8,22
12/21/1994,7,0,3,9,19
12/22/1994,4,0,3,2,9
12/23/1994,8,0,2,6,16
12/24/1994,7,0,7,6,20
12/25/1994,7,0,4,0,11
12/26/1994,6,0,4,10,20
12/27/1994,2,0,3,5,10
12/28/1994,5,0,5,10,20
12/29/1994,3,0,5,2,10
12/30/1994,2,0,8,13,23
12/31/1994,5,0,6,4,15
1/1/1995,5,0,7,12,24
1/2/1995,2,0,4,6,12
1/3/1995,7,0,2,5,14
1/4/1995,7,0,6,6,19
1/5/1995,3,0,6,10,19
1/6/1995,6,0,4,3,13
1/7/1995,6,0,6,13,25
1/8/1995,4,0,4,12,20
1/9/1995,6,0,2,2,10
1/10/1995,3,0,5,6,14
1/11/1995,8,0,7,2,17
1/12/1995,3,0,2,1,6
1/13/1995,2,0,2,12,16
1/14/1995,5,0,6,11,22
1/15/1995,4,0,6,11,21
1/16/1995,5,0,4,9,18
1/17/1995,8,0,7,6,21
1/18/1995,3,0,8,0,11
1/19/1995,4,0,6,11,21
1/20/1995,7,0,3,3,13
1/21/1995,4,0,3,6,13
1/22/1995,6,0,5,13,24
1/23/1995,5,0,5,0,10
1/24/1995,7,0,2,0,9
1/25/1995,2,0,4,6,12
1/26/1995,5,0,3,2,10
1/27/1995,7,0,7,9,23
1/28/1995,8,0,8,13,29
1/29/1995,6,0,7,6,19
1/30/1995,8,0,7,2,17
1/31/1995,4,0,6,0,10
2/1/1995,5,0,2,13,20
2/2/1995,5,0,8,9,22
2/3/1995,5,0,2,6,13
2/4/1995,5,0,7,10,22
2/5/1995,8,0,5,6,19
2/6/1995,6,0,4,3,13
2/7/1995,3,0,8,8,19
2/8/1995,2,0,3,6,11
2/9/1995,3,0,2,11,16
2/10/1995,3,0,3,13,19
2/11/1995,3,0,6,12,21
2/12/1995,2,0,5,8,15
2/13/1995,4,0,7,10,21
2/14/1995,7,0,2,6,15
2/15/1995,4,0,5,5,14
2/16/1995,6,0,6,1,13
2/17/1995,4,0,7,12,23
2/18/1995,5,0,2,10,17
2/19/1995,6,0,2,9,17
2/20/1995,4,0,3,1,8
2/21/1995,5,0,3,12,20
2/22/1995,3,0,6,7,16
2/23/1995,3,0,6,5,14
2/24/1995,5,0,8,12,25
2/25/1995,5,0,6,13,24
2/26/1995,5,0,7,1,13
2/27/1995,4,0,5,12,21
2/28/1995,7,0,4,10,21
3/1/1995,6,0,7,8,21
3/2/1995,8,0,6,6,20
3/3/1995,6,0,4,8,18
3/4/1995,5,0,3,12,20
3/5/1995,2,0,8,1,11
3/6/1995,5,0,8,0,13
3/7/1995,7,0,2,2,11
3/8/1995,4,0,3,1,8
3/9/1995,3,0,4,9,16
3/10/1995,7,0,6,10,23
3/11/1995,7,0,6,10,23
3/12/1995,8,0,3,9,20
3/13/1995,2,0,3,8,13
3/14/1995,7,0,3,6,16
3/15/1995,3,0,8,11,22
3/16/1995,7,0,4,6,17
3/17/1995,2,0,2,13,17
3/18/1995,2,0,3,5,10
3/19/1995,3,0,6,6,15
3/20/1995,8,0,7,6,21
3/21/1995,8,0,3,9,20
3/22/1995,3,0,8,10,21
3/23/1995,5,0,5,13,23
3/24/1995,6,0,8,6,20
3/25/1995,6,0,6,9,21
3/26/1995,7,0,8,3,18
3/27/1995,6,0,3,4,13
3/28/1995,4,0,6,4,14
3/29/1995,6,0,7,8,21
3/30/1995,6,0,8,3,17
3/31/1995,3,0,7,8,18
4/1/1995,7,0,4,3,14
4/2/1995,4,0,4,11,19
4/3/1995,7,0,6,13,26
4/4/1995,7,0,7,2,16
4/5/1995,3,0,6,6,15
4/6/1995,4,0,4,4,12
4/7/1995,3,0,2,13,18
4/8/1995,3,0,3,6,12
4/9/1995,8,0,6,8,22
4/10/1995,5,0,2,3,10
4/11/1995,6,0,4,13,23
4/12/1995,5,0,3,3,11
4/13/1995,6,0,2,0,8
4/14/1995,4,0,4,5,13
4/15/1995,3,0,4,6,13
4/16/1995,6,0,3,8,17
4/17/1995,7,0,6,8,21
4/18/1995,5,0,6,1,12
4/19/1995,3,0,4,11,18
4/20/1995,3,0,8,0,11
4/21/1995,7,0,6,7,20
4/22/1995,8,0,3,10,21
4/23/1995,3,0,5,9,17
4/24/1995,7,0,2,9,18
4/25/1995,2,0,5,5,12
4/26/1995,6,0,2,12,20
4/27/1995,5,0,2,2,9
4/28/1995,3,0,7,10,20
4/29/1995,6,0,4,0,10
4/30/1995,5,0,5,1,11
5/1/1995,2,0,7,11,20
5/2/1995,4,0,3,5,12
5/3/1995,6,0,6,11,23
5/4/1995,6,0,5,1,12
5/5/1995,3,0,6,4,13
5/6/1995,6,0,2,7,15
5/7/1995,8,0,7,12,27
5/8/1995,8,0,3,6,17
5/9/1995,6,0,3,7,16
5/10/1995,8,0,8,4,20
5/11/1995,5,0,8,8,21
5/12/1995,3,0,4,4,11
5/13/1995,8,0,7,6,21
5/14/1995,7,0,2,5,14
5/15/1995,7,0,5,8,20
5/16/1995,6,0,5,0,11
5/17/1995,7,0,6,11,24
5/18/1995,2,0,8,6,16
5/19/1995,8,0,4,5,17
5/20/1995,4,0,2,9,15
5/21/1995,4,0,3,2,9
5/22/1995,4,0,4,0,8
5/23/1995,5,0,7,0,12
5/24/1995,4,0,5,5,14
5/25/1995,3,0,3,8,14
5/26/1995,7,0,4,3,14
5/27/1995,8,0,3,0,11
5/28/1995,4,0,7,11,22
5/29/1995,8,0,8,12,28
5/30/1995,7,0,2,9,18
5/31/1995,6,0,5,9,20
6/1/1995,8,0,2,9,19
6/2/1995,8,0,8,1,17
6/3/1995,5,0,4,7,16
6/4/1995,8,0,5,11,24
6/5/1995,2,0,6,12,20
6/6/1995,7,0,8,5,20
6/7/1995,3,0,6,13,22
6/8/1995,4,0,5,6,15
6/9/1995,8,0,6,3,17
6/10/1995,8,0,3,11,22
6/11/1995,5,0,3,8,16
6/12/1995,8,0,8,2,18
6/13/1995,2,0,3,6,11
6/14/1995,3,0,7,9,19
6/15/1995,4,0,7,6,17
6/16/1995,2,0,8,12,22
6/17/1995,6,0,8,3,17
6/18/1995,8,0,6,0,14
6/19/1995,3,0,2,9,14
6/20/1995,8,0,4,12,24
6/21/1995,7,0,7,11,25
6/22/1995,7,0,7,3,17
6/23/1995,2,0,3,5,10
6/24/1995,6,0,8,13,27
6/25/1995,5,0,4,5,14
6/26/1995,2,0,5,4,11
6/27/1995,3,0,8,7,18
6/28/1995,2,0,7,9,18
6/29/1995,5,0,8,10,23
6/30/1995,8,0,8,13,29
7/1/1995,5,0,6,11,22
7/2/1995,5,0,4,6,15
7/3/1995,8,0,2,7,17
7/4/1995,5,0,2,1,8
7/5/1995,5,0,6,10,21
7/6/1995,4,0,8,12,24
7/7/1995,4,0,5,1,10
7/8/1995,4,0,6,6,16
7/9/1995,7,0,5,6,18
7/10/1995,3,0,8,5,16
7/11/1995,8,0,6,1,15
7/12/1995,8,0,7,2,17
7/13/1995,4,0,7,3,14
7/14/1995,8,0,2,1,11
7/15/1995,3,0,2,9,14
7/16/1995,6,0,5,13,24
7/17/1995,8,0,5,5,18
7/18/1995,8,0,3,13,24
7/19/1995,6,0,5,6,17
7/20/1995,4,0,2,11,17
7/21/1995,5,0,2,2,9
7/22/1995,3,0,7,11,21
7/23/1995,2,0,7,11,20
7/24/1995,3,0,3,1,7
7/25/1995,4,0,8,7,19
7/26/1995,2,0,7,0,9
7/27/1995,5,0,5,6,16
7/28/1995,5,0,6,5,16
7/29/1995,4,0,8,11,23
7/30/1995,8,0,6,9,23
7/31/1995,5,0,4,0,9
8/1/1995,8,0,3,5,16
8/2/1995,7,0,5,8,20
8/3/1995,6,0,8,11,25
8/4/1995,4,0,5,12,21
8/5/1995,5,0,8,1,14
8/6/1995,6,0,2,6,14
8/7/1995,3,0,3,7,13
8/8/1995,3,0,2,9,14
8/9/1995,8,0,8,11,27
8/10/1995,3,0,7,13,23
8/11/1995,4,0,7,0,11
8/12/1995,6,0,6,2,14
8/13/1995,8,0,8,4,20
8/14/1995,6,0,7,4,17
8/15/1995,4,0,3,13,20
8/16/1995,7,0,6,1,14
8/17/1995,3,0,7,0,10
8/18/1995,5,0,5,8,18
8/19/1995,2,0,3,7,12
8/20/1995,4,0,4,9,17
8/21/1995,4,0,7,12,23
8/22/1995,8,0,3,3,14
8/23/1995,2,0,2,6,10
8/24/1995,8,0,3,4,15
8/25/1995,3,0,7,7,17
8/26/1995,3,0,7,2,12
8/27/1995,5,0,8,8,21
8/28/1995,3,0,3,3,9
8/29/1995,4,0,6,4,14
8/30/1995,6,0,7,5,18
8/31/1995,7,0,6,11,24
9/1/1995,4,0,5,7,16
9/2/1995,4,0,2,9,15
9/3/1995,8,0,8,11,27
9/4/1995,2,0,7,1,10
9/5/1995,8,0,8,8,24
9/6/1995,5,0,8,6,19
9/7/1995,2,0,2,12,16
9/8/1995,6,0,4,9,19
9/9/1995,2,0,7,3,12
9/10/1995,6,0,2,0,8
9/11/1995,3,0,8,11,22
9/12/1995,3,0,5,5,13
9/13/1995,4,0,2,9,15
9/14/1995,5,0,8,12,25
9/15/1995,2,0,7,13,22
9/16/1995,3,0,8,1,12
9/17/1995,3,0,2,4,9
9/18/1995,3,0,3,11,17
9/19/1995,3,0,4,8,15
9/20/1995,3,0,8,11,22
9/21/1995,6,0,7,4,17
9/22/1995,4,0,3,12,19
9/23/1995,7,0,6,4,17
9/24/1995,2,0,7,4,13
9/25/1995,7,0,5,1,13
9/26/1995,8,0,5,3,16
9/27/1995,3,0,5,10,18
9/28/1995,5,0,3,3,11
9/29/1995,4,0,7,6,17
9/30/1995,7,0,2,6,15
10/1/1995,5,0,2,7,14
10/2/1995,2,0,3,10,15
10/3/1995,4,0,3,7,14
10/4/1995,8,0,6,1,15
10/5/1995,5,0,6,0,11
10/6/1995,6,0,7,6,19
10/7/1995,6,0,4,9,19
10/8/1995,5,0,5,9,19
10/9/1995,2,0,6,6,14
10/10/1995,5,0,7,2,14
10/11/1995,4,0,3,11,18
10/12/1995,5,0,5,4,14
10/13/1995,4,0,8,10,22
10/14/1995,7,0,8,0,15
10/15/1995,3,0,2,7,12
10/16/1995,6,0,5,0,11
10/17/1995,6,0,8,12,26
10/18/1995,8,0,8,6,22
10/19/1995,6,0,4,11,21
10/20/1995,8,0,2,12,22
10/21/1995,7,0,8,2,17
10/22/1995,7,0,6,4,17
10/23/1995,5,0,4,11,20
10/24/1995,5,0,6,13,24
10/25/1995,3,0,8,9,20
10/26/1995,5,0,7,1,13
10/27/1995,5,0,7,6,18
10/28/1995,6,0,3,9,18
10/29/1995,8,0,5,9,22
10/30/1995,3,0,8,12,23
10/31/1995,3,0,5,3,11
11/1/1995,4,0,2,4,10
11/2/1995,2,0,3,5,10
11/3/1995,2,0,2,8,12
11/4/1995,3,0,3,3,9
11/5/1995,2,0,5,12,19
11/6/1995,8,0,3,4,15
11/7/1995,2,0,3,8,13
11/8/1995,2,0,8,11,21
11/9/1995,5,0,2,9,16
11/10/1995,6,0,5,3,14
11/11/1995,7,0,5,8,20
11/12/1995,7,0,2,13,22
11/13/1995,3,0,8,9,20
11/14/1995,5,0,4,3,12
11/15/1995,4,0,8,1,13
11/16/1995,8,0,3,1,12
11/17/1995,4,0,2,2,8
11/18/1995,7,0,4,8,19
11/19/1995,8,0,2,8,18
11/20/1995,2,0,5,8,15
11/21/1995,2,0,7,11,20
11/22/1995,2,0,2,8,12
11/23/1995,6,0,4,7,17
11/24/1995,5,0,5,12,22
11/25/1995,3,0,4,3,10
11/26/1995,4,0,5,12,21
11/27/1995,4,0,7,1,12
11/28/1995,5,0,8,0,13
11/29/1995,8,0,3,7,18
11/30/1995,6,0,4,11,21
12/1/1995,2,0,8,2,12
12/2/1995,6,0,6,4,16
12/3/1995,8,0,4,0,12
12/4/1995,3,0,8,3,14
12/5/1995,2,0,6,12,20
12/6/1995,2,0,8,10,20
12/7/1995,6,0,8,7,21
12/8/1995,5,0,6,3,14
12/9/1995,6,0,3,7,16
12/10/1995,2,0,5,4,11
12/11/1995,3,0,5,9,17
12/12/1995,2,0,6,10,18
12/13/1995,2,0,5,8,15
12/14/1995,4,0,3,6,13
12/15/1995,6,0,3,9,18
12/16/1995,2,0,4,12,18
12/17/1995,3,0,4,6,13
12/18/1995,3,0,8,7,18
12/19/1995,4,0,3,11,18
12/20/1995,5,0,5,13,23
12/21/1995,5,0,5,5,15
12/22/1995,3,0,5,4,12
12/23/1995,5,0,8,10,23
12/24/1995,6,0,2,1,9
12/25/1995,7,0,3,11,21
12/26/1995,7,0,2,8,17
12/27/1995,4,0,7,9,20
12/28/1995,2,0,4,9,15
12/29/1995,2,0,7,10,19
12/30/1995,6,0,6,1,13
12/31/1995,8,0,3,4,15
1/1/1996,5,0,6,5,16
1/2/1996,7,0,2,5,14
1/3/1996,5,0,8,3,16
1/4/1996,8,0,6,6,20
1/5/1996,4,0,7,3,14
1/6/1996,6,0,4,13,23
1/7/1996,6,0,6,3,15
1/8/1996,7,0,3,5,15
1/9/1996,6,0,6,5,17
1/10/1996,4,0,8,3,15
1/11/1996,6,0,8,3,17
1/12/1996,2,0,5,5,12
1/13/1996,7,0,5,6,18
1/14/1996,8,0,4,9,21
1/15/1996,7,0,7,10,24
1/16/1996,8,0,5,5,18
1/17/1996,4,0,5,7,16
1/18/1996,6,0,7,7,20
1/19/1996,6,0,8,10,24
1/20/1996,5,0,8,2,15
1/21/1996,5,0,5,0,10
1/22/1996,6,0,5,11,22
1/23/1996,4,0,2,4,10
1/24/1996,6,0,3,5,14
1/25/1996,2,0,6,10,18
1/26/1996,3,0,2,7,12
1/27/1996,3,0,5,9,17
1/28/1996,5,0,8,0,13
1/29/1996,3,0,2,6,11
1/30/1996,2,0,3,12,17
1/31/1996,8,0,2,4,14
2/1/1996,5,0,2,13,20
2/2/1996,2,0,8,2,12
2/3/1996,6,0,4,5,15
2/4/1996,8,0,4,11,23
2/5/1996,5,0,3,9,17
2/6/1996,2,0,4,4,10
2/7/1996,5,0,4,4,13
2/8/1996,2,0,6,4,12
2/9/1996,2,0,8,2,12
2/10/1996,3,0,2,6,11
2/11/1996,5,0,6,13,24
2/12/1996,3,0,3,8,14
2/13/1996,4,0,3,13,20
2/14/1996,5,0,2,2,9
2/15/1996,3,0,4,3,10
2/16/1996,4,0,7,1,12
2/17/1996,8,0,5,1,14
2/18/1996,3,0,6,6,15
2/19/1996,5,0,7,2,14
2/20/1996,5,0,3,11,19
2/21/1996,8,0,8,12,28
2/22/1996,4,0,8,9,21
2/23/1996,7,0,4,11,22
2/24/1996,7,0,4,11,22
2/25/1996,6,0,6,2,14
2/26/1996,5,0,3,2,10
2/27/1996,6,0,3,6,15
2/28/1996,2,0,3,7,12
2/29/1996,5,0,8,9,22
3/1/1996,4,0,2,13,19
3/2/1996,6,0,7,10,23
3/3/1996,4,0,8,7,19
3/4/1996,6,0,5,1,12
3/5/1996,2,0,3,0,5
3/6/1996,5,0,2,5,12
3/7/1996,8,0,5,13,26
3/8/1996,2,0,8,4,14
3/9/1996,3,0,5,1,9
3/10/1996,6,0,7,5,18
3/11/1996,6,0,3,3,12
3/12/1996,3,0,4,11,18
3/13/1996,5,0,3,9,17
3/14/1996,3,0,5,8,16
3/15/1996,8,0,6,5,19
3/16/1996,7,0,7,0,14
3/17/1996,2,0,8,10,20
3/18/1996,6,0,2,12,20
3/19/1996,7,0,3,8,18
3/20/1996,6,0,8,4,18
3/21/1996,3,0,4,13,20
3/22/1996,6,0,7,0,13
3/23/1996,3,0,4,6,13
3/24/1996,2,0,2,8,12
3/25/1996,3,0,6,10,19
3/26/1996,4,0,5,0,9
3/27/1996,6,0,2,2,10
3/28/1996,8,0,8,7,23
3/29/1996,6,0,8,3,17
3/30/1996,5,0,2,0,7
3/31/1996,3,0,4,8,15
4/1/1996,5,0,5,1,11
4/2/1996,8,0,8,6,22
4/3/1996,4,0,7,10,21
4/4/1996,3,0,6,4,13
4/5/1996,6,0,4,11,21
4/6/1996,8,0,7,13,28
4/7/1996,6,0,8,13,27
4/8/1996,3,0,5,8,16
4/9/1996,8,0,6,2,16
4/10/1996,6,0,6,8,20
4/11/1996,2,0,8,11,21
4/12/1996,8,0,4,2,14
4/13/1996,6,0,2,4,12
4/14/1996,2,0,6,3,11
4/15/1996,8,0,7,4,19
4/16/1996,2,0,3,0,5
4/17/1996,5,0,8,10,23
4/18/1996,4,0,3,6,13
4/19/1996,8,0,2,10,20
4/20/1996,4,0,4,4,12
4/21/1996,7,0,6,12,25
4/22/1996,7,0,8,3,18
4/23/1996,4,0,2,6,12
4/24/1996,6,0,8,9,23
4/25/1996,4,0,3,6,13
4/26/1996,5,0,3,1,9
4/27/1996,6,0,7,3,16
4/28/1996,5,0,2,11,18
4/29/1996,3,0,2,6,11
4/30/1996,3,0,5,6,14
5/1/1996,4,0,7,1,12
5/2/1996,4,0,6,0,10
5/3/1996,8,0,8,3,19
5/4/1996,3,0,8,0,11
5/5/1996,6,0,7,5,18
5/6/1996,2,0,3,9,14
5/7/1996,3,0,8,6,17
5/8/1996,2,0,4,2,8
5/9/1996,6,0,5,1,12
5/10/1996,4,0,4,6,14
5/11/1996,7,0,2,8,17
5/12/1996,3,0,3,5,11
5/13/1996,4,0,8,8,20
5/14/1996,7,0,3,11,21
5/15/1996,5,0,4,11,20
5/16/1996,3,0,5,11,19
5/17/1996,8,0,2,5,15
5/18/1996,3,0,4,3,10
5/19/1996,8,0,7,9,24
5/20/1996,3,0,8,5,16
5/21/1996,4,0,2,4,10
5/22/1996,5,0,6,6,17
5/23/1996,7,0,2,9,18
5/24/1996,7,0,7,13,27
5/25/1996,5,0,8,7,20
5/26/1996,2,0,5,4,11
5/27/1996,4,0,7,8,19
5/28/1996,8,0,7,10,25
5/29/1996,2,0,7,5,14
5/30/1996,5,0,3,3,11
5/31/1996,2,0,2,8,12
6/1/1996,5,0,7,5,17
6/2/1996,7,0,6,11,24
6/3/1996,8,0,8,12,28
6/4/1996,8,0,6,10,24
6/5/1996,4,0,2,5,11
6/6/1996,7,0,7,0,14
6/7/1996,5,0,8,10,23
6/8/1996,5,0,3,6,14
6/9/1996,6,0,8,4,18
6/10/1996,8,0,3,0,11
6/11/1996,8,0,8,8,24
6/12/1996,8,0,6,7,21
6/13/1996,4,0,3,7,14
6/14/1996,3,0,4,2,9
6/15/1996,7,0,3,8,18
6/16/1996,4,0,6,9,19
6/17/1996,2,0,7,10,19
6/18/1996,4,0,4,0,8
6/19/1996,7,0,6,2,15
6/20/1996,3,0,6,6,15
6/21/1996,6,0,3,5,14
6/22/1996,6,0,7,8,21
6/23/1996,4,0,4,6,14
6/24/1996,4,0,6,2,12
6/25/1996,2,0,3,3,8
6/26/1996,5,0,8,2,15
6/27/1996,3,0,5,0,8
6/28/1996,5,0,5,13,23
6/29/1996,3,0,8,2,13
6/30/1996,6,0,5,11,22
7/1/1996,2,0,3,6,11
7/2/1996,6,0,5,7,18
7/3/1996,8,0,3,3,14
7/4/1996,4,0,2,6,12
7/5/1996,6,0,3,6,15
7/6/1996,8,0,5,6,19
7/7/1996,5,0,8,2,15
7/8/1996,5,0,2,3,10
7/9/1996,8,0,5,1,14
7/10/1996,3,0,7,6,16
7/11/1996,4,0,6,11,21
7/12/1996,4,0,7,9,20
7/13/1996,3,0,7,5,15
7/14/1996,8,0,2,2,12
7/15/1996,3,0,3,1,7
7/16/1996,4,0,4,8,16
7/17/1996,5,0,7,9,21
7/18/1996,5,0,4,10,19
7/19/1996,5,0,7,1,13
7/20/1996,5,0,8,13,26
7/21/1996,5,0,4,6,15
7/22/1996,5,0,8,7,20
7/23/1996,8,0,2,1,11
7/24/1996,8,0,2,10,20
7/25/1996,5,0,8,10,23
7/26/1996,6,0,6,3,15
7/27/1996,8,0,8,13,29
7/28/1996,5,0,4,4,13
7/29/1996,5,0,4,3,12
7/30/1996,5,0,8,6,19
7/31/1996,8,0,6,5,19
8/1/1996,4,0,2,1,7
8/2/1996,4,0,6,7,17
8/3/1996,2,0,2,2,6
8/4/1996,3,0,8,3,14
8/5/1996,4,0,3,3,10
8/6/1996,2,0,5,7,14
8/7/1996,7,0,4,6,17
8/8/1996,5,0,6,12,23
8/9/1996,3,0,8,7,18
8/10/1996,4,0,7,6,17
8/11/1996,7,0,6,3,16
8/12/1996,5,0,2,13,20
8/13/1996,3,0,7,8,18
8/14/1996,7,0,3,5,15
8/15/1996,7,0,7,12,26
8/16/1996,6,0,4,2,12
8/17/1996,4,0,7,9,20
8/18/1996,3,0,5,13,21
8/19/1996,5,0,7,2,14
8/20/1996,6,0,4,4,14
8/21/1996,2,0,3,7,12
8/22/1996,7,0,6,10,23
8/23/1996,7,0,2,4,13
8/24/1996,6,0,8,8,22
8/25/1996,2,0,7,2,11
8/26/1996,2,0,5,1,8
8/27/1996,2,0,7,7,16
8/28/1996,6,0,2,11,19
8/29/1996,4,0,4,6,14
8/30/1996,6,0,5,11,22
8/31/1996,8,0,7,5,20
9/1/1996,6,0,2,6,14
9/2/1996,2,0,5,11,18
9/3/1996,6,0,5,9,20
9/4/1996,3,0,8,4,15
9/5/1996,5,0,7,10,22
9/6/1996,7,0,4,10,21
9/7/1996,4,0,4,8,16
9/8/1996,8,0,5,5,18
9/9/1996,2,0,4,11,17
9/10/1996,4,0,7,9,20
9/11/1996,4,0,3,12,19
9/12/1996,7,0,3,11,21
9/13/1996,5,0,5,6,16
9/14/1996,3,0,6,2,11
9/15/1996,4,0,2,4,10
9/16/1996,7,0,5,7,19
9/17/1996,8,0,2,10,20
9/18/1996,2,0,2,13,17
9/19/1996,4,0,6,3,13
9/20/1996,6,0,8,11,25
9/21/1996,4,0,5,8,17
9/22/1996,7,0,5,11,23
9/23/1996,5,0,5,9,19
9/24/1996,7,0,5,1,13
9/25/1996,4,0,3,7,14
9/26/1996,5,0,7,10,22
9/27/1996,6,0,4,5,15
9/28/1996,7,0,8,9,24
9/29/1996,2,0,8,1,11
9/30/1996,3,0,7,1,11
10/1/1996,2,0,6,2,10
10/2/1996,7,0,8,5,20
10/3/1996,4,0,4,13,21
10/4/1996,7,0,7,8,22
10/5/1996,7,0,4,10,21
10/6/1996,7,0,6,4,17
10/7/1996,7,0,3,5,15
10/8/1996,8,0,5,8,21
10/9/1996,6,0,8,9,23
10/10/1996,2,0,2,12,16
10/11/1996,8,0,5,9,22
10/12/1996,5,0,4,5,14
10/13/1996,8,0,4,4,16
10/14/1996,6,0,7,2,15
10/15/1996,2,0,6,9,17
10/16/1996,2,0,7,5,14
10/17/1996,3,0,4,5,12
10/18/1996,6,0,4,2,12
10/19/1996,4,0,7,5,16
10/20/1996,5,0,5,2,12
10/21/1996,2,0,6,4,12
10/22/1996,6,0,7,6,19
10/23/1996,4,0,2,3,9
10/24/1996,5,0,2,8,15
10/25/1996,3,0,2,1,6
10/26/1996,7,0,3,13,23
10/27/1996,5,0,7,7,19
10/28/1996,3,0,8,9,20
10/29/1996,8,0,3,1,12
10/30/1996,4,0,3,1,8
10/31/1996,3,0,2,0,5
11/1/1996,2,0,2,12,16
11/2/1996,2,0,7,12,21
11/3/1996,6,0,4,0,10
11/4/1996,2,0,3,4,9
11/5/1996,8,0,4,6,18
11/6/1996,6,0,6,7,19
11/7/1996,3,0,7,7,17
11/8/1996,2,0,7,0,9
11/9/1996,2,0,2,0,4
11/10/1996,7,0,7,2,16
11/11/1996,2,0,5,0,7
11/12/1996,4,0,8,12,24
11/13/1996,6,0,8,8,22
11/14/1996,6,0,3,7,16
11/15/1996,6,0,8,8,22
11/16/1996,6,0,5,13,24
11/17/1996,8,0,5,10,23
11/18/1996,3,0,2,12,17
11/19/1996,8,0,2,6,16
11/20/1996,6,0,4,10,20
11/21/1996,2,0,8,1,11
11/22/1996,3,0,6,13,22
11/23/1996,4,0,8,4,16
11/24/1996,2,0,3,10,15
11/25/1996,8,0,3,9,20
11/26/1996,3,0,5,6,14
11/27/1996,6,0,5,2,13
11/28/1996,3,0,3,9,15
11/29/1996,2,0,2,7,11
11/30/1996,6,0,8,4,18
12/1/1996,3,0,4,9,16
12/2/1996,8,0,2,3,13
12/3/1996,6,0,6,4,16
12/4/1996,3,0,6,2,11
12/5/1996,8,0,7,4,19
12/6/1996,8,0,4,7,19
12/7/1996,2,0,5,3,10
12/8/1996,8,0,7,12,27
12/9/1996,4,0,4,1,9
12/10/1996,5,0,5,11,21
12/11/1996,8,0,4,13,25
12/12/1996,2,0,6,7,15
12/13/1996,6,0,6,0,12
12/14/1996,2,0,3,11,16
12/15/1996,5,0,8,7,20
12/16/1996,2,0,4,1,7
12/17/1996,2,0,7,9,18
12/18/1996,3,0,2,9,14
12/19/1996,4,0,7,4,15
12/20/1996,4,0,7,3,14
12/21/1996,3,0,3,6,12
12/22/1996,5,0,7,6,18
12/23/1996,8,0,7,12,27
12/24/1996,3,0,7,0,10
12/25/1996,7,0,2,0,9
12/26/1996,4,0,5,2,11
12/27/1996,6,0,3,8,17
12/28/1996,3,0,2,2,7
12/29/1996,8,0,6,7,21
12/30/1996,2,0,3,13,18
12/31/1996,4,0,6,11,21
1/1/1997,7,0,3,11,21
1/2/1997,2,0,4,13,19
1/3/1997,3,0,5,2,10
1/4/1997,3,0,4,12,19
1/5/1997,4,0,5,7,16
1/6/1997,2,0,2,8,12
1/7/1997,2,0,5,11,18
1/8/1997,6,0,3,7,16
1/9/1997,8,0,4,12,24
1/10/1997,2,0,3,13,18
1/11/1997,3,0,8,3,14
1/12/1997,6,0,5,6,17
1/13/1997,6,0,6,2,14
1/14/1997,2,0,4,1,7
1/15/1997,7,0,3,1,11
1/16/1997,5,0,6,3,14
1/17/1997,5,0,8,12,25
1/18/1997,2,0,2,10,14
1/19/1997,5,0,7,12,24
1/20/1997,6,0,6,7,19
1/21/1997,2,0,5,3,10
1/22/1997,5,0,4,7,16
1/23/1997,2,0,2,12,16
1/24/1997,7,0,6,5,18
1/25/1997,3,0,7,9,19
1/26/1997,5,0,7,7,19
1/27/1997,5,0,3,0,8
1/28/1997,8,0,4,13,25
1/29/1997,6,0,2,10,18
1/30/1997,3,0,3,6,12
1/31/1997,4,0,3,6,13
2/1/1997,8,0,7,4,19
2/2/1997,2,0,6,5,13
2/3/1997,4,0,5,7,16
2/4/1997,4,0,8,10,22
2/5/1997,5,0,8,1,14
2/6/1997,7,0,7,11,25
2/7/1997,7,0,6,4,17
2/8/1997,3,0,3,8,14
2/9/1997,5,0,3,13,21
2/10/1997,8,0,2,0,10
2/11/1997,2,0,2,3,7
2/12/1997,7,0,5,10,22
2/13/1997,4,0,2,4,10
2/14/1997,3,0,2,4,9
2/15/1997,5,0,5,2,12
2/16/1997,8,0,7,5,20
2/17/1997,4,0,5,8,17
2/18/1997,4,0,4,11,19
2/19/1997,3,0,7,4,14
2/20/1997,7,0,5,8,20
2/21/1997,2,0,5,0,7
2/22/1997,8,0,7,4,19
2/23/1997,6,0,8,9,23
2/24/1997,3,0,2,7,12
2/25/1997,2,0,7,12,21
2/26/1997,5,0,7,9,21
2/27/1997,4,0,6,5,15
2/28/1997,3,0,4,12,19
3/1/1997,6,0,3,7,16
3/2/1997,8,0,2,3,13
3/3/1997,3,0,2,11,16
3/4/1997,4,0,6,7,17
3/5/1997,3,0,5,1,9
3/6/1997,3,0,7,1,11
3/7/1997,5,0,8,7,20
3/8/1997,8,0,7,7,22
3/9/1997,6,0,4,10,20
3/10/1997,5,0,7,12,24
3/11/1997,6,0,4,9,19
3/12/1997,8,0,7,5,20
3/13/1997,4,0,5,5,14
3/14/1997,4,0,7,11,22
3/15/1997,3,0,8,11,22
3/16/1997,3,0,6,11,20
3/17/1997,7,0,3,11,21
3/18/1997,2,0,8,1,11
3/19/1997,4,0,8,0,12
3/20/1997,4,0,6,11,21
3/21/1997,8,0,5,12,25
3/22/1997,5,0,7,13,25
3/23/1997,2,0,8,12,22
3/24/1997,5,0,3,13,21
3/25/1997,6,0,4,3,13
3/26/1997,4,0,6,2,12
3/27/1997,6,0,7,11,24
3/28/1997,3,0,3,9,15
3/29/1997,3,0,3,1,7
3/30/1997,2,0,5,13,20
3/31/1997,6,0,6,9,21
4/1/1997,6,0,2,6,14
4/2/1997,8,0,3,6,17
4/3/1997,6,0,7,11,24
4/4/1997,2,0,6,0,8
4/5/1997,2,0,6,13,21
4/6/1997,8,0,2,13,23
4/7/1997,2,0,5,13,20
4/8/1997,2,0,8,8,18
4/9/1997,7,0,4,6,17
4/10/1997,4,0,5,6,15
4/11/1997,8,0,8,5,21
4/12/1997,4,0,6,7,17
4/13/1997,2,0,4,13,19
4/14/1997,3,0,7,9,19
4/15/1997,4,0,5,12,21
4/16/1997,2,0,5,6,13
4/17/1997,2,0,3,4,9
4/18/1997,6,0,4,11,21
4/19/1997,2,0,8,13,23
4/20/1997,4,0,4,11,19
4/21/1997,5,0,4,5,14
4/22/1997,4,0,4,2,10
4/23/1997,2,0,3,6,11
4/24/1997,6,0,8,7,21
4/25/1997,2,0,7,4,13
4/26/1997,2,0,2,8,12
4/27/1997,4,0,8,0,12
4/28/1997,7,0,3,10,20
4/29/1997,5,0,8,13,26
4/30/1997,7,0,5,13,25
5/1/1997,2,0,8,1,11
5/2/1997,2,0,6,2,10
5/3/1997,5,0,5,6,16
5/4/1997,7,0,4,2,13
5/5/1997,5,0,7,6,18
5/6/1997,4,0,2,11,17
5/7/1997,7,0,4,13,24
5/8/1997,3,0,5,9,17
5/9/1997,4,0,8,12,24
5/10/1997,3,0,4,1,8
5/11/1997,5,0,3,0,8
5/12/1997,3,0,8,6,17
5/13/1997,2,0,5,4,11
5/14/1997,8,0,2,2,12
5/15/1997,8,0,4,7,19
5/16/1997,7,0,6,5,18
5/17/1997,3,0,2,11,16
5/18/1997,3,0,7,12,22
5/19/1997,4,0,4,1,9
5/20/1997,5,0,2,4,11
5/21/1997,8,0,4,13,25
5/22/1997,5,0,8,12,25
5/23/1997,6,0,6,11,23
5/24/1997,4,0,2,3,9
5/25/1997,2,0,4,11,17
5/26/1997,3,0,5,9,17
5/27/1997,3,0,3,7,13
5/28/1997,7,0,6,11,24
5/29/1997,4,0,8,13,25
5/30/1997,6,0,7,13,26
5/31/1997,2,0,6,10,18
6/1/1997,6,0,4,11,21
6/2/1997,2,0,5,5,12
6/3/1997,2,0,2,6,10
6/4/1997,4,0,4,5,13
6/5/1997,2,0,4,1,7
6/6/1997,5,0,5,4,14
6/7/1997,7,0,8,6,21
6/8/1997,7,0,3,5,15
6/9/1997,5,0,3,1,9
6/10/1997,4,0,7,12,23
6/11/1997,5,0,2,12,19
6/12/1997,3,0,6,10,19
6/13/1997,4,0,3,2,9
6/14/1997,3,0,3,10,16
6/15/1997,2,0,4,1,7
6/16/1997,8,0,6,11,25
6/17/1997,2,0,3,0,5
6/18/1997,7,0,7,5,19
6/19/1997,6,0,3,13,22
6/20/1997,2,0,2,10,14
6/21/1997,5,0,7,8,20
6/22/1997,8,0,3,9,20
6/23/1997,4,0,6,11,21
6/24/1997,5,0,8,7,20
6/25/1997,8,0,5,7,20
6/26/1997,2,0,6,2,10
6/27/1997,5,0,3,0,8
6/28/1997,4,0,4,12,20
6/29/1997,5,0,4,3,12
6/30/1997,5,0,5,6,16
7/1/1997,8,0,3,6,17
7/2/1997,6,0,5,10,21
7/3/1997,6,0,6,9,21
7/4/1997,6,0,4,2,12
7/5/1997,2,0,7,0,9
7/6/1997,6,0,8,0,14
7/7/1997,8,0,3,11,22
7/8/1997,2,0,7,6,15
7/9/1997,7,0,8,1,16
7/10/1997,8,0,8,12,28
7/11/1997,6,0,8,6,20
7/12/1997,2,0,4,6,12
7/13/1997,2,0,2,13,17
7/14/1997,2,0,2,2,6
7/15/1997,2,0,8,4,14
7/16/1997,8,0,5,9,22
7/17/1997,5,0,6,7,18
7/18/1997,6,0,6,3,15
7/19/1997,4,0,5,5,14
7/20/1997,5,0,4,10,19
7/21/1997,8,0,8,0,16
7/22/1997,5,0,6,5,16
7/23/1997,5,0,2,6,13
7/24/1997,5,0,8,11,24
7/25/1997,2,0,6,1,9
7/26/1997,7,0,8,10,25
7/27/1997,7,0,6,12,25
7/28/1997,4,0,5,2,11
7/29/1997,2,0,4,1,7
7/30/1997,7,0,7,1,15
7/31/1997,6,0,7,7,20
8/1/1997,8,0,7,3,18
8/2/1997,4,0,7,4,15
8/3/1997,2,0,5,12,19
8/4/1997,2,0,5,11,18
8/5/1997,6,0,5,8,19
8/6/1997,2,0,2,1,5
8/7/1997,8,0,5,9,22
8/8/1997,8,0,2,7,17
8/9/1997,8,0,4,1,13
8/10/1997,7,0,5,7,19
8/11/1997,2,0,8,1,11
8/12/1997,8,0,2,13,23
8/13/1997,5,0,5,3,13
8/14/1997,8,0,5,5,18
8/15/1997,8,0,4,2,14
8/16/1997,4,0,8,8,20
8/17/1997,6,0,5,5,16
8/18/1997,6,0,6,7,19
8/19/1997,8,0,8,11,27
8/20/1997,2,0,6,7,15
8/21/1997,2,0,7,11,20
8/22/1997,5,0,3,12,20
8/23/1997,8,0,5,8,21
8/24/1997,3,0,8,10,21
8/25/1997,4,0,7,0,11
8/26/1997,6,0,7,8,21
8/27/1997,2,0,2,7,11
8/28/1997,8,0,3,10,21
8/29/1997,7,0,7,12,26
8/30/1997,8,0,5,8,21
8/31/1997,5,0,2,1,8
9/1/1997,4,0,4,6,14
9/2/1997,7,0,6,3,16
9/3/1997,4,0,8,7,19
9/4/1997,6,0,5,13,24
9/5/1997,5,0,2,8,15
9/6/1997,5,0,7,11,23
9/7/1997,5,0,3,2,10
9/8/1997,5,0,8,2,15
9/9/1997,4,0,8,6,18
9/10/1997,7,0,4,1,12
9/11/1997,6,0,4,5,15
9/12/1997,4,0,3,8,15
9/13/1997,5,0,5,6,16
9/14/1997,6,0,5,0,11
9/15/1997,6,0,7,13,26
9/16/1997,6,0,7,0,13
9/17/1997,3,0,8,6,17
9/18/1997,7,0,4,6,17
9/19/1997,7,0,2,11,20
9/20/1997,2,0,6,6,14
9/21/1997,5,0,2,5,12
9/22/1997,5,0,5,3,13
9/23/1997,8,0,7,9,24
9/24/1997,2,0,6,0,8
9/25/1997,7,0,2,9,18
9/26/1997,4,0,2,6,12
9/27/1997,5,0,3,1,9
9/28/1997,7,0,4,10,21
9/29/1997,7,0,2,11,20
9/30/1997,2,0,4,4,10
10/1/1997,3,0,3,3,9
10/2/1997,2,0,4,7,13
10/3/1997,5,0,3,13,21
10/4/1997,5,0,5,3,13
10/5/1997,4,0,6,11,21
10/6/1997,2,0,8,2,12
10/7/1997,7,0,4,5,16
10/8/1997,3,0,2,6,11
10/9/1997,8,0,7,12,27
10/10/1997,3,0,6,4,13
10/11/1997,3,0,8,0,11
10/12/1997,4,0,4,11,19
10/13/1997,5,0,7,11,23
10/14/1997,2,0,5,13,20
10/15/1997,6,0,5,0,11
10/16/1997,3,0,3,13,19
10/17/1997,2,0,8,5,15
10/18/1997,3,0,6,8,17
10/19/1997,2,0,7,4,13
10/20/1997,8,0,3,9,20
10/21/1997,8,0,2,6,16
10/22/1997,3,0,2,1,6
10/23/1997,7,0,3,13,23
10/24/1997,8,0,2,13,23
10/25/1997,2,0,4,7,13
10/26/1997,5,0,2,3,10
10/27/1997,4,0,4,11,19
10/28/1997,2,0,4,1,7
10/29/1997,2,0,6,0,8
10/30/1997,7,0,8,6,21
10/31/1997,6,0,4,5,15
11/1/1997,6,0,8,6,20
11/2/1997,2,0,6,11,19
11/3/1997,8,0,8,7,23
11/4/1997,4,0,8,3,15
11/5/1997,4,0,3,7,14
11/6/1997,8,0,4,6,18
11/7/1997,3,0,7,2,12
11/8/1997,2,0,6,4,12
11/9/1997,5,0,5,4,14
11/10/1997,3,0,2,8,13
11/11/1997,8,0,5,11,24
11/12/1997,3,0,7,3,13
11/13/1997,8,0,3,10,21
11/14/1997,4,0,6,12,22
11/15/1997,6,0,2,4,12
11/16/1997,8,0,2,12,22
11/17/1997,5,0,4,12,21
11/18/1997,7,0,2,7,16
11/19/1997,6,0,2,11,19
11/20/1997,3,0,7,9,19
11/21/1997,8,0,2,5,15
11/22/1997,5,0,6,8,19
11/23/1997,8,0,3,10,21
11/24/1997,2,0,2,7,11
11/25/1997,8,0,5,4,17
11/26/1997,3,0,6,13,22
11/27/1997,8,0,8,2,18
11/28/1997,6,0,8,13,27
11/29/1997,4,0,5,11,20
11/30/1997,5,0,3,12,20
12/1/1997,3,0,8,5,16
12/2/1997,8,0,8,0,16
12/3/1997,8,0,4,10,22
12/4/1997,7,0,5,12,24
12/5/1997,3,0,2,13,18
12/6/1997,5,0,2,4,11
12/7/1997,4,0,4,10,18
12/8/1997,3,0,2,1,6
12/9/1997,7,0,3,9,19
12/10/1997,6,0,8,9,23
12/11/1997,6,0,7,7,20
12/12/1997,5,0,2,10,17
12/13/1997,3,0,3,2,8
12/14/1997,5,0,3,0,8
12/15/1997,6,0,7,5,18
12/16/1997,4,0,7,9,20
12/17/1997,8,0,3,6,17
12/18/1997,6,0,2,1,9
12/19/1997,4,0,2,11,17
12/20/1997,3,0,3,3,9
12/21/1997,4,0,8,8,20
12/22/1997,2,0,4,12,18
12/23/1997,2,0,5,11,18
12/24/1997,6,0,6,8,20
12/25/1997,7,0,3,5,15
12/26/1997,5,0,8,12,25
12/27/1997,6,0,6,7,19
12/28/1997,5,0,2,2,9
12/29/1997,6,0,4,7,17
12/30/1997,4,0,7,5,16
12/31/1997,2,0,4,13,19
1/1/1998,6,0,6,1,13
1/2/1998,4,0,5,12,21
1/3/1998,8,0,5,6,19
1/4/1998,3,0,8,0,11
1/5/1998,2,0,2,0,4
1/6/1998,2,0,5,7,14
1/7/1998,8,0,5,11,24
1/8/1998,6,0,5,13,24
1/9/1998,6,0,2,5,13
1/10/1998,7,0,7,11,25
1/11/1998,8,0,3,0,11
1/12/1998,8,0,5,13,26
1/13/1998,6,0,5,11,22
1/14/1998,7,0,3,0,10
1/15/1998,7,0,6,2,15
1/16/1998,2,0,7,10,19
1/17/1998,4,0,4,2,10
1/18/1998,5,0,7,13,25
1/19/1998,4,0,6,11,21
1/20/1998,8,0,6,3,17
1/21/1998,8,0,7,0,15
1/22/1998,3,0,2,11,16
1/23/1998,6,0,2,3,11
1/24/1998,3,0,6,7,16
1/25/1998,2,0,6,13,21
1/26/1998,8,0,3,4,15
1/27/1998,2,0,5,6,13
1/28/1998,6,0,7,0,13
1/29/1998,7,0,2,4,13
1/30/1998,5,0,7,7,19
1/31/1998,5,0,6,8,19
2/1/1998,2,0,7,9,18
2/2/1998,8,0,3,4,15
2/3/1998,7,0,8,7,22
2/4/1998,2,0,6,13,21
2/5/1998,2,0,5,1,8
2/6/1998,3,0,6,6,15
2/7/1998,7,0,8,9,24
2/8/1998,7,0,3,6,16
2/9/1998,6,0,2,8,16
2/10/1998,2,0,7,2,11
2/11/1998,6,0,5,1,12
2/12/1998,5,0,5,11,21
2/13/1998,2,0,4,4,10
2/14/1998,3,0,7,8,18
2/15/1998,5,0,6,8,19
2/16/1998,8,0,2,0,10
2/17/1998,7,0,3,11,21
2/18/1998,2,0,8,7,17
2/19/1998,8,0,7,13,28
2/20/1998,8,0,3,12,23
2/21/1998,2,0,5,10,17
2/22/1998,4,0,5,10,19
2/23/1998,2,0,8,2,12
2/24/1998,8,0,8,12,28
2/25/1998,6,0,8,2,16
2/26/1998,8,0,3,5,16
2/27/1998,5,0,5,12,22
2/28/1998,3,0,6,1,10
3/1/1998,6,0,5,6,17
3/2/1998,4,0,4,9,17
3/3/1998,5,0,8,6,19
3/4/1998,2,0,7,4,13
3/5/1998,2,0,8,5,15
3/6/1998,8,0,3,2,13
3/7/1998,6,0,2,4,12
3/8/1998,2,0,2,10,14
3/9/1998,3,0,8,13,24
3/10/1998,5,0,6,11,22
3/11/1998,4,0,3,12,19
3/12/1998,4,0,8,4,16
3/13/1998,2,0,5,3,10
3/14/1998,3,0,4,4,11
3/15/1998,6,0,8,11,25
3/16/1998,7,0,7,9,23
3/17/1998,4,0,6,9,19
3/18/1998,5,0,7,8,20
3/19/1998,7,0,4,9,20
3/20/1998,2,0,7,12,21
3/21/1998,7,0,7,10,24
3/22/1998,7,0,5,4,16
3/23/1998,4,0,4,10,18
3/24/1998,7,0,8,2,17
3/25/1998,4,0,6,11,21
3/26/1998,4,0,6,9,19
3/27/1998,3,0,7,0,10
3/28/1998,8,0,7,5,20
3/29/1998,4,0,8,6,18
3/30/1998,5,0,2,8,15
3/31/1998,4,0,5,9,18
4/1/1998,5,0,2,5,12
4/2/1998,2,0,5,0,7
4/3/1998,7,0,5,8,20
4/4/1998,6,0,6,5,17
4/5/1998,3,0,2,4,9
4/6/1998,7,0,8,3,18
4/7/1998,4,0,6,10,20
4/8/1998,2,0,3,12,17
4/9/1998,5,0,5,1,11
4/10/1998,3,0,2,11,16
4/11/1998,6,0,5,12,23
4/12/1998,7,0,7,6,20
4/13/1998,5,0,2,1,8
4/14/1998,6,0,4,8,18
4/15/1998,8,0,2,8,18
4/16/1998,5,0,6,9,20
4/17/1998,4,0,5,11,20
4/18/1998,6,0,7,7,20
4/19/1998,4,0,2,8,14
4/20/1998,6,0,4,5,15
4/21/1998,7,0,4,10,21
4/22/1998,8,0,7,3,18
4/23/1998,3,0,8,8,19
4/24/1998,8,0,2,3,13
4/25/1998,8,0,3,0,11
4/26/1998,2,0,4,4,10
4/27/1998,7,0,8,5,20
4/28/1998,3,0,2,12,17
4/29/1998,2,0,8,9,19
4/30/1998,8,0,8,0,16
5/1/1998,4,0,7,8,19
5/2/1998,4,0,4,2,10
5/3/1998,2,0,7,0,9
5/4/1998,7,0,3,3,13
5/5/1998,8,0,5,0,13
5/6/1998,5,0,7,8,20
5/7/1998,4,0,2,13,19
5/8/1998,3,0,7,9,19
5/9/1998,8,0,7,4,19
5/10/1998,6,0,7,8,21
5/11/1998,5,0,2,9,16
5/12/1998,5,0,3,4,12
5/13/1998,3,0,7,12,22
5/14/1998,3,0,2,9,14
5/15/1998,5,0,2,11,18
5/16/1998,6,0,6,9,21
5/17/1998,5,0,7,11,23
5/18/1998,3,0,8,12,23
5/19/1998,8,0,3,9,20
5/20/1998,2,0,2,9,13
5/21/1998,3,0,4,0,7
5/22/1998,3,0,7,9,19
5/23/1998,7,0,6,6,19
5/24/1998,5,0,4,3,12
5/25/1998,8,0,6,1,15
5/26/1998,4,0,6,10,20
5/27/1998,8,0,7,9,24
5/28/1998,2,0,2,4,8
5/29/1998,7,0,3,9,19
5/30/1998,8,0,5,7,20
5/31/1998,5,0,2,5,12
6/1/1998,8,0,4,6,18
6/2/1998,3,0,6,13,22
6/3/1998,4,0,5,3,12
6/4/1998,5,0,7,4,16
6/5/1998,5,0,6,1,12
6/6/1998,5,0,8,4,17
6/7/1998,7,0,3,6,16
6/8/1998,5,0,3,1,9
6/9/1998,2,0,6,5,13
6/10/1998,6,0,6,13,25
6/11/1998,5,0,3,0,8
6/12/1998,4,0,8,6,18
6/13/1998,2,0,4,1,7
6/14/1998,2,0,4,9,15
6/15/1998,5,0,5,6,16
6/16/1998,3,0,8,5,16
6/17/1998,5,0,6,10,21
6/18/1998,3,0,5,13,21
6/19/1998,7,0,4,13,24
6/20/1998,7,0,3,3,13
6/21/1998,3,0,8,5,16
6/22/1998,8,0,5,12,25
6/23/1998,8,0,2,2,12
6/24/1998,6,0,8,10,24
6/25/1998,7,0,3,2,12
6/26/1998,5,0,3,4,12
6/27/1998,7,0,7,8,22
6/28/1998,2,0,8,11,21
6/29/1998,5,0,7,9,21
6/30/1998,4,0,6,6,16
7/1/1998,3,0,5,7,15
7/2/1998,5,0,7,10,22
7/3/1998,7,0,4,1,12
7/4/1998,7,0,3,0,10
7/5/1998,2,0,7,0,9
7/6/1998,4,0,3,13,20
7/7/1998,5,0,3,2,10
7/8/1998,3,0,7,13,23
7/9/1998,8,0,4,7,19
7/10/1998,7,0,5,12,24
7/11/1998,2,0,5,13,20
7/12/1998,8,0,6,12,26
7/13/1998,8,0,3,12,23
7/14/1998,7,0,4,2,13
7/15/1998,3,0,7,0,10
7/16/1998,3,0,7,10,20
7/17/1998,4,0,6,0,10
7/18/1998,7,0,4,3,14
7/19/1998,4,0,2,0,6
7/20/1998,8,0,2,8,18
7/21/1998,4,0,5,6,15
7/22/1998,8,0,8,8,24
7/23/1998,4,0,7,0,11
7/24/1998,5,0,7,11,23
7/25/1998,6,0,6,9,21
7/26/1998,4,0,2,5,11
7/27/1998,5,0,7,7,19
7/28/1998,5,0,6,1,12
7/29/1998,8,0,7,1,16
7/30/1998,7,0,6,8,21
7/31/1998,8,0,4,0,12
8/1/1998,5,0,6,6,17
8/2/1998,3,0,6,0,9
8/3/1998,4,0,6,13,23
8/4/1998,3,0,4,8,15
8/5/1998,4,0,2,4,10
8/6/1998,2,0,3,1,6
8/7/1998,3,0,2,2,7
8/8/1998,3,0,6,10,19
8/9/1998,5,0,4,10,19
8/10/1998,5,0,3,12,20
8/11/1998,3,0,7,7,17
8/12/1998,8,0,3,3,14
8/13/1998,8,0,2,11,21
8/14/1998,2,0,2,5,9
8/15/1998,3,0,3,2,8
8/16/1998,7,0,2,2,11
8/17/1998,8,0,2,1,11
8/18/1998,5,0,6,0,11
8/19/1998,7,0,2,4,13
8/20/1998,2,0,2,9,13
8/21/1998,7,0,6,3,16
8/22/1998,4,0,7,6,17
8/23/1998,3,0,4,3,10
8/24/1998,6,0,8,9,23
8/25/1998,3,0,7,6,16
8/26/1998,5,0,3,8,16
8/27/1998,6,0,3,10,19
8/28/1998,4,0,7,1,12
8/29/1998,4,0,3,5,12
8/30/1998,2,0,4,13,19
8/31/1998,4,0,6,0,10
9/1/1998,2,0,8,6,16
9/2/1998,5,0,2,9,16
9/3/1998,2,0,6,11,19
9/4/1998,6,0,7,9,22
9/5/1998,7,0,3,2,12
9/6/1998,2,0,7,1,10
9/7/1998,8,0,3,9,20
9/8/1998,6,0,2,7,15
9/9/1998,4,0,3,13,20
9/10/1998,4,0,5,7,16
9/11/1998,2,0,2,1,5
9/12/1998,3,0,2,13,18
9/13/1998,5,0,3,5,13
9/14/1998,8,0,7,2,17
9/15/1998,3,0,4,13,20
9/16/1998,6,0,4,1,11
9/17/1998,5,0,3,10,18
9/18/1998,2,0,5,6,13
9/19/1998,2,0,2,3,7
9/20/1998,3,0,2,10,15
9/21/1998,3,0,3,3,9
9/22/1998,3,0,6,9,18
9/23/1998,6,0,3,6,15
9/24/1998,7,0,4,8,19
9/25/1998,3,0,2,10,15
9/26/1998,3,0,7,4,14
9/27/1998,2,0,5,2,9
9/28/1998,5,0,7,3,15
9/29/1998,6,0,2,10,18
9/30/1998,6,0,4,3,13
10/1/1998,4,0,3,5,12
10/2/1998,3,0,7,12,22
10/3/1998,5,0,6,9,20
10/4/1998,7,0,8,8,23
10/5/1998,7,0,8,9,24
10/6/1998,4,0,6,8,18
10/7/1998,2,0,4,9,15
10/8/1998,5,0,5,4,14
10/9/1998,5,0,6,4,15
10/10/1998,8,0,3,5,16
10/11/1998,6,0,4,11,21
10/12/1998,5,0,2,12,19
10/13/1998,2,0,6,5,13
10/14/1998,6,0,6,6,18
10/15/1998,5,0,7,2,14
10/16/1998,5,0,3,4,12
10/17/1998,2,0,2,7,11
10/18/1998,2,0,3,6,11
10/19/1998,6,0,7,7,20
10/20/1998,7,0,6,3,16
10/21/1998,8,0,6,3,17
10/22/1998,2,0,6,13,21
10/23/1998,5,0,4,12,21
10/24/1998,7,0,7,0,14
10/25/1998,8,0,3,1,12
10/26/1998,3,0,8,0,11
10/27/1998,2,0,2,0,4
10/28/1998,3,0,8,9,20
10/29/1998,2,0,7,3,12
10/30/1998,3,0,6,2,11
10/31/1998,7,0,6,0,13
11/1/1998,3,0,7,11,21
11/2/1998,7,0,3,3,13
11/3/1998,2,0,5,7,14
11/4/1998,3,0,5,2,10
11/5/1998,3,0,4,4,11
11/6/1998,3,0,5,3,11
11/7/1998,4,0,2,6,12
11/8/1998,5,0,8,11,24
11/9/1998,4,0,8,11,23
11/10/1998,3,0,5,7,15
11/11/1998,2,0,8,5,15
11/12/1998,5,0,3,10,18
11/13/1998,7,0,5,2,14
11/14/1998,3,0,5,2,10
11/15/1998,5,0,5,7,17
11/16/1998,6,0,4,12,22
11/17/1998,4,0,8,5,17
11/18/1998,3,0,5,5,13
11/19/1998,2,0,3,13,18
11/20/1998,7,0,7,5,19
11/21/1998,2,0,6,4,12
11/22/1998,7,0,4,2,13
11/23/1998,6,0,6,3,15
11/24/1998,6,0,3,0,9
11/25/1998,2,0,2,7,11
11/26/1998,2,0,6,0,8
11/27/1998,3,0,7,11,21
11/28/1998,3,0,7,3,13
11/29/1998,6,0,3,11,20
11/30/1998,3,0,3,11,17
12/1/1998,7,0,4,9,20
12/2/1998,7,0,8,0,15
12/3/1998,4,0,8,7,19
12/4/1998,7,0,8,9,24
12/5/1998,5,0,4,12,21
12/6/1998,6,0,3,10,19
12/7/1998,6,0,8,10,24
12/8/1998,2,0,2,3,7
12/9/1998,3,0,3,0,6
12/10/1998,6,0,8,7,21
12/11/1998,4,0,4,3,11
12/12/1998,5,0,2,2,9
12/13/1998,2,0,3,11,16
12/14/1998,2,0,4,10,16
12/15/1998,7,0,2,0,9
12/16/1998,5,0,6,7,18
12/17/1998,6,0,8,6,20
12/18/1998,7,0,3,1,11
12/19/1998,3,0,2,13,18
12/20/1998,4,0,5,7,16
12/21/1998,4,0,8,13,25
12/22/1998,2,0,5,10,17
12/23/1998,5,0,2,10,17
12/24/1998,7,0,4,12,23
12/25/1998,4,0,2,7,13
12/26/1998,7,0,4,7,18
12/27/1998,6,0,4,3,13
12/28/1998,3,0,7,2,12
12/29/1998,8,0,3,12,23
12/30/1998,4,0,7,3,14
12/31/1998,5,0,5,9,19
1/1/1999,2,0,2,1,5
1/2/1999,3,0,4,4,11
1/3/1999,5,0,7,7,19
1/4/1999,4,0,5,12,21
1/5/1999,7,0,6,11,24
1/6/1999,6,0,5,13,24
1/7/1999,2,0,2,12,16
1/8/1999,3,0,5,4,12
1/9/1999,3,0,6,12,21
1/10/1999,4,0,7,5,16
1/11/1999,2,0,3,11,16
1/12/1999,6,0,5,13,24
1/13/1999,5,0,2,9,16
1/14/1999,6,0,3,9,18
1/15/1999,5,0,2,7,14
1/16/1999,3,0,2,8,13
1/17/1999,4,0,2,7,13
1/18/1999,6,0,2,11,19
1/19/1999,7,0,7,10,24
1/20/1999,5,0,7,0,12
1/21/1999,2,0,6,2,10
1/22/1999,3,0,2,6,11
1/23/1999,8,0,3,2,13
1/24/1999,8,0,2,1,11
1/25/1999,3,0,3,6,12
1/26/1999,7,0,6,12,25
1/27/1999,2,0,2,6,10
1/28/1999,3,0,6,1,10
1/29/1999,5,0,6,13,24
1/30/1999,8,0,6,9,23
1/31/1999,7,0,7,5,19
2/1/1999,5,0,8,5,18
2/2/1999,5,0,3,5,13
2/3/1999,6,0,4,3,13
2/4/1999,5,0,7,4,16
2/5/1999,2,0,3,8,13
2/6/1999,4,0,7,2,13
2/7/1999,3,0,7,2,12
2/8/1999,2,0,3,11,16
2/9/1999,2,0,8,13,23
2/10/1999,3,0,7,11,21
2/11/1999,5,0,8,1,14
2/12/1999,3,0,5,12,20
2/13/1999,4,0,4,2,10
2/14/1999,2,0,8,10,20
2/15/1999,4,0,2,7,13
2/16/1999,6,0,2,5,13
2/17/1999,6,0,3,4,13
2/18/1999,8,0,6,6,20
2/19/1999,3,0,4,4,11
2/20/1999,6,0,7,6,19
2/21/1999,3,0,8,12,23
2/22/1999,6,0,2,0,8
2/23/1999,3,0,6,7,16
2/24/1999,4,0,4,3,11
2/25/1999,4,0,8,11,23
2/26/1999,8,0,6,12,26
2/27/1999,6,0,8,7,21
2/28/1999,3,0,5,0,8
3/1/1999,7,0,2,12,21
3/2/1999,6,0,3,5,14
3/3/1999,5,0,6,1,12
3/4/1999,6,0,2,2,10
3/5/1999,2,0,4,0,6
3/6/1999,7,0,5,2,14
3/7/1999,3,0,7,6,16
3/8/1999,7,0,4,3,14
3/9/1999,5,0,3,1,9
3/10/1999,4,0,8,9,21
3/11/1999,5,0,2,0,7
3/12/1999,2,0,2,2,6
3/13/1999,8,0,3,6,17
3/14/1999,4,0,5,3,12
3/15/1999,5,0,3,10,18
3/16/1999,8,0,8,9,25
3/17/1999,2,0,4,0,6
3/18/1999,5,0,6,13,24
3/19/1999,7,0,4,12,23
3/20/1999,5,0,6,10,21
3/21/1999,6,0,2,8,16
3/22/1999,8,0,3,0,11
3/23/1999,7,0,3,2,12
3/24/1999,5,0,8,4,17
3/25/1999,2,0,3,6,11
3/26/1999,5,0,7,5,17
3/27/1999,6,0,2,13,21
3/28/1999,6,0,4,10,20
3/29/1999,7,0,5,4,16
3/30/1999,8,0,6,0,14
3/31/1999,4,0,8,7,19
4/1/1999,3,0,2,10,15
4/2/1999,5,0,6,12,23
4/3/1999,3,0,3,5,11
4/4/1999,6,0,3,1,10
4/5/1999,7,0,2,9,18
4/6/1999,5,0,4,8,17
4/7/1999,5,0,6,9,20
4/8/1999,7,0,7,8,22
4/9/1999,3,0,4,8,15
4/10/1999,5,0,8,12,25
4/11/1999,3,0,3,10,16
4/12/1999,3,0,6,10,19
4/13/1999,2,0,6,2,10
4/14/1999,8,0,8,0,16
4/15/1999,4,0,2,1,7
4/16/1999,2,0,7,10,19
4/17/1999,4,0,7,11,22
4/18/1999,5,0,6,2,13
4/19/1999,5,0,3,7,15
4/20/1999,6,0,8,1,15
4/21/1999,4,0,8,3,15
4/22/1999,2,0,7,8,17
4/23/1999,3,0,3,2,8
4/24/1999,4,0,6,11,21
4/25/1999,7,0,5,10,22
4/26/1999,6,0,6,12,24
4/27/1999,8,0,6,11,25
4/28/1999,7,0,2,2,11
4/29/1999,7,0,3,6,16
4/30/1999,7,0,7,7,21
5/1/1999,2,0,2,0,4
5/2/1999,8,0,8,6,22
5/3/1999,3,0,6,2,11
5/4/1999,3,0,8,8,19
5/5/1999,4,0,4,10,18
5/6/1999,7,0,7,6,20
5/7/1999,6,0,5,9,20
5/8/1999,6,0,7,2,15
5/9/1999,3,0,6,6,15
5/10/1999,3,0,5,1,9
5/11/1999,3,0,7,3,13
5/12/1999,3,0,5,3,11
5/13/1999,6,0,5,11,22
5/14/1999,6,0,6,5,17
5/15/1999,3,0,8,5,16
5/16/1999,7,0,2,1,10
5/17/1999,7,0,6,6,19
5/18/1999,3,0,5,9,17
5/19/1999,4,0,7,12,23
5/20/1999,8,0,6,3,17
5/21/1999,2,0,6,2,10
5/22/1999,2,0,6,10,18
5/23/1999,3,0,5,13,21
5/24/1999,6,0,2,3,11
5/25/1999,8,0,8,8,24
5/26/1999,5,0,5,2,12
5/27/1999,5,0,6,6,17
5/28/1999,8,0,6,12,26
5/29/1999,7,0,5,7,19
5/30/1999,2,0,3,4,9
5/31/1999,4,0,4,6,14
6/1/1999,2,0,6,7,15
6/2/1999,2,0,3,13,18
6/3/1999,4,0,8,13,25
6/4/1999,5,0,3,10,18
6/5/1999,6,0,8,2,16
6/6/1999,5,0,8,12,25
6/7/1999,6,0,3,4,13
6/8/1999,7,0,8,9,24
6/9/1999,3,0,2,1,6
6/10/1999,6,0,3,11,20
6/11/1999,7,0,6,12,25
6/12/1999,7,0,6,1,14
6/13/1999,7,0,2,9,18
6/14/1999,7,0,3,7,17
6/15/1999,6,0,2,12,20
6/16/1999,2,0,8,9,19
6/17/1999,5,0,2,11,18
6/18/1999,7,0,6,9,22
6/19/1999,8,0,3,8,19
6/20/1999,8,0,4,2,14
6/21/1999,5,0,2,0,7
6/22/1999,2,0,4,12,18
6/23/1999,2,0,4,8,14
6/24/1999,4,0,7,7,18
6/25/1999,3,0,5,13,21
6/26/1999,3,0,3,2,8
6/27/1999,2,0,5,2,9
6/28/1999,6,0,8,3,17
6/29/1999,6,0,4,12,22
6/30/1999,3,0,2,0,5
7/1/1999,8,0,5,12,25
7/2/1999,8,0,6,5,19
7/3/1999,8,0,6,4,18
7/4/1999,5,0,3,9,17
7/5/1999,4,0,7,9,20
7/6/1999,6,0,5,2,13
7/7/1999,7,0,8,9,24
7/8/1999,5,0,6,13,24
7/9/1999,5,0,6,8,19
7/10/1999,5,0,5,10,20
7/11/1999,6,0,5,2,13
7/12/1999,7,0,3,13,23
7/13/1999,5,0,8,8,21
7/14/1999,3,0,2,8,13
7/15/1999,3,0,7,13,23
7/16/1999,7,0,2,1,10
7/17/1999,2,0,7,8,17
7/18/1999,3,0,6,6,15
7/19/1999,3,0,2,6,11
7/20/1999,8,0,5,9,22
7/21/1999,2,0,8,3,13
7/22/1999,6,0,3,3,12
7/23/1999,3,0,6,10,19
7/24/1999,2,0,7,7,16
7/25/1999,2,0,2,0,4
7/26/1999,6,0,6,3,15
7/27/1999,7,0,8,3,18
7/28/1999,4,0,2,10,16
7/29/1999,5,0,3,7,15
7/30/1999,7,0,8,9,24
7/31/1999,4,0,7,13,24
8/1/1999,7,0,6,4,17
8/2/1999,3,0,4,7,14
8/3/1999,2,0,4,5,11
8/4/1999,6,0,5,2,13
8/5/1999,6,0,4,8,18
8/6/1999,3,0,3,13,19
8/7/1999,2,0,5,13,20
8/8/1999,8,0,4,11,23
8/9/1999,2,0,4,2,8
8/10/1999,8,0,5,10,23
8/11/1999,4,0,4,0,8
8/12/1999,7,0,3,7,17
8/13/1999,4,0,4,7,15
8/14/1999,2,0,7,10,19
8/15/1999,8,0,2,6,16
8/16/1999,8,0,5,13,26
8/17/1999,8,0,2,12,22
8/18/1999,7,0,7,12,26
8/19/1999,4,0,5,12,21
8/20/1999,3,0,2,3,8
8/21/1999,8,0,2,5,15
8/22/1999,2,0,2,12,16
8/23/1999,3,0,6,10,19
8/24/1999,2,0,3,12,17
8/25/1999,4,0,5,13,22
8/26/1999,6,0,6,12,24
8/27/1999,3,0,7,7,17
8/28/1999,8,0,2,10,20
8/29/1999,8,0,2,1,11
8/30/1999,3,0,2,10,15
8/31/1999,3,0,5,10,18
9/1/1999,7,0,3,9,19
9/2/1999,2,0,7,2,11
9/3/1999,2,0,3,10,15
9/4/1999,6,0,5,3,14
9/5/1999,7,0,7,9,23
9/6/1999,3,0,5,3,11
9/7/1999,2,0,3,1,6
9/8/1999,4,0,8,6,18
9/9/1999,6,0,6,10,22
9/10/1999,4,0,5,1,10
9/11/1999,2,0,8,1,11
9/12/1999,3,0,4,3,10
9/13/1999,8,0,8,9,25
9/14/1999,8,0,8,2,18
9/15/1999,4,0,5,2,11
9/16/1999,6,0,3,6,15
9/17/1999,5,0,5,13,23
9/18/1999,8,0,4,3,15
9/19/1999,6,0,6,3,15
9/20/1999,5,0,6,12,23
9/21/1999,4,0,6,9,19
9/22/1999,6,0,2,11,19
9/23/1999,7,0,6,6,19
9/24/1999,4,0,6,11,21
9/25/1999,3,0,2,7,12
9/26/1999,2,0,6,11,19
9/27/1999,6,0,5,2,13
9/28/1999,8,0,4,10,22
9/29/1999,6,0,4,12,22
9/30/1999,2,0,4,2,8
10/1/1999,8,0,4,3,15
10/2/1999,7,0,7,10,24
10/3/1999,5,0,8,10,23
10/4/1999,7,0,5,4,16
10/5/1999,2,0,2,12,16
10/6/1999,2,0,4,5,11
10/7/1999,4,0,3,12,19
10/8/1999,8,0,6,5,19
10/9/1999,2,0,5,2,9
10/10/1999,6,0,3,12,21
10/11/1999,3,0,2,6,11
10/12/1999,7,0,7,9,23
10/13/1999,4,0,4,10,18
10/14/1999,2,0,4,9,15
10/15/1999,3,0,5,6,14
10/16/1999,8,0,2,3,13
10/17/1999,7,0,4,3,14
10/18/1999,6,0,8,13,27
10/19/1999,2,0,2,1,5
10/20/1999,7,0,8,9,24
10/21/1999,4,0,3,7,14
10/22/1999,2,0,3,7,12
10/23/1999,3,0,6,6,15
10/24/1999,7,0,8,10,25
10/25/1999,5,0,8,1,14
10/26/1999,7,0,6,8,21
10/27/1999,3,0,6,8,17
10/28/1999,7,0,8,8,23
10/29/1999,7,0,8,10,25
10/30/1999,4,0,5,3,12
10/31/1999,8,0,4,9,21
11/1/1999,4,0,4,8,16
11/2/1999,5,0,4,1,10
11/3/1999,7,0,6,1,14
11/4/1999,7,0,7,5,19
11/5/1999,2,0,3,9,14
11/6/1999,6,0,7,1,14
11/7/1999,6,0,4,2,12
11/8/1999,2,0,7,8,17
11/9/1999,3,0,2,2,7
11/10/1999,3,0,8,8,19
11/11/1999,2,0,2,1,5
11/12/1999,5,0,3,8,16
11/13/1999,7,0,4,1,12
11/14/1999,3,0,6,6,15
11/15/1999,3,0,8,11,22
11/16/1999,8,0,7,7,22
11/17/1999,4,0,7,11,22
11/18/1999,6,0,2,0,8
11/19/1999,6,0,3,2,11
11/20/1999,7,0,6,13,26
11/21/1999,6,0,7,5,18
11/22/1999,3,0,5,11,19
11/23/1999,4,0,6,7,17
11/24/1999,4,0,7,1,12
11/25/1999,4,0,6,2,12
11/26/1999,4,0,7,7,18
11/27/1999,4,0,8,13,25
11/28/1999,3,0,8,8,19
11/29/1999,5,0,4,1,10
11/30/1999,7,0,7,13,27
12/1/1999,6,0,8,2,16
12/2/1999,8,0,5,13,26
12/3/1999,6,0,4,4,14
12/4/1999,8,0,4,6,18
12/5/1999,6,0,2,6,14
12/6/1999,2,0,6,4,12
12/7/1999,5,0,4,11,20
12/8/1999,6,0,7,3,16
12/9/1999,8,0,5,5,18
12/10/1999,3,0,7,3,13
12/11/1999,5,0,4,0,9
12/12/1999,2,0,7,1,10
12/13/1999,5,0,2,11,18
12/14/1999,4,0,2,11,17
12/15/1999,6,0,7,7,20
12/16/1999,2,0,8,6,16
12/17/1999,4,0,8,13,25
12/18/1999,6,0,7,8,21
12/19/1999,6,0,8,5,19
12/20/1999,5,0,2,3,10
12/21/1999,5,0,2,13,20
12/22/1999,6,0,4,4,14
12/23/1999,3,0,8,7,18
12/24/1999,4,0,5,5,14
12/25/1999,8,0,3,6,17
12/26/1999,8,0,4,7,19
12/27/1999,7,0,6,7,20
12/28/1999,2,0,6,1,9
12/29/1999,3,0,5,8,16
12/30/1999,8,0,3,10,21
12/31/1999,2,0,8,3,13
1/1/2000,4,0,8,0,12
1/2/2000,6,0,8,1,15
1/3/2000,5,0,5,13,23
1/4/2000,6,0,6,10,22
1/5/2000,3,0,3,8,14
1/6/2000,6,0,6,11,23
1/7/2000,4,0,2,8,14
1/8/2000,5,0,7,7,19
1/9/2000,3,0,8,8,19
1/10/2000,4,0,4,11,19
1/11/2000,8,0,3,3,14
1/12/2000,4,0,6,7,17
1/13/2000,4,0,5,6,15
1/14/2000,3,0,6,3,12
1/15/2000,6,0,3,4,13
1/16/2000,4,0,8,7,19
1/17/2000,2,0,5,10,17
1/18/2000,7,0,7,0,14
1/19/2000,8,0,5,13,26
1/20/2000,4,0,2,5,11
1/21/2000,3,0,7,1,11
1/22/2000,6,0,7,13,26
1/23/2000,3,0,5,1,9
1/24/2000,5,0,3,7,15
1/25/2000,4,0,8,7,19
1/26/2000,2,0,5,11,18
1/27/2000,2,0,5,2,9
1/28/2000,2,0,8,11,21
1/29/2000,5,0,5,0,10
1/30/2000,7,0,2,12,21
1/31/2000,3,0,7,0,10
2/1/2000,8,0,8,11,27
2/2/2000,2,0,4,10,16
2/3/2000,3,0,3,2,8
2/4/2000,5,0,4,3,12
2/5/2000,2,0,6,0,8
2/6/2000,8,0,4,3,15
2/7/2000,5,0,8,11,24
2/8/2000,2,0,2,1,5
2/9/2000,8,0,5,11,24
2/10/2000,6,0,8,11,25
2/11/2000,2,0,2,0,4
2/12/2000,2,0,7,7,16
2/13/2000,4,0,4,2,10
2/14/2000,6,0,2,9,17
2/15/2000,3,0,7,6,16
2/16/2000,8,0,3,5,16
2/17/2000,2,0,2,0,4
2/18/2000,5,0,2,11,18
2/19/2000,2,0,5,5,12
2/20/2000,8,0,7,8,23
2/21/2000,4,0,5,8,17
2/22/2000,6,0,5,3,14
2/23/2000,2,0,8,11,21
2/24/2000,2,0,4,13,19
2/25/2000,8,0,5,8,21
2/26/2000,4,0,6,4,14
2/27/2000,6,0,4,9,19
2/28/2000,3,0,8,7,18
2/29/2000,5,0,2,6,13
3/1/2000,8,0,5,6,19
3/2/2000,5,0,4,0,9
3/3/2000,5,0,6,2,13
3/4/2000,7,0,8,11,26
3/5/2000,8,0,4,7,19
3/6/2000,5,0,8,13,26
3/7/2000,4,0,6,9,19
3/8/2000,8,0,7,9,24
3/9/2000,2,0,5,0,7
3/10/2000,4,0,5,5,14
3/11/2000,8,0,6,11,25
3/12/2000,7,0,5,12,24
3/13/2000,8,0,7,11,26
3/14/2000,7,0,5,9,21
3/15/2000,4,0,6,1,11
3/16/2000,8,0,2,10,20
3/17/2000,4,0,7,11,22
3/18/2000,2,0,4,4,10
3/19/2000,8,0,4,5,17
3/20/2000,8,0,4,6,18
3/21/2000,3,0,7,3,13
3/22/2000,4,0,4,7,15
3/23/2000,7,0,8,5,20
3/24/2000,5,0,3,2,10
3/25/2000,4,0,3,4,11
3/26/2000,5,0,5,2,12
3/27/2000,2,0,4,10,16
3/28/2000,8,0,4,10,22
3/29/2000,7,0,3,0,10
3/30/2000,2,0,4,13,19
3/31/2000,5,0,5,8,18
4/1/2000,7,0,2,10,19
4/2/2000,2,0,3,11,16
4/3/2000,6,0,4,6,16
4/4/2000,4,0,8,9,21
4/5/2000,8,0,4,8,20
4/6/2000,6,0,3,5,14
4/7/2000,4,0,5,5,14
4/8/2000,3,0,6,11,20
4/9/2000,4,0,7,13,24
4/10/2000,3,0,6,8,17
4/11/2000,2,0,4,2,8
4/12/2000,7,0,3,9,19
4/13/2000,5,0,5,13,23
4/14/2000,5,0,7,0,12
4/15/2000,6,0,3,7,16
4/16/2000,7,0,2,4,13
4/17/2000,5,0,6,6,17
4/18/2000,5,0,8,1,14
4/19/2000,6,0,6,9,21
4/20/2000,3,0,8,5,16
4/21/2000,4,0,4,11,19
4/22/2000,6,0,2,7,15
4/23/2000,6,0,5,7,18
4/24/2000,8,0,5,7,20
4/25/2000,4,0,2,10,16
4/26/2000,7,0,2,7,16
4/27/2000,3,0,6,2,11
4/28/2000,8,0,2,11,21
4/29/2000,3,0,6,11,20
4/30/2000,6,0,5,1,12
5/1/2000,3,0,7,13,23
5/2/2000,7,0,8,9,24
5/3/2000,7,0,3,7,17
5/4/2000,3,0,7,3,13
5/5/2000,3,0,4,9,16
5/6/2000,8,0,7,5,20
5/7/2000,2,0,7,7,16
5/8/2000,5,0,4,13,22
5/9/2000,4,0,4,2,10
5/10/2000,2,0,6,3,11
5/11/2000,8,0,6,0,14
5/12/2000,2,0,6,10,18
5/13/2000,5,0,8,4,17
5/14/2000,4,0,4,12,20
5/15/2000,8,0,5,10,23
5/16/2000,8,0,8,2,18
5/17/2000,2,0,2,4,8
5/18/2000,7,0,7,1,15
5/19/2000,6,0,7,6,19
5/20/2000,6,0,3,1,10
5/21/2000,7,0,3,9,19
5/22/2000,6,0,7,4,17
5/23/2000,8,0,7,8,23
5/24/2000,4,0,3,7,14
5/25/2000,5,0,8,7,20
5/26/2000,4,0,8,0,12
5/27/2000,7,0,7,8,22
5/28/2000,2,0,2,11,15
5/29/2000,5,0,5,10,20
5/30/2000,7,0,8,4,19
5/31/2000,5,0,7,6,18
6/1/2000,7,0,5,5,17
6/2/2000,8,0,2,9,19
6/3/2000,7,0,3,8,18
6/4/2000,5,0,3,2,10
6/5/2000,7,0,2,0,9
6/6/2000,5,0,6,0,11
6/7/2000,5,0,5,9,19
6/8/2000,8,0,2,3,13
6/9/2000,2,0,3,11,16
6/10/2000,2,0,8,12,22
6/11/2000,8,0,5,10,23
6/12/2000,6,0,7,4,17
6/13/2000,7,0,5,9,21
6/14/2000,7,0,8,3,18
6/15/2000,6,0,2,6,14
6/16/2000,3,0,2,1,6
6/17/2000,5,0,8,1,14
6/18/2000,5,0,4,10,19
6/19/2000,5,0,6,3,14
6/20/2000,7,0,6,6,19
6/21/2000,2,0,2,11,15
6/22/2000,2,0,6,9,17
6/23/2000,3,0,3,7,13
6/24/2000,5,0,8,11,24
6/25/2000,3,0,7,0,10
6/26/2000,3,0,8,10,21
6/27/2000,2,0,2,6,10
6/28/2000,8,0,3,3,14
6/29/2000,5,0,8,1,14
6/30/2000,8,0,2,7,17
7/1/2000,3,0,4,9,16
7/2/2000,8,0,5,4,17
7/3/2000,3,0,7,11,21
7/4/2000,4,0,7,11,22
7/5/2000,4,0,6,1,11
7/6/2000,4,0,5,5,14
7/7/2000,8,0,8,1,17
7/8/2000,5,0,6,3,14
7/9/2000,2,0,8,8,18
7/10/2000,6,0,2,12,20
7/11/2000,3,0,7,13,23
7/12/2000,8,0,4,7,19
7/13/2000,5,0,2,13,20
7/14/2000,3,0,8,5,16
7/15/2000,2,0,6,5,13
7/16/2000,7,0,6,7,20
7/17/2000,5,0,3,9,17
7/18/2000,6,0,8,6,20
7/19/2000,5,0,6,5,16
7/20/2000,6,0,5,6,17
7/21/2000,6,0,8,10,24
7/22/2000,4,0,8,3,15
7/23/2000,3,0,7,4,14
7/24/2000,5,0,2,3,10
7/25/2000,3,0,6,7,16
7/26/2000,5,0,4,13,22
7/27/2000,2,0,4,5,11
7/28/2000,5,0,8,13,26
7/29/2000,3,0,5,11,19
7/30/2000,3,0,7,3,13
7/31/2000,7,0,6,3,16
8/1/2000,6,0,5,10,21
8/2/2000,2,0,7,3,12
8/3/2000,5,0,7,9,21
8/4/2000,5,0,2,8,15
8/5/2000,5,0,3,8,16
8/6/2000,7,0,5,0,12
8/7/2000,8,0,3,7,18
8/8/2000,3,0,2,3,8
8/9/2000,5,0,7,7,19
8/10/2000,4,0,3,13,20
8/11/2000,4,0,2,2,8
8/12/2000,3,0,7,0,10
8/13/2000,7,0,8,10,25
8/14/2000,8,0,4,7,19
8/15/2000,2,0,3,8,13
8/16/2000,7,0,7,8,22
8/17/2000,6,0,6,1,13
8/18/2000,7,0,2,3,12
8/19/2000,5,0,6,10,21
8/20/2000,6,0,7,6,19
8/21/2000,6,0,6,10,22
8/22/2000,7,0,5,9,21
8/23/2000,8,0,7,4,19
8/24/2000,3,0,4,5,12
8/25/2000,6,0,6,3,15
8/26/2000,3,0,5,4,12
8/27/2000,2,0,4,0,6
8/28/2000,4,0,4,11,19
8/29/2000,4,0,6,8,18
8/30/2000,8,0,5,0,13
8/31/2000,6,0,8,13,27
9/1/2000,3,0,7,13,23
9/2/2000,6,0,4,7,17
9/3/2000,2,0,7,13,22
9/4/2000,5,0,4,2,11
9/5/2000,6,0,4,7,17
9/6/2000,6,0,7,8,21
9/7/2000,7,0,8,9,24
9/8/2000,5,0,6,4,15
9/9/2000,8,0,6,13,27
9/10/2000,7,0,7,8,22
9/11/2000,8,0,4,6,18
9/12/2000,7,0,2,13,22
9/13/2000,7,0,2,4,13
9/14/2000,7,0,2,7,16
9/15/2000,6,0,2,3,11
9/16/2000,5,0,7,2,14
9/17/2000,2,0,4,10,16
9/18/2000,4,0,7,11,22
9/19/2000,8,0,6,1,15
9/20/2000,3,0,6,1,10
9/21/2000,8,0,4,0,12
9/22/2000,2,0,5,6,13
9/23/2000,6,0,5,2,13
9/24/2000,2,0,3,10,15
9/25/2000,8,0,5,12,25
9/26/2000,2,0,8,12,22
9/27/2000,4,0,3,10,17
9/28/2000,8,0,6,11,25
9/29/2000,3,0,8,3,14
9/30/2000,8,0,6,8,22
10/1/2000,8,0,4,11,23
10/2/2000,8,0,5,11,24
10/3/2000,2,0,6,11,19
10/4/2000,4,0,3,11,18
10/5/2000,6,0,5,6,17
10/6/2000,8,0,8,9,25
10/7/2000,4,0,4,5,13
10/8/2000,8,0,2,13,23
10/9/2000,7,0,3,12,22
10/10/2000,7,0,2,0,9
10/11/2000,4,0,3,12,19
10/12/2000,2,0,3,5,10
10/13/2000,2,0,2,6,10
10/14/2000,3,0,6,2,11
10/15/2000,2,0,4,10,16
10/16/2000,4,0,7,2,13
10/17/2000,2,0,2,8,12
10/18/2000,4,0,5,3,12
10/19/2000,6,0,6,9,21
10/20/2000,3,0,2,2,7
10/21/2000,5,0,2,10,17
10/22/2000,4,0,3,3,10
10/23/2000,5,0,3,3,11
10/24/2000,5,0,8,12,25
10/25/2000,5,0,7,3,15
10/26/2000,8,0,8,10,26
10/27/2000,8,0,2,4,14
10/28/2000,8,0,4,6,18
10/29/2000,4,0,4,1,9
10/30/2000,4,0,3,0,7
10/31/2000,6,0,7,10,23
11/1/2000,2,0,5,5,12
11/2/2000,8,0,2,6,16
11/3/2000,5,0,4,3,12
11/4/2000,3,0,4,11,18
11/5/2000,5,0,4,5,14
11/6/2000,2,0,8,2,12
11/7/2000,5,0,8,2,15
11/8/2000,6,0,3,6,15
11/9/2000,8,0,4,3,15
11/10/2000,7,0,2,2,11
11/11/2000,7,0,5,12,24
11/12/2000,5,0,4,5,14
11/13/2000,7,0,4,4,15
11/14/2000,7,0,7,11,25
11/15/2000,6,0,8,6,20
11/16/2000,4,0,3,6,13
11/17/2000,3,0,8,3,14
11/18/2000,7,0,7,8,22
11/19/2000,6,0,8,12,26
11/20/2000,5,0,5,13,23
11/21/2000,2,0,2,7,11
11/22/2000,6,0,5,8,19
11/23/2000,8,0,3,10,21
11/24/2000,4,0,4,4,12
11/25/2000,4,0,3,5,12
11/26/2000,5,0,6,4,15
11/27/2000,5,0,6,5,16
11/28/2000,5,0,2,1,8
11/29/2000,7,0,7,4,18
11/30/2000,8,0,2,4,14
12/1/2000,5,0,6,12,23
12/2/2000,7,0,8,13,28
12/3/2000,6,0,3,6,15
12/4/2000,2,0,8,1,11
12/5/2000,2,0,8,1,11
12/6/2000,7,0,2,2,11
12/7/2000,4,0,5,2,11
12/8/2000,3,0,6,6,15
12/9/2000,7,0,2,6,15
12/10/2000,3,0,2,7,12
12/11/2000,5,0,6,6,17
12/12/2000,2,0,3,0,5
12/13/2000,4,0,8,3,15
12/14/2000,3,0,5,8,16
12/15/2000,6,0,3,5,14
12/16/2000,2,0,7,0,9
12/17/2000,7,0,7,1,15
12/18/2000,5,0,7,2,14
12/19/2000,3,0,6,4,13
12/20/2000,8,0,6,10,24
12/21/2000,2,0,4,6,12
12/22/2000,8,0,7,2,17
12/23/2000,4,0,3,0,7
12/24/2000,3,0,4,2,9
12/25/2000,8,0,5,10,23
12/26/2000,8,0,7,3,18
12/27/2000,3,0,3,13,19
12/28/2000,8,0,5,6,19
12/29/2000,4,0,7,4,15
12/30/2000,4,0,6,4,14
12/31/2000,3,0,6,11,20
1/1/2001,3,0,8,1,12
1/2/2001,8,0,4,10,22
1/3/2001,3,0,6,8,17
1/4/2001,3,0,3,12,18
1/5/2001,3,0,2,12,17
1/6/2001,7,0,6,7,20
1/7/2001,7,0,4,9,20
1/8/2001,7,0,4,7,18
1/9/2001,6,0,3,12,21
1/10/2001,3,0,6,4,13
1/11/2001,6,0,2,13,21
1/12/2001,4,0,5,9,18
1/13/2001,5,0,8,1,14
1/14/2001,8,0,5,10,23
1/15/2001,3,0,2,6,11
1/16/2001,3,0,2,7,12
1/17/2001,4,0,7,4,15
1/18/2001,6,0,4,3,13
1/19/2001,2,0,6,3,11
1/20/2001,6,0,2,6,14
1/21/2001,3,0,2,0,5
1/22/2001,5,0,6,3,14
1/23/2001,2,0,8,12,22
1/24/2001,7,0,5,13,25
1/25/2001,8,0,3,12,23
1/26/2001,2,0,2,2,6
1/27/2001,2,0,7,6,15
1/28/2001,3,0,8,12,23
1/29/2001,8,0,5,1,14
1/30/2001,2,0,2,9,13
1/31/2001,3,0,6,3,12
2/1/2001,2,0,7,5,14
2/2/2001,8,0,5,5,18
2/3/2001,7,0,3,9,19
2/4/2001,8,0,3,4,15
2/5/2001,7,0,7,1,15
2/6/2001,8,0,5,7,20
2/7/2001,5,0,4,4,13
2/8/2001,5,0,6,2,13
2/9/2001,5,0,5,8,18
2/10/2001,3,0,4,6,13
2/11/2001,8,0,7,0,15
2/12/2001,4,0,5,12,21
2/13/2001,2,0,5,7,14
2/14/2001,4,0,5,7,16
2/15/2001,6,0,4,2,12
2/16/2001,2,0,5,0,7
2/17/2001,7,0,7,13,27
2/18/2001,4,0,2,11,17
2/19/2001,4,0,8,10,22
2/20/2001,5,0,5,7,17
2/21/2001,6,0,6,0,12
2/22/2001,6,0,8,2,16
2/23/2001,3,0,4,1,8
2/24/2001,6,0,5,5,16
2/25/2001,8,0,8,11,27
2/26/2001,2,0,7,4,13
2/27/2001,5,0,6,0,11
2/28/2001,4,0,6,9,19
3/1/2001,7,0,4,8,19
3/2/2001,5,0,8,2,15
3/3/2001,2,0,6,5,13
3/4/2001,5,0,6,11,22
3/5/2001,6,0,7,10,23
3/6/2001,4,0,7,2,13
3/7/2001,4,0,7,13,24
3/8/2001,6,0,8,11,25
3/9/2001,2,0,6,6,14
3/10/2001,8,0,5,9,22
3/11/2001,5,0,7,8,20
3/12/2001,4,0,6,8,18
3/13/2001,4,0,2,13,19
3/14/2001,5,0,5,5,15
3/15/2001,2,0,3,1,6
3/16/2001,5,0,5,13,23
3/17/2001,7,0,3,3,13
3/18/2001,5,0,4,2,11
3/19/2001,5,0,2,13,20
3/20/2001,4,0,6,2,12
3/21/2001,7,0,3,5,15
3/22/2001,6,0,3,2,11
3/23/2001,8,0,6,10,24
3/24/2001,6,0,4,7,17
3/25/2001,2,0,4,13,19
3/26/2001,7,0,4,10,21
3/27/2001,7,0,6,0,13
3/28/2001,7,0,4,13,24
3/29/2001,2,0,6,1,9
3/30/2001,2,0,6,1,9
3/31/2001,6,0,6,3,15
4/1/2001,4,0,4,7,15
4/2/2001,6,0,2,2,10
4/3/2001,3,0,3,2,8
4/4/2001,8,0,2,7,17
4/5/2001,7,0,6,0,13
4/6/2001,6,0,3,4,13
4/7/2001,2,0,7,3,12
4/8/2001,6,0,2,0,8
4/9/2001,5,0,7,10,22
4/10/2001,4,0,2,4,10
4/11/2001,6,0,8,11,25
4/12/2001,3,0,7,7,17
4/13/2001,2,0,6,3,11
4/14/2001,5,0,4,3,12
4/15/2001,6,0,3,13,22
4/16/2001,2,0,5,2,9
4/17/2001,2,0,8,7,17
4/18/2001,3,0,7,9,19
4/19/2001,4,0,4,4,12
4/20/2001,7,0,7,7,21
4/21/2001,4,0,4,2,10
4/22/2001,7,0,3,13,23
4/23/2001,7,0,3,10,20
4/24/2001,5,0,2,10,17
4/25/2001,8,0,2,4,14
4/26/2001,7,0,7,13,27
4/27/2001,7,0,5,7,19
4/28/2001,3,0,3,3,9
4/29/2001,7,0,6,9,22
4/30/2001,3,0,2,2,7
5/1/2001,2,0,4,11,17
5/2/2001,5,0,7,1,13
5/3/2001,6,0,2,13,21
5/4/2001,5,0,3,4,12
5/5/2001,4,0,7,8,19
5/6/2001,5,0,7,2,14
5/7/2001,4,0,6,8,18
5/8/2001,6,0,8,0,14
5/9/2001,3,0,4,5,12
5/10/2001,5,0,2,2,9
5/11/2001,2,0,8,3,13
5/12/2001,6,0,8,1,15
5/13/2001,2,0,7,0,9
5/14/2001,2,0,8,8,18
5/15/2001,2,0,5,9,16
5/16/2001,8,0,8,6,22
5/17/2001,5,0,8,6,19
5/18/2001,6,0,4,8,18
5/19/2001,4,0,4,10,18
5/20/2001,8,0,3,6,17
5/21/2001,7,0,4,1,12
5/22/2001,8,0,8,4,20
5/23/2001,5,0,3,10,18
5/24/2001,3,0,7,0,10
5/25/2001,3,0,4,2,9
5/26/2001,8,0,4,1,13
5/27/2001,7,0,2,4,13
5/28/2001,7,0,7,8,22
5/29/2001,5,0,6,0,11
5/30/2001,4,0,4,5,13
5/31/2001,4,0,8,11,23
6/1/2001,2,0,4,8,14
6/2/2001,7,0,5,12,24
6/3/2001,7,0,5,6,18
6/4/2001,4,0,3,3,10
6/5/2001,6,0,8,11,25
6/6/2001,4,0,3,9,16
6/7/2001,3,0,8,6,17
6/8/2001,2,0,5,4,11
6/9/2001,5,0,5,1,11
6/10/2001,8,0,2,8,18
6/11/2001,7,0,8,12,27
6/12/2001,2,0,6,11,19
6/13/2001,3,0,5,7,15
6/14/2001,2,0,7,6,15
6/15/2001,7,0,7,0,14
6/16/2001,4,0,5,2,11
6/17/2001,3,0,7,5,15
6/18/2001,6,0,2,5,13
6/19/2001,6,0,4,13,23
6/20/2001,2,0,8,1,11
6/21/2001,5,0,5,12,22
6/22/2001,5,0,3,6,14
6/23/2001,8,0,4,6,18
6/24/2001,2,0,2,11,15
6/25/2001,2,0,7,1,10
6/26/2001,7,0,7,11,25
6/27/2001,8,0,8,8,24
6/28/2001,5,0,6,0,11
6/29/2001,8,0,7,1,16
6/30/2001,8,0,2,4,14
7/1/2001,5,0,2,6,13
7/2/2001,3,0,6,0,9
7/3/2001,8,0,2,3,13
7/4/2001,4,0,8,10,22
7/5/2001,3,0,8,13,24
7/6/2001,2,0,2,13,17
7/7/2001,6,0,6,2,14
7/8/2001,2,0,3,9,14
7/9/2001,2,0,8,8,18
7/10/2001,3,0,6,11,20
7/11/2001,7,0,4,0,11
7/12/2001,6,0,6,2,14
7/13/2001,8,0,2,1,11
7/14/2001,8,0,4,12,24
7/15/2001,3,0,7,12,22
7/16/2001,7,0,7,4,18
7/17/2001,6,0,4,13,23
7/18/2001,7,0,2,3,12
7/19/2001,4,0,8,6,18
7/20/2001,3,0,5,5,13
7/21/2001,6,0,2,5,13
7/22/2001,6,0,3,2,11
7/23/2001,3,0,2,1,6
7/24/2001,2,0,3,0,5
7/25/2001,3,0,5,2,10
7/26/2001,6,0,3,1,10
7/27/2001,2,0,7,7,16
7/28/2001,2,0,3,12,17
7/29/2001,2,0,8,11,21
7/30/2001,3,0,6,4,13
7/31/2001,7,0,5,5,17
8/1/2001,8,0,8,10,26
8/2/2001,4,0,7,6,17
8/3/2001,6,0,3,2,11
8/4/2001,7,0,5,4,16
8/5/2001,3,0,2,3,8
8/6/2001,4,0,3,5,12
8/7/2001,4,0,8,1,13
8/8/2001,5,0,5,12,22
8/9/2001,4,0,8,6,18
8/10/2001,5,0,4,13,22
8/11/2001,5,0,6,11,22
8/12/2001,6,0,3,8,17
8/13/2001,2,0,4,6,12
8/14/2001,2,0,7,1,10
8/15/2001,7,0,6,6,19
8/16/2001,5,0,6,4,15
8/17/2001,6,0,5,10,21
8/18/2001,2,0,5,3,10
8/19/2001,6,0,5,3,14
8/20/2001,7,0,7,6,20
8/21/2001,7,0,7,8,22
8/22/2001,7,0,7,8,22
8/23/2001,2,0,4,10,16
8/24/2001,4,0,6,9,19
8/25/2001,8,0,5,13,26
8/26/2001,2,0,5,11,18
8/27/2001,2,0,3,5,10
8/28/2001,3,0,5,1,9
8/29/2001,3,0,6,12,21
8/30/2001,4,0,8,6,18
8/31/2001,2,0,8,9,19
9/1/2001,6,0,8,4,18
9/2/2001,5,0,6,13,24
9/3/2001,7,0,7,6,20
9/4/2001,4,0,6,11,21
9/5/2001,6,0,4,12,22
9/6/2001,7,0,2,1,10
9/7/2001,2,0,8,3,13
9/8/2001,2,0,7,5,14
9/9/2001,8,0,4,4,16
9/10/2001,8,0,6,1,15
9/11/2001,8,0,8,2,18
9/12/2001,3,0,6,12,21
9/13/2001,8,0,4,5,17
9/14/2001,6,0,3,2,11
9/15/2001,3,0,2,5,10
9/16/2001,3,0,4,7,14
9/17/2001,2,0,7,0,9
9/18/2001,2,0,3,13,18
9/19/2001,6,0,2,10,18
9/20/2001,5,0,8,8,21
9/21/2001,3,0,7,1,11
9/22/2001,3,0,4,9,16
9/23/2001,7,0,4,0,11
9/24/2001,8,0,3,6,17
9/25/2001,7,0,3,8,18
9/26/2001,8,0,8,5,21
9/27/2001,5,0,6,9,20
9/28/2001,7,0,3,7,17
9/29/2001,7,0,8,10,25
9/30/2001,6,0,7,9,22
10/1/2001,6,0,4,3,13
10/2/2001,2,0,6,5,13
10/3/2001,6,0,8,0,14
10/4/2001,2,0,4,10,16
10/5/2001,5,0,6,4,15
10/6/2001,4,0,8,9,21
10/7/2001,4,0,5,13,22
10/8/2001,5,0,4,4,13
10/9/2001,5,0,6,12,23
10/10/2001,3,0,6,5,14
10/11/2001,2,0,6,8,16
10/12/2001,6,0,7,10,23
10/13/2001,2,0,7,8,17
10/14/2001,2,0,3,3,8
10/15/2001,8,0,6,6,20
10/16/2001,4,0,8,11,23
10/17/2001,4,0,7,0,11
10/18/2001,3,0,2,9,14
10/19/2001,5,0,2,7,14
10/20/2001,4,0,5,13,22
10/21/2001,7,0,7,7,21
10/22/2001,3,0,2,5,10
10/23/2001,5,0,6,9,20
10/24/2001,4,0,5,11,20
10/25/2001,6,0,2,12,20
10/26/2001,3,0,6,8,17
10/27/2001,4,0,5,5,14
10/28/2001,4,0,4,4,12
10/29/2001,6,0,5,9,20
10/30/2001,6,0,3,7,16
10/31/2001,8,0,3,0,11
11/1/2001,3,0,8,13,24
11/2/2001,2,0,7,12,21
11/3/2001,3,0,2,7,12
11/4/2001,6,0,6,4,16
11/5/2001,2,0,4,10,16
11/6/2001,4,0,5,0,9
11/7/2001,8,0,5,7,20
11/8/2001,6,0,5,8,19
11/9/2001,4,0,6,13,23
11/10/2001,5,0,4,2,11
11/11/2001,2,0,7,6,15
11/12/2001,2,0,3,11,16
11/13/2001,2,0,3,12,17
11/14/2001,8,0,2,7,17
11/15/2001,7,0,5,3,15
11/16/2001,8,0,8,11,27
11/17/2001,6,0,6,13,25
11/18/2001,7,0,7,8,22
11/19/2001,3,0,2,10,15
11/20/2001,3,0,2,12,17
11/21/2001,6,0,8,4,18
11/22/2001,4,0,6,13,23
11/23/2001,3,0,8,10,21
11/24/2001,3,0,8,2,13
11/25/2001,2,0,2,13,17
11/26/2001,7,0,8,1,16
11/27/2001,8,0,5,2,15
11/28/2001,3,0,6,11,20
11/29/2001,7,0,5,5,17
11/30/2001,3,0,2,9,14
12/1/2001,7,0,7,11,25
12/2/2001,2,0,4,9,15
12/3/2001,3,0,6,10,19
12/4/2001,3,0,8,13,24
12/5/2001,7,0,5,3,15
12/6/2001,6,0,7,13,26
12/7/2001,4,0,7,1,12
12/8/2001,8,0,3,9,20
12/9/2001,7,0,8,13,28
12/10/2001,4,0,5,13,22
12/11/2001,8,0,3,7,18
12/12/2001,4,0,8,4,16
12/13/2001,3,0,5,1,9
12/14/2001,8,0,2,2,12
12/15/2001,7,0,2,11,20
12/16/2001,5,0,8,12,25
12/17/2001,7,0,4,1,12
12/18/2001,4,0,7,10,21
12/19/2001,2,0,3,11,16
12/20/2001,2,0,2,8,12
12/21/2001,3,0,7,5,15
12/22/2001,2,0,3,0,5
12/23/2001,3,0,2,13,18
12/24/2001,8,0,2,8,18
12/25/2001,4,0,2,11,17
12/26/2001,5,0,3,1,9
12/27/2001,3,0,2,5,10
12/28/2001,5,0,6,4,15
12/29/2001,3,0,6,9,18
12/30/2001,4,0,5,2,11
12/31/2001,2,0,8,2,12
1/1/2002,4,0,4,12,20
1/2/2002,6,0,2,13,21
1/3/2002,4,0,5,11,20
1/4/2002,8,0,5,6,19
1/5/2002,8,0,6,3,17
1/6/2002,2,0,3,6,11
1/7/2002,2,0,6,3,11
1/8/2002,2,0,8,4,14
1/9/2002,8,0,6,3,17
1/10/2002,4,0,5,11,20
1/11/2002,6,0,7,0,13
1/12/2002,7,0,3,0,10
1/13/2002,6,0,8,0,14
1/14/2002,2,0,7,3,12
1/15/2002,6,0,5,0,11
1/16/2002,2,0,8,5,15
1/17/2002,4,0,7,13,24
1/18/2002,4,0,6,5,15
1/19/2002,8,0,3,0,11
1/20/2002,4,0,4,3,11
1/21/2002,5,0,8,1,14
1/22/2002,8,0,3,13,24
1/23/2002,4,0,3,5,12
1/24/2002,2,0,7,1,10
1/25/2002,8,0,2,1,11
1/26/2002,8,0,3,0,11
1/27/2002,2,0,2,3,7
1/28/2002,7,0,3,6,16
1/29/2002,4,0,2,10,16
1/30/2002,3,0,8,1,12
1/31/2002,2,0,8,0,10
2/1/2002,6,0,8,8,22
2/2/2002,7,0,6,3,16
2/3/2002,7,0,2,1,10
2/4/2002,3,0,8,10,21
2/5/2002,3,0,4,0,7
2/6/2002,5,0,5,11,21
2/7/2002,2,0,8,2,12
2/8/2002,6,0,6,9,21
2/9/2002,2,0,6,13,21
2/10/2002,3,0,3,9,15
2/11/2002,5,0,2,2,9
2/12/2002,7,0,3,9,19
2/13/2002,4,0,4,6,14
2/14/2002,2,0,7,0,9
2/15/2002,6,0,7,12,25
2/16/2002,6,0,5,8,19
2/17/2002,5,0,6,8,19
2/18/2002,5,0,7,9,21
2/19/2002,6,0,4,12,22
2/20/2002,4,0,8,11,23
2/21/2002,2,0,2,11,15
2/22/2002,6,0,3,11,20
2/23/2002,2,0,3,7,12
2/24/2002,6,0,8,2,16
2/25/2002,2,0,6,1,9
2/26/2002,4,0,5,12,21
2/27/2002,7,0,3,4,14
2/28/2002,4,0,7,12,23
3/1/2002,4,0,7,1,12
3/2/2002,4,0,5,8,17
3/3/2002,3,0,8,0,11
3/4/2002,2,0,3,9,14
3/5/2002,4,0,2,4,10
3/6/2002,8,0,3,4,15
3/7/2002,7,0,3,10,20
3/8/2002,6,0,3,12,21
3/9/2002,4,0,8,1,13
3/10/2002,4,0,6,0,10
3/11/2002,8,0,4,3,15
3/12/2002,8,0,6,1,15
3/13/2002,3,0,7,4,14
3/14/2002,3,0,6,2,11
3/15/2002,6,0,6,3,15
3/16/2002,8,0,6,7,21
3/17/2002,5,0,8,1,14
3/18/2002,3,0,4,5,12
3/19/2002,6,0,6,12,24
3/20/2002,6,0,5,9,20
3/21/2002,8,0,6,2,16
3/22/2002,7,0,2,1,10
3/23/2002,3,0,7,9,19
3/24/2002,3,0,3,5,11
3/25/2002,5,0,5,12,22
3/26/2002,8,0,2,0,10
3/27/2002,8,0,7,5,20
3/28/2002,4,0,6,12,22
3/29/2002,2,0,4,2,8
3/30/2002,8,0,3,3,14
3/31/2002,8,0,3,2,13
4/1/2002,6,0,4,12,22
4/2/2002,3,0,2,12,17
4/3/2002,7,0,4,13,24
4/4/2002,3,0,2,7,12
4/5/2002,8,0,3,0,11
4/6/2002,5,0,5,4,14
4/7/2002,8,0,3,2,13
4/8/2002,7,0,8,4,19
4/9/2002,7,0,8,7,22
4/10/2002,6,0,8,6,20
4/11/2002,6,0,7,0,13
4/12/2002,5,0,4,10,19
4/13/2002,6,0,3,10,19
4/14/2002,3,0,7,0,10
4/15/2002,7,0,6,2,15
4/16/2002,6,0,3,12,21
4/17/2002,7,0,7,3,17
4/18/2002,8,0,4,5,17
4/19/2002,5,0,2,5,12
4/20/2002,8,0,2,2,12
4/21/2002,2,0,4,0,6
4/22/2002,8,0,2,10,20
4/23/2002,7,0,2,12,21
4/24/2002,7,0,3,10,20
4/25/2002,5,0,3,3,11
4/26/2002,5,0,8,11,24
4/27/2002,4,0,4,13,21
4/28/2002,2,0,6,7,15
4/29/2002,2,0,2,4,8
4/30/2002,3,0,4,13,20
5/1/2002,4,0,6,7,17
5/2/2002,3,0,4,13,20
5/3/2002,8,0,5,11,24
5/4/2002,8,0,3,8,19
5/5/2002,4,0,7,2,13
5/6/2002,8,0,7,10,25
5/7/2002,5,0,4,1,10
5/8/2002,3,0,7,0,10
5/9/2002,4,0,7,7,18
5/10/2002,7,0,7,6,20
5/11/2002,8,0,5,1,14
5/12/2002,4,0,3,4,11
5/13/2002,8,0,7,9,24
5/14/2002,6,0,7,9,22
5/15/2002,7,0,8,2,17
5/16/2002,7,0,8,9,24
5/17/2002,7,0,8,11,26
5/18/2002,5,0,4,12,21
5/19/2002,3,0,3,8,14
5/20/2002,5,0,7,4,16
5/21/2002,3,0,3,3,9
5/22/2002,7,0,5,1,13
5/23/2002,5,0,5,4,14
5/24/2002,4,0,2,9,15
5/25/2002,5,0,4,11,20
5/26/2002,4,0,2,9,15
5/27/2002,6,0,2,5,13
5/28/2002,5,0,4,4,13
5/29/2002,8,0,7,10,25
5/30/2002,4,0,8,5,17
5/31/2002,2,0,2,12,16
6/1/2002,5,0,5,0,10
6/2/2002,4,0,2,9,15
6/3/2002,5,0,3,4,12
6/4/2002,4,0,3,10,17
6/5/2002,7,0,2,1,10
6/6/2002,8,0,2,9,19
6/7/2002,2,0,7,2,11
6/8/2002,4,0,4,0,8
6/9/2002,4,0,7,3,14
6/10/2002,6,0,8,0,14
6/11/2002,7,0,7,1,15
6/12/2002,4,0,5,3,12
6/13/2002,5,0,8,0,13
6/14/2002,8,0,6,5,19
6/15/2002,3,0,4,8,15
6/16/2002,6,0,2,7,15
6/17/2002,7,0,6,3,16
6/18/2002,7,0,4,9,20
6/19/2002,6,0,2,1,9
6/20/2002,3,0,3,4,10
6/21/2002,8,0,7,1,16
6/22/2002,8,0,2,1,11
6/23/2002,2,0,5,9,16
6/24/2002,6,0,6,3,15
6/25/2002,2,0,6,9,17
6/26/2002,4,0,2,7,13
6/27/2002,3,0,5,8,16
6/28/2002,6,0,7,9,22
6/29/2002,4,0,4,12,20
6/30/2002,4,0,7,10,21
7/1/2002,5,0,5,8,18
7/2/2002,7,0,8,7,22
7/3/2002,6,0,3,12,21
7/4/2002,6,0,2,8,16
7/5/2002,4,0,3,12,19
7/6/2002,6,0,2,9,17
7/7/2002,8,0,2,12,22
7/8/2002,5,0,8,13,26
7/9/2002,2,0,7,4,13
7/10/2002,5,0,7,13,25
7/11/2002,3,0,4,10,17
7/12/2002,6,0,8,3,17
7/13/2002,8,0,3,6,17
7/14/2002,2,0,2,7,11
7/15/2002,8,0,4,13,25
7/16/2002,8,0,2,2,12
7/17/2002,6,0,8,1,15
7/18/2002,3,0,8,8,19
7/19/2002,8,0,4,0,12
7/20/2002,2,0,8,10,20
7/21/2002,8,0,4,13,25
7/22/2002,5,0,4,9,18
7/23/2002,8,0,5,13,26
7/24/2002,2,0,3,10,15
7/25/2002,7,0,7,1,15
7/26/2002,6,0,7,0,13
7/27/2002,2,0,7,1,10
7/28/2002,4,0,5,3,12
7/29/2002,7,0,7,4,18
7/30/2002,7,0,6,5,18
7/31/2002,7,0,4,10,21
8/1/2002,3,0,6,11,20
8/2/2002,8,0,3,1,12
8/3/2002,3,0,8,9,20
8/4/2002,6,0,5,4,15
8/5/2002,5,0,7,11,23
8/6/2002,5,0,6,6,17
8/7/2002,4,0,5,5,14
8/8/2002,2,0,8,11,21
8/9/2002,4,0,5,6,15
8/10/2002,8,0,4,13,25
8/11/2002,4,0,3,9,16
8/12/2002,6,0,3,13,22
8/13/2002,4,0,3,4,11
8/14/2002,3,0,7,6,16
8/15/2002,7,0,2,8,17
8/16/2002,6,0,6,7,19
8/17/2002,5,0,3,8,16
8/18/2002,6,0,3,10,19
8/19/2002,4,0,2,0,6
8/20/2002,2,0,8,2,12
8/21/2002,3,0,7,9,19
8/22/2002,8,0,4,6,18
8/23/2002,2,0,6,11,19
8/24/2002,5,0,3,4,12
8/25/2002,4,0,4,13,21
8/26/2002,2,0,6,9,17
8/27/2002,4,0,2,5,11
8/28/2002,4,0,6,9,19
8/29/2002,8,0,6,7,21
8/30/2002,2,0,3,6,11
8/31/2002,4,0,2,13,19
9/1/2002,2,0,2,0,4
9/2/2002,8,0,4,3,15
9/3/2002,5,0,8,8,21
9/4/2002,8,0,3,8,19
9/5/2002,3,0,8,10,21
9/6/2002,2,0,4,8,14
9/7/2002,7,0,4,4,15
9/8/2002,6,0,5,0,11
9/9/2002,6,0,5,9,20
9/10/2002,4,0,3,12,19
9/11/2002,4,0,3,9,16
9/12/2002,4,0,8,8,20
9/13/2002,4,0,6,0,10
9/14/2002,6,0,5,5,16
9/15/2002,2,0,4,0,6
9/16/2002,5,0,3,11,19
9/17/2002,6,0,2,9,17
9/18/2002,8,0,3,1,12
9/19/2002,2,0,8,11,21
9/20/2002,5,0,7,6,18
9/21/2002,2,0,4,13,19
9/22/2002,5,0,3,10,18
9/23/2002,8,0,3,7,18
9/24/2002,6,0,2,6,14
9/25/2002,8,0,4,9,21
9/26/2002,6,0,3,8,17
9/27/2002,4,0,6,5,15
9/28/2002,8,0,7,9,24
9/29/2002,5,0,8,4,17
9/30/2002,2,0,2,3,7
10/1/2002,3,0,2,3,8
10/2/2002,7,0,5,10,22
10/3/2002,2,0,8,4,14
10/4/2002,2,0,8,5,15
10/5/2002,3,0,6,11,20
10/6/2002,2,0,3,2,7
10/7/2002,4,0,6,5,15
10/8/2002,3,0,4,2,9
10/9/2002,7,0,5,1,13
10/10/2002,7,0,8,7,22
10/11/2002,5,0,7,1,13
10/12/2002,4,0,6,12,22
10/13/2002,5,0,3,13,21
10/14/2002,8,0,5,6,19
10/15/2002,8,0,4,3,15
10/16/2002,2,0,3,10,15
10/17/2002,3,0,6,13,22
10/18/2002,5,0,5,13,23
10/19/2002,4,0,7,12,23
10/20/2002,5,0,7,7,19
10/21/2002,6,0,8,4,18
10/22/2002,6,0,7,7,20
10/23/2002,6,0,3,8,17
10/24/2002,8,0,7,0,15
10/25/2002,6,0,8,8,22
10/26/2002,4,0,6,10,20
10/27/2002,5,0,4,8,17
10/28/2002,5,0,5,5,15
10/29/2002,8,0,6,8,22
10/30/2002,4,0,8,3,15
10/31/2002,5,0,3,2,10
11/1/2002,2,0,4,0,6
11/2/2002,6,0,4,10,20
11/3/2002,5,0,6,3,14
11/4/2002,6,0,7,4,17
11/5/2002,4,0,6,9,19
11/6/2002,8,0,7,0,15
11/7/2002,2,0,2,6,10
11/8/2002,5,0,5,11,21
11/9/2002,2,0,3,10,15
11/10/2002,3,0,8,9,20
11/11/2002,8,0,2,1,11
11/12/2002,6,0,5,5,16
11/13/2002,2,0,7,0,9
11/14/2002,7,0,2,12,21
11/15/2002,8,0,2,2,12
11/16/2002,6,0,6,8,20
11/17/2002,7,0,3,10,20
11/18/2002,2,0,3,1,6
11/19/2002,3,0,8,3,14
11/20/2002,4,0,6,12,22
11/21/2002,6,0,3,10,19
11/22/2002,4,0,5,1,10
11/23/2002,3,0,8,11,22
11/24/2002,7,0,8,5,20
11/25/2002,6,0,6,10,22
11/26/2002,4,0,3,9,16
11/27/2002,3,0,4,11,18
11/28/2002,5,0,6,12,23
11/29/2002,5,0,3,8,16
11/30/2002,5,0,2,11,18
12/1/2002,4,0,6,6,16
12/2/2002,5,0,8,11,24
12/3/2002,8,0,3,4,15
12/4/2002,3,0,6,1,10
12/5/2002,5,0,2,12,19
12/6/2002,8,0,4,5,17
12/7/2002,7,0,3,10,20
12/8/2002,2,0,5,12,19
12/9/2002,7,0,7,13,27
12/10/2002,5,0,6,2,13
12/11/2002,6,0,8,7,21
12/12/2002,7,0,4,3,14
12/13/2002,7,0,6,1,14
12/14/2002,7,0,3,12,22
12/15/2002,5,0,3,7,15
12/16/2002,5,0,6,12,23
12/17/2002,8,0,3,10,21
12/18/2002,4,0,2,1,7
12/19/2002,8,0,7,11,26
12/20/2002,6,0,8,7,21
12/21/2002,6,0,3,2,11
12/22/2002,7,0,2,10,19
12/23/2002,7,0,2,4,13
12/24/2002,2,0,3,4,9
12/25/2002,8,0,5,7,20
12/26/2002,4,0,4,6,14
12/27/2002,7,0,8,3,18
12/28/2002,6,0,3,10,19
12/29/2002,2,0,3,2,7
12/30/2002,6,0,4,6,16
12/31/2002,6,0,4,7,17
1/1/2003,2,0,3,0,5
1/2/2003,2,0,2,5,9
1/3/2003,5,0,8,11,24
1/4/2003,7,0,6,10,23
1/5/2003,7,0,2,4,13
1/6/2003,8,0,7,8,23
1/7/2003,2,0,4,8,14
1/8/2003,4,0,7,4,15
1/9/2003,2,0,4,7,13
1/10/2003,6,0,4,8,18
1/11/2003,3,0,5,9,17
1/12/2003,6,0,7,4,17
1/13/2003,5,0,5,2,12
1/14/2003,5,0,6,4,15
1/15/2003,3,0,5,2,10
1/16/2003,8,0,2,2,12
1/17/2003,2,0,5,9,16
1/18/2003,5,0,6,11,22
1/19/2003,6,0,6,8,20
1/20/2003,5,0,5,11,21
1/21/2003,4,0,2,11,17
1/22/2003,3,0,8,4,15
1/23/2003,4,0,2,11,17
1/24/2003,6,0,6,7,19
1/25/2003,3,0,2,4,9
1/26/2003,4,0,2,4,10
1/27/2003,3,0,3,11,17
1/28/2003,6,0,3,9,18
1/29/2003,4,0,4,10,18
1/30/2003,8,0,8,13,29
1/31/2003,4,0,6,12,22
2/1/2003,2,0,4,9,15
2/2/2003,5,0,5,5,15
2/3/2003,6,0,8,11,25
2/4/2003,2,0,8,12,22
2/5/2003,3,0,8,9,20
2/6/2003,3,0,8,12,23
2/7/2003,8,0,8,10,26
2/8/2003,6,0,2,1,9
2/9/2003,8,0,5,12,25
2/10/2003,6,0,3,3,12
2/11/2003,5,0,5,5,15
2/12/2003,8,0,3,4,15
2/13/2003,3,0,5,9,17
2/14/2003,5,0,7,10,22
2/15/2003,4,0,3,6,13
2/16/2003,8,0,5,4,17
2/17/2003,6,0,6,4,16
2/18/2003,8,0,2,10,20
2/19/2003,7,0,3,8,18
2/20/2003,5,0,8,11,24
2/21/2003,5,0,6,10,21
2/22/2003,6,0,6,10,22
2/23/2003,8,0,6,6,20
2/24/2003,4,0,2,3,9
2/25/2003,7,0,8,5,20
2/26/2003,8,0,8,8,24
2/27/2003,7,0,2,6,15
2/28/2003,8,0,5,6,19
3/1/2003,8,0,3,9,20
3/2/2003,5,0,5,11,21
3/3/2003,8,0,3,0,11
3/4/2003,5,0,7,11,23
3/5/2003,8,0,7,7,22
3/6/2003,2,0,3,0,5
3/7/2003,3,0,8,1,12
3/8/2003,2,0,5,0,7
3/9/2003,2,0,5,1,8
3/10/2003,2,0,3,9,14
3/11/2003,4,0,6,3,13
3/12/2003,5,0,7,8,20
3/13/2003,3,0,8,10,21
3/14/2003,4,0,7,13,24
3/15/2003,7,0,4,5,16
3/16/2003,7,0,5,12,24
3/17/2003,7,0,6,2,15
3/18/2003,4,0,7,3,14
3/19/2003,7,0,5,12,24
3/20/2003,4,0,3,6,13
3/21/2003,6,0,4,6,16
3/22/2003,6,0,5,6,17
3/23/2003,6,0,8,5,19
3/24/2003,3,0,7,6,16
3/25/2003,4,0,4,6,14
3/26/2003,5,0,8,4,17
3/27/2003,6,0,8,10,24
3/28/2003,4,0,2,2,8
3/29/2003,5,0,6,4,15
3/30/2003,4,0,3,12,19
3/31/2003,7,0,3,3,13
4/1/2003,5,0,2,0,7
4/2/2003,8,0,3,1,12
4/3/2003,8,0,2,3,13
4/4/2003,6,0,4,10,20
4/5/2003,2,0,8,0,10
4/6/2003,5,0,4,2,11
4/7/2003,6,0,7,7,20
4/8/2003,3,0,8,3,14
4/9/2003,6,0,8,9,23
4/10/2003,5,0,2,2,9
4/11/2003,3,0,5,10,18
4/12/2003,7,0,7,7,21
4/13/2003,4,0,6,4,14
4/14/2003,7,0,2,10,19
4/15/2003,7,0,6,2,15
4/16/2003,5,0,5,10,20
4/17/2003,8,0,5,2,15
4/18/2003,5,0,3,0,8
4/19/2003,4,0,3,11,18
4/20/2003,4,0,8,4,16
4/21/2003,8,0,5,6,19
4/22/2003,2,0,8,2,12
4/23/2003,6,0,4,12,22
4/24/2003,8,0,4,11,23
4/25/2003,8,0,4,13,25
4/26/2003,4,0,8,1,13
4/27/2003,2,0,8,11,21
4/28/2003,8,0,5,12,25
4/29/2003,3,0,2,2,7
4/30/2003,6,0,8,10,24
5/1/2003,2,0,8,7,17
5/2/2003,3,0,5,2,10
5/3/2003,6,0,8,10,24
5/4/2003,4,0,5,0,9
5/5/2003,4,0,6,5,15
5/6/2003,4,0,5,1,10
5/7/2003,7,0,5,0,12
5/8/2003,5,0,2,7,14
5/9/2003,2,0,6,10,18
5/10/2003,3,0,3,3,9
5/11/2003,4,0,6,2,12
5/12/2003,6,0,7,0,13
5/13/2003,2,0,7,9,18
5/14/2003,7,0,2,7,16
5/15/2003,8,0,6,0,14
5/16/2003,2,0,8,9,19
5/17/2003,8,0,3,5,16
5/18/2003,7,0,2,10,19
5/19/2003,8,0,6,1,15
5/20/2003,4,0,7,5,16
5/21/2003,3,0,3,0,6
5/22/2003,6,0,6,13,25
5/23/2003,6,0,4,0,10
5/24/2003,5,0,5,12,22
5/25/2003,5,0,5,12,22
5/26/2003,3,0,8,12,23
5/27/2003,4,0,2,13,19
5/28/2003,3,0,2,2,7
5/29/2003,2,0,2,7,11
5/30/2003,5,0,4,11,20
5/31/2003,7,0,5,6,18
6/1/2003,5,0,5,7,17
6/2/2003,4,0,3,10,17
6/3/2003,2,0,4,2,8
6/4/2003,3,0,5,7,15
6/5/2003,2,0,4,5,11
6/6/2003,4,0,8,13,25
6/7/2003,2,0,4,12,18
6/8/2003,7,0,5,13,25
6/9/2003,6,0,6,6,18
6/10/2003,6,0,6,11,23
6/11/2003,5,0,5,9,19
6/12/2003,3,0,6,10,19
6/13/2003,7,0,6,0,13
6/14/2003,6,0,4,9,19
6/15/2003,7,0,8,11,26
6/16/2003,4,0,3,3,10
6/17/2003,4,0,7,5,16
6/18/2003,5,0,8,7,20
6/19/2003,7,0,2,0,9
6/20/2003,2,0,3,11,16
6/21/2003,4,0,8,2,14
6/22/2003,7,0,3,12,22
6/23/2003,2,0,5,0,7
6/24/2003,8,0,2,2,12
6/25/2003,4,0,2,8,14
6/26/2003,3,0,7,6,16
6/27/2003,8,0,2,5,15
6/28/2003,4,0,3,12,19
6/29/2003,7,0,5,4,16
6/30/2003,7,0,4,1,12
7/1/2003,7,0,2,5,14
7/2/2003,3,0,5,2,10
7/3/2003,2,0,3,5,10
7/4/2003,3,0,8,7,18
7/5/2003,7,0,5,11,23
7/6/2003,8,0,5,1,14
7/7/2003,3,0,5,3,11
7/8/2003,5,0,6,12,23
7/9/2003,3,0,4,0,7
7/10/2003,2,0,6,2,10
7/11/2003,5,0,5,11,21
7/12/2003,5,0,5,5,15
7/13/2003,5,0,2,8,15
7/14/2003,2,0,4,1,7
7/15/2003,6,0,4,9,19
7/16/2003,8,0,6,5,19
7/17/2003,2,0,8,1,11
7/18/2003,5,0,7,2,14
7/19/2003,6,0,3,6,15
7/20/2003,6,0,4,13,23
7/21/2003,2,0,3,12,17
7/22/2003,5,0,4,1,10
7/23/2003,5,0,2,11,18
7/24/2003,5,0,3,2,10
7/25/2003,6,0,8,0,14
7/26/2003,8,0,7,8,23
7/27/2003,7,0,4,7,18
7/28/2003,5,0,2,11,18
7/29/2003,2,0,7,11,20
7/30/2003,2,0,3,12,17
7/31/2003,6,0,8,11,25
8/1/2003,6,0,8,8,22
8/2/2003,6,0,3,11,20
8/3/2003,5,0,7,7,19
8/4/2003,7,0,7,7,21
8/5/2003,3,0,2,3,8
8/6/2003,5,0,5,8,18
8/7/2003,3,0,6,13,22
8/8/2003,6,0,6,7,19
8/9/2003,7,0,7,13,27
8/10/2003,7,0,3,4,14
8/11/2003,8,0,4,8,20
8/12/2003,7,0,6,1,14
8/13/2003,3,0,7,9,19
8/14/2003,6,0,2,9,17
8/15/2003,8,0,2,1,11
8/16/2003,4,0,4,13,21
8/17/2003,8,0,4,8,20
8/18/2003,2,0,5,10,17
8/19/2003,2,0,2,3,7
8/20/2003,7,0,6,11,24
8/21/2003,4,0,2,10,16
8/22/2003,3,0,7,4,14
8/23/2003,6,0,2,2,10
8/24/2003,8,0,8,1,17
8/25/2003,5,0,6,1,12
8/26/2003,7,0,3,0,10
8/27/2003,6,0,5,8,19
8/28/2003,7,0,4,13,24
8/29/2003,4,0,2,9,15
8/30/2003,7,0,4,12,23
8/31/2003,2,0,7,7,16
9/1/2003,4,0,8,13,25
9/2/2003,3,0,6,8,17
9/3/2003,5,0,6,12,23
9/4/2003,2,0,7,6,15
9/5/2003,5,0,5,9,19
9/6/2003,7,0,2,13,22
9/7/2003,7,0,8,1,16
9/8/2003,4,0,8,4,16
9/9/2003,3,0,8,1,12
9/10/2003,7,0,4,8,19
9/11/2003,6,0,2,13,21
9/12/2003,6,0,6,0,12
9/13/2003,4,0,8,9,21
9/14/2003,6,0,3,10,19
9/15/2003,7,0,2,10,19
9/16/2003,4,0,3,11,18
9/17/2003,6,0,5,13,24
9/18/2003,7,0,2,11,20
9/19/2003,7,0,4,5,16
9/20/2003,8,0,5,2,15
9/21/2003,2,0,8,6,16
9/22/2003,6,0,3,10,19
9/23/2003,4,0,2,13,19
9/24/2003,3,0,7,1,11
9/25/2003,6,0,6,11,23
9/26/2003,7,0,2,11,20
9/27/2003,3,0,5,6,14
9/28/2003,3,0,5,5,13
9/29/2003,7,0,3,5,15
9/30/2003,8,0,6,13,27
10/1/2003,6,0,8,6,20
10/2/2003,2,0,5,0,7
10/3/2003,7,0,7,4,18
10/4/2003,3,0,3,13,19
10/5/2003,7,0,3,7,17
10/6/2003,3,0,5,8,16
10/7/2003,8,0,6,13,27
10/8/2003,7,0,6,13,26
10/9/2003,3,0,5,11,19
10/10/2003,8,0,2,2,12
10/11/2003,6,0,4,8,18
10/12/2003,5,0,5,3,13
10/13/2003,7,0,3,12,22
10/14/2003,6,0,8,5,19
10/15/2003,8,0,7,7,22
10/16/2003,4,0,7,9,20
10/17/2003,8,0,8,11,27
10/18/2003,3,0,3,10,16
10/19/2003,2,0,7,4,13
10/20/2003,2,0,2,13,17
10/21/2003,3,0,7,4,14
10/22/2003,3,0,5,9,17
10/23/2003,7,0,5,0,12
10/24/2003,3,0,4,0,7
10/25/2003,2,0,6,8,16
10/26/2003,7,0,7,2,16
10/27/2003,2,0,8,7,17
10/28/2003,7,0,4,0,11
10/29/2003,4,0,7,3,14
10/30/2003,6,0,8,6,20
10/31/2003,4,0,4,3,11
11/1/2003,5,0,4,3,12
11/2/2003,3,0,3,11,17
11/3/2003,2,0,7,2,11
11/4/2003,5,0,8,7,20
11/5/2003,4,0,8,3,15
11/6/2003,6,0,4,4,14
11/7/2003,4,0,7,13,24
11/8/2003,5,0,2,13,20
11/9/2003,5,0,6,13,24
11/10/2003,3,0,7,7,17
11/11/2003,7,0,5,7,19
11/12/2003,3,0,7,7,17
11/13/2003,8,0,3,8,19
11/14/2003,4,0,5,7,16
11/15/2003,3,0,8,10,21
11/16/2003,2,0,8,9,19
11/17/2003,2,0,7,6,15
11/18/2003,4,0,2,7,13
11/19/2003,2,0,8,12,22
11/20/2003,2,0,5,3,10
11/21/2003,7,0,5,8,20
11/22/2003,5,0,3,7,15
11/23/2003,5,0,2,7,14
11/24/2003,5,0,3,0,8
11/25/2003,7,0,6,8,21
11/26/2003,3,0,3,13,19
11/27/2003,7,0,7,4,18
11/28/2003,7,0,5,11,23
11/29/2003,2,0,7,0,9
11/30/2003,7,0,4,11,22
12/1/2003,3,0,7,5,15
12/2/2003,5,0,8,9,22
12/3/2003,8,0,8,8,24
12/4/2003,8,0,7,5,20
12/5/2003,6,0,4,1,11
12/6/2003,7,0,7,2,16
12/7/2003,8,0,5,10,23
12/8/2003,3,0,4,0,7
12/9/2003,6,0,3,8,17
12/10/2003,5,0,3,10,18
12/11/2003,2,0,6,5,13
12/12/2003,7,0,2,11,20
12/13/2003,7,0,8,8,23
12/14/2003,5,0,6,12,23
12/15/2003,8,0,7,0,15
12/16/2003,6,0,8,12,26
12/17/2003,6,0,5,4,15
12/18/2003,2,0,7,3,12
12/19/2003,7,0,7,8,22
12/20/2003,6,0,2,6,14
12/21/2003,3,0,7,6,16
12/22/2003,3,0,5,2,10
12/23/2003,7,0,7,10,24
12/24/2003,8,0,8,1,17
12/25/2003,4,0,6,11,21
12/26/2003,5,0,8,13,26
12/27/2003,4,0,4,6,14
12/28/2003,6,0,2,3,11
12/29/2003,7,0,6,4,17
12/30/2003,3,0,2,9,14
12/31/2003,8,0,7,12,27
1/1/2004,2,0,5,7,14
1/2/2004,6,0,2,12,20
1/3/2004,5,0,4,2,11
1/4/2004,5,0,7,3,15
1/5/2004,4,0,2,12,18
1/6/2004,5,0,3,5,13
1/7/2004,4,0,3,1,8
1/8/2004,2,0,5,11,18
1/9/2004,4,0,4,1,9
1/10/2004,2,0,3,0,5
1/11/2004,3,0,6,1,10
1/12/2004,5,0,7,8,20
1/13/2004,7,0,5,12,24
1/14/2004,2,0,4,3,9
1/15/2004,6,0,3,0,9
1/16/2004,2,0,8,10,20
1/17/2004,4,0,4,9,17
1/18/2004,6,0,3,0,9
1/19/2004,7,0,8,0,15
1/20/2004,4,0,4,9,17
1/21/2004,8,0,8,5,21
1/22/2004,5,0,6,7,18
1/23/2004,4,0,5,11,20
1/24/2004,2,0,8,10,20
1/25/2004,5,0,4,7,16
1/26/2004,3,0,4,1,8
1/27/2004,5,0,2,1,8
1/28/2004,3,0,5,11,19
1/29/2004,4,0,2,1,7
1/30/2004,8,0,3,3,14
1/31/2004,7,0,7,10,24
2/1/2004,5,0,8,1,14
2/2/2004,5,0,4,8,17
2/3/2004,6,0,5,7,18
2/4/2004,8,0,4,8,20
2/5/2004,3,0,4,12,19
2/6/2004,7,0,8,8,23
2/7/2004,4,0,3,9,16
2/8/2004,5,0,8,9,22
2/9/2004,4,0,2,3,9
2/10/2004,7,0,7,12,26
2/11/2004,8,0,6,2,16
2/12/2004,7,0,8,1,16
2/13/2004,6,0,2,12,20
2/14/2004,6,0,3,8,17
2/15/2004,7,0,7,0,14
2/16/2004,3,0,7,9,19
2/17/2004,6,0,5,11,22
2/18/2004,4,0,5,4,13
2/19/2004,4,0,5,0,9
2/20/2004,2,0,6,8,16
2/21/2004,2,0,4,0,6
2/22/2004,3,0,3,7,13
2/23/2004,2,0,4,4,10
2/24/2004,4,0,3,12,19
2/25/2004,2,0,7,1,10
2/26/2004,2,0,8,10,20
2/27/2004,6,0,8,4,18
2/28/2004,4,0,8,12,24
2/29/2004,3,0,8,1,12
3/1/2004,2,0,8,3,13
3/2/2004,4,0,4,11,19
3/3/2004,8,0,8,3,19
3/4/2004,7,0,3,4,14
3/5/2004,5,0,5,12,22
3/6/2004,3,0,5,4,12
3/7/2004,6,0,8,1,15
3/8/2004,6,0,2,5,13
3/9/2004,5,0,5,7,17
3/10/2004,8,0,3,7,18
3/11/2004,5,0,3,4,12
3/12/2004,5,0,3,8,16
3/13/2004,6,0,7,2,15
3/14/2004,8,0,8,0,16
3/15/2004,2,0,3,11,16
3/16/2004,4,0,4,6,14
3/17/2004,5,0,3,2,10
3/18/2004,6,0,3,8,17
3/19/2004,3,0,2,0,5
3/20/2004,8,0,6,9,23
3/21/2004,8,0,2,6,16
3/22/2004,2,0,6,0,8
3/23/2004,4,0,5,1,10
3/24/2004,6,0,3,9,18
3/25/2004,6,0,6,3,15
3/26/2004,5,0,4,7,16
3/27/2004,4,0,7,2,13
3/28/2004,6,0,7,2,15
3/29/2004,4,0,5,4,13
3/30/2004,7,0,7,9,23
3/31/2004,7,0,4,9,20
4/1/2004,2,0,7,7,16
4/2/2004,6,0,5,6,17
4/3/2004,8,0,3,8,19
4/4/2004,8,0,4,13,25
4/5/2004,2,0,6,5,13
4/6/2004,5,0,5,1,11
4/7/2004,7,0,5,6,18
4/8/2004,8,0,5,13,26
4/9/2004,6,0,2,2,10
4/10/2004,6,0,4,11,21
4/11/2004,3,0,5,4,12
4/12/2004,2,0,4,10,16
4/13/2004,3,0,6,0,9
4/14/2004,4,0,3,0,7
4/15/2004,8,0,4,5,17
4/16/2004,2,0,4,0,6
4/17/2004,2,0,2,6,10
4/18/2004,3,0,8,2,13
4/19/2004,6,0,8,12,26
4/20/2004,3,0,7,4,14
4/21/2004,8,0,3,8,19
4/22/2004,2,0,6,8,16
4/23/2004,6,0,7,10,23
4/24/2004,2,0,7,4,13
4/25/2004,6,0,4,13,23
4/26/2004,4,0,4,7,15
4/27/2004,7,0,4,1,12
4/28/2004,6,0,3,3,12
4/29/2004,7,0,3,0,10
4/30/2004,5,0,7,9,21
5/1/2004,3,0,5,2,10
5/2/2004,8,0,4,2,14
5/3/2004,5,0,8,10,23
5/4/2004,6,0,7,5,18
5/5/2004,6,0,5,6,17
5/6/2004,6,0,6,5,17
5/7/2004,3,0,2,7,12
5/8/2004,8,0,6,4,18
5/9/2004,6,0,7,12,25
5/10/2004,6,0,8,1,15
5/11/2004,5,0,3,0,8
5/12/2004,5,0,8,5,18
5/13/2004,7,0,4,5,16
5/14/2004,5,0,4,10,19
5/15/2004,8,0,7,3,18
5/16/2004,2,0,8,3,13
5/17/2004,7,0,6,7,20
5/18/2004,3,0,7,6,16
5/19/2004,7,0,5,1,13
5/20/2004,5,0,8,1,14
5/21/2004,8,0,3,0,11
5/22/2004,3,0,6,2,11
5/23/2004,2,0,7,8,17
5/24/2004,8,0,5,6,19
5/25/2004,2,0,6,2,10
5/26/2004,6,0,8,5,19
5/27/2004,8,0,7,8,23
5/28/2004,3,0,4,12,19
5/29/2004,2,0,3,10,15
5/30/2004,2,0,5,8,15
5/31/2004,3,0,4,12,19
6/1/2004,4,0,8,0,12
6/2/2004,4,0,5,11,20
6/3/2004,3,0,4,8,15
6/4/2004,8,0,3,1,12
6/5/2004,2,0,4,0,6
6/6/2004,3,0,7,9,19
6/7/2004,2,0,8,3,13
6/8/2004,8,0,5,12,25
6/9/2004,3,0,3,9,15
6/10/2004,7,0,5,1,13
6/11/2004,5,0,3,4,12
6/12/2004,2,0,3,6,11
6/13/2004,8,0,2,13,23
6/14/2004,7,0,5,0,12
6/15/2004,3,0,6,2,11
6/16/2004,2,0,4,12,18
6/17/2004,6,0,5,6,17
6/18/2004,3,0,5,10,18
6/19/2004,3,0,5,1,9
6/20/2004,6,0,4,6,16
6/21/2004,2,0,5,2,9
6/22/2004,8,0,6,2,16
6/23/2004,8,0,5,4,17
6/24/2004,4,0,8,13,25
6/25/2004,4,0,6,5,15
6/26/2004,7,0,7,6,20
6/27/2004,3,0,3,13,19
6/28/2004,7,0,5,4,16
6/29/2004,2,0,4,2,8
6/30/2004,7,0,3,4,14
7/1/2004,8,0,4,7,19
7/2/2004,6,0,3,6,15
7/3/2004,6,0,5,3,14
7/4/2004,2,0,7,7,16
7/5/2004,7,0,3,7,17
7/6/2004,8,0,4,2,14
7/7/2004,5,0,2,10,17
7/8/2004,8,0,4,9,21
7/9/2004,4,0,2,6,12
7/10/2004,4,0,6,3,13
7/11/2004,2,0,8,11,21
7/12/2004,8,0,6,12,26
7/13/2004,3,0,6,5,14
7/14/2004,4,0,5,12,21
7/15/2004,8,0,8,7,23
7/16/2004,5,0,6,8,19
7/17/2004,8,0,3,4,15
7/18/2004,7,0,4,8,19
7/19/2004,8,0,4,13,25
7/20/2004,4,0,4,10,18
7/21/2004,5,0,2,3,10
7/22/2004,3,0,3,2,8
7/23/2004,2,0,4,11,17
7/24/2004,7,0,6,11,24
7/25/2004,3,0,2,13,18
7/26/2004,2,0,4,8,14
7/27/2004,2,0,5,4,11
7/28/2004,2,0,7,7,16
7/29/2004,8,0,2,9,19
7/30/2004,6,0,8,0,14
7/31/2004,3,0,6,9,18
8/1/2004,7,0,4,0,11
8/2/2004,7,0,7,8,22
8/3/2004,7,0,2,0,9
8/4/2004,6,0,5,13,24
8/5/2004,6,0,7,10,23
8/6/2004,6,0,8,12,26
8/7/2004,8,0,8,5,21
8/8/2004,6,0,5,11,22
8/9/2004,6,0,8,0,14
8/10/2004,8,0,7,12,27
8/11/2004,4,0,2,6,12
8/12/2004,7,0,4,10,21
8/13/2004,5,0,2,2,9
8/14/2004,2,0,3,12,17
8/15/2004,2,0,4,10,16
8/16/2004,5,0,6,8,19
8/17/2004,7,0,4,13,24
8/18/2004,3,0,6,13,22
8/19/2004,8,0,3,2,13
8/20/2004,7,0,8,0,15
8/21/2004,8,0,7,3,18
8/22/2004,6,0,6,12,24
8/23/2004,2,0,4,4,10
8/24/2004,5,0,7,12,24
8/25/2004,6,0,3,0,9
8/26/2004,7,0,4,1,12
8/27/2004,7,0,3,4,14
8/28/2004,4,0,3,4,11
8/29/2004,4,0,8,11,23
8/30/2004,8,0,6,0,14
8/31/2004,8,0,8,5,21
9/1/2004,4,0,3,13,20
9/2/2004,8,0,5,0,13
9/3/2004,6,0,8,12,26
9/4/2004,3,0,3,11,17
9/5/2004,6,0,5,11,22
9/6/2004,5,0,8,3,16
9/7/2004,4,0,3,8,15
9/8/2004,3,0,5,6,14
9/9/2004,6,0,2,7,15
9/10/2004,4,0,6,5,15
9/11/2004,2,0,5,5,12
9/12/2004,6,0,6,5,17
9/13/2004,6,0,3,10,19
9/14/2004,3,0,8,13,24
9/15/2004,7,0,5,0,12
9/16/2004,3,0,7,0,10
9/17/2004,2,0,3,9,14
9/18/2004,6,0,2,9,17
9/19/2004,6,0,5,8,19
9/20/2004,4,0,2,7,13
9/21/2004,2,0,5,8,15
9/22/2004,5,0,6,3,14
9/23/2004,8,0,6,9,23
9/24/2004,7,0,4,8,19
9/25/2004,3,0,6,11,20
9/26/2004,8,0,8,2,18
9/27/2004,5,0,2,12,19
9/28/2004,6,0,2,2,10
9/29/2004,8,0,5,1,14
9/30/2004,7,0,4,1,12
10/1/2004,4,0,7,1,12
10/2/2004,2,0,6,13,21
10/3/2004,6,0,2,12,20
10/4/2004,3,0,7,1,11
10/5/2004,8,0,4,5,17
10/6/2004,7,0,8,11,26
10/7/2004,4,0,6,0,10
10/8/2004,2,0,3,1,6
10/9/2004,2,0,3,6,11
10/10/2004,6,0,2,9,17
10/11/2004,2,0,3,1,6
10/12/2004,5,0,8,4,17
10/13/2004,2,0,2,4,8
10/14/2004,2,0,6,13,21
10/15/2004,4,0,4,13,21
10/16/2004,8,0,4,1,13
10/17/2004,7,0,4,8,19
10/18/2004,2,0,8,5,15
10/19/2004,3,0,3,2,8
10/20/2004,3,0,8,13,24
10/21/2004,6,0,8,2,16
10/22/2004,3,0,5,1,9
10/23/2004,8,0,7,1,16
10/24/2004,7,0,7,4,18
10/25/2004,5,0,3,5,13
10/26/2004,3,0,8,5,16
10/27/2004,5,0,3,11,19
10/28/2004,6,0,6,12,24
10/29/2004,8,0,8,5,21
10/30/2004,2,0,4,7,13
10/31/2004,7,0,3,6,16
11/1/2004,8,0,2,7,17
11/2/2004,5,0,2,12,19
11/3/2004,2,0,8,4,14
11/4/2004,5,0,8,1,14
11/5/2004,7,0,2,0,9
11/6/2004,4,0,5,13,22
11/7/2004,5,0,7,5,17
11/8/2004,6,0,4,9,19
11/9/2004,5,0,4,1,10
11/10/2004,7,0,6,13,26
11/11/2004,6,0,7,13,26
11/12/2004,3,0,5,4,12
11/13/2004,6,0,6,4,16
11/14/2004,8,0,6,9,23
11/15/2004,6,0,2,11,19
11/16/2004,7,0,3,12,22
11/17/2004,6,0,7,7,20
11/18/2004,7,0,5,11,23
11/19/2004,8,0,6,1,15
11/20/2004,8,0,3,2,13
11/21/2004,5,0,3,0,8
11/22/2004,5,0,6,1,12
11/23/2004,5,0,6,11,22
11/24/2004,7,0,5,13,25
11/25/2004,5,0,3,11,19
11/26/2004,8,0,3,12,23
11/27/2004,7,0,4,13,24
11/28/2004,8,0,3,4,15
11/29/2004,3,0,4,11,18
11/30/2004,4,0,5,7,16
12/1/2004,3,0,4,10,17
12/2/2004,3,0,3,8,14
12/3/2004,5,0,2,7,14
12/4/2004,4,0,2,0,6
12/5/2004,7,0,3,8,18
12/6/2004,6,0,3,7,16
12/7/2004,2,0,6,5,13
12/8/2004,8,0,7,7,22
12/9/2004,5,0,6,1,12
12/10/2004,3,0,8,2,13
12/11/2004,5,0,4,12,21
12/12/2004,4,0,4,12,20
12/13/2004,6,0,2,10,18
12/14/2004,5,0,3,3,11
12/15/2004,7,0,8,11,26
12/16/2004,6,0,4,8,18
12/17/2004,8,0,7,13,28
12/18/2004,5,0,2,13,20
12/19/2004,2,0,8,9,19
12/20/2004,8,0,3,12,23
12/21/2004,6,0,4,3,13
12/22/2004,4,0,8,13,25
12/23/2004,7,0,3,4,14
12/24/2004,2,0,8,1,11
12/25/2004,2,0,5,1,8
12/26/2004,8,0,5,8,21
12/27/2004,6,0,4,5,15
12/28/2004,7,0,7,3,17
12/29/2004,3,0,2,1,6
12/30/2004,3,0,6,5,14
12/31/2004,3,0,7,10,20
1/1/2005,6,0,4,7,17
1/2/2005,8,0,6,8,22
1/3/2005,4,0,4,1,9
1/4/2005,2,0,5,3,10
1/5/2005,6,0,4,8,18
1/6/2005,4,0,7,13,24
1/7/2005,7,0,2,12,21
1/8/2005,7,0,6,11,24
1/9/2005,2,0,2,7,11
1/10/2005,3,0,5,10,18
1/11/2005,5,0,6,4,15
1/12/2005,2,0,3,9,14
1/13/2005,4,0,4,9,17
1/14/2005,8,0,5,10,23
1/15/2005,7,0,2,10,19
1/16/2005,5,0,4,2,11
1/17/2005,7,0,5,1,13
1/18/2005,4,0,2,8,14
1/19/2005,6,0,8,7,21
1/20/2005,6,0,2,7,15
1/21/2005,5,0,3,13,21
1/22/2005,5,0,2,2,9
1/23/2005,2,0,2,4,8
1/24/2005,5,0,4,9,18
1/25/2005,6,0,2,8,16
1/26/2005,3,0,8,3,14
1/27/2005,5,0,2,8,15
1/28/2005,5,0,3,12,20
1/29/2005,6,0,8,6,20
1/30/2005,6,0,7,11,24
1/31/2005,7,0,3,4,14
2/1/2005,6,0,3,5,14
2/2/2005,2,0,2,7,11
2/3/2005,5,0,5,6,16
2/4/2005,7,0,3,4,14
2/5/2005,5,0,6,13,24
2/6/2005,4,0,2,0,6
2/7/2005,5,0,3,3,11
2/8/2005,3,0,5,5,13
2/9/2005,6,0,8,8,22
2/10/2005,3,0,7,2,12
2/11/2005,7,0,5,4,16
2/12/2005,5,0,4,0,9
2/13/2005,7,0,7,11,25
2/14/2005,7,0,2,3,12
2/15/2005,4,0,3,10,17
2/16/2005,5,0,4,13,22
2/17/2005,4,0,8,11,23
2/18/2005,5,0,3,10,18
2/19/2005,5,0,8,5,18
2/20/2005,6,0,4,11,21
2/21/2005,8,0,5,12,25
2/22/2005,8,0,8,12,28
2/23/2005,8,0,4,0,12
2/24/2005,6,0,8,1,15
2/25/2005,6,0,3,9,18
2/26/2005,4,0,6,6,16
2/27/2005,7,0,4,1,12
2/28/2005,5,0,8,5,18
3/1/2005,8,0,4,11,23
3/2/2005,4,0,6,9,19
3/3/2005,8,0,7,0,15
3/4/2005,4,0,2,10,16
3/5/2005,6,0,4,8,18
3/6/2005,7,0,4,13,24
3/7/2005,7,0,5,11,23
3/8/2005,6,0,2,9,17
3/9/2005,6,0,5,9,20
3/10/2005,8,0,2,5,15
3/11/2005,7,0,6,3,16
3/12/2005,3,0,8,10,21
3/13/2005,8,0,8,12,28
3/14/2005,7,0,3,0,10
3/15/2005,6,0,8,9,23
3/16/2005,7,0,7,3,17
3/17/2005,8,0,2,5,15
3/18/2005,7,0,2,3,12
3/19/2005,6,0,2,11,19
3/20/2005,4,0,5,4,13
3/21/2005,3,0,8,8,19
3/22/2005,2,0,3,13,18
3/23/2005,6,0,7,1,14
3/24/2005,2,0,3,6,11
3/25/2005,8,0,4,11,23
3/26/2005,3,0,7,13,23
3/27/2005,8,0,7,12,27
3/28/2005,2,0,2,9,13
3/29/2005,8,0,7,13,28
3/30/2005,8,0,3,6,17
3/31/2005,5,0,2,8,15
4/1/2005,7,0,8,6,21
4/2/2005,8,0,3,4,15
4/3/2005,8,0,8,1,17
4/4/2005,5,0,5,11,21
4/5/2005,3,0,3,3,9
4/6/2005,5,0,8,10,23
4/7/2005,4,0,8,4,16
4/8/2005,8,0,8,10,26
4/9/2005,6,0,7,1,14
4/10/2005,5,0,4,12,21
4/11/2005,7,0,3,13,23
4/12/2005,8,0,8,5,21
4/13/2005,2,0,4,0,6
4/14/2005,6,0,6,13,25
4/15/2005,5,0,7,3,15
4/16/2005,5,0,8,11,24
4/17/2005,7,0,7,7,21
4/18/2005,5,0,5,5,15
4/19/2005,4,0,5,8,17
4/20/2005,5,0,4,1,10
4/21/2005,7,0,2,9,18
4/22/2005,3,0,8,4,15
4/23/2005,7,0,3,3,13
4/24/2005,8,0,8,1,17
4/25/2005,7,0,4,10,21
4/26/2005,4,0,4,2,10
4/27/2005,5,0,7,9,21
4/28/2005,2,0,6,11,19
4/29/2005,3,0,2,5,10
4/30/2005,5,0,4,3,12
5/1/2005,2,0,4,0,6
5/2/2005,6,0,7,0,13
5/3/2005,7,0,2,5,14
5/4/2005,4,0,7,12,23
5/5/2005,4,0,2,1,7
5/6/2005,7,0,6,4,17
5/7/2005,8,0,8,8,24
5/8/2005,6,0,8,8,22
5/9/2005,5,0,8,9,22
5/10/2005,8,0,8,8,24
5/11/2005,5,0,7,3,15
5/12/2005,4,0,8,1,13
5/13/2005,3,0,6,4,13
5/14/2005,6,0,3,9,18
5/15/2005,3,0,4,1,8
5/16/2005,4,0,5,11,20
5/17/2005,2,0,8,5,15
5/18/2005,8,0,5,9,22
5/19/2005,3,0,3,7,13
5/20/2005,4,0,4,0,8
5/21/2005,5,0,4,8,17
5/22/2005,8,0,6,7,21
5/23/2005,4,0,5,6,15
5/24/2005,3,0,4,11,18
5/25/2005,4,0,3,0,7
5/26/2005,6,0,6,8,20
5/27/2005,6,0,6,8,20
5/28/2005,3,0,7,9,19
5/29/2005,8,0,5,2,15
5/30/2005,2,0,7,10,19
5/31/2005,3,0,5,3,11
6/1/2005,5,0,4,9,18
6/2/2005,6,0,2,3,11
6/3/2005,2,0,8,5,15
6/4/2005,5,0,4,1,10
6/5/2005,2,0,8,2,12
6/6/2005,5,0,3,6,14
6/7/2005,2,0,5,9,16
6/8/2005,6,0,2,0,8
6/9/2005,7,0,6,4,17
6/10/2005,3,0,7,9,19
6/11/2005,5,0,7,4,16
6/12/2005,5,0,8,9,22
6/13/2005,3,0,5,8,16
6/14/2005,6,0,6,1,13
6/15/2005,8,0,5,7,20
6/16/2005,7,0,3,4,14
6/17/2005,4,0,4,6,14
6/18/2005,3,0,8,5,16
6/19/2005,5,0,5,12,22
6/20/2005,4,0,6,9,19
6/21/2005,5,0,8,2,15
6/22/2005,2,0,3,10,15
6/23/2005,6,0,7,7,20
6/24/2005,8,0,5,1,14
6/25/2005,8,0,8,1,17
6/26/2005,7,0,3,13,23
6/27/2005,4,0,3,2,9
6/28/2005,2,0,4,11,17
6/29/2005,5,0,5,6,16
6/30/2005,8,0,7,11,26
7/1/2005,6,0,8,8,22
7/2/2005,2,0,4,3,9
7/3/2005,8,0,7,0,15
7/4/2005,7,0,2,0,9
7/5/2005,8,0,7,0,15
7/6/2005,7,0,4,8,19
7/7/2005,5,0,8,10,23
7/8/2005,4,0,2,2,8
7/9/2005,7,0,3,7,17
7/10/2005,4,0,2,8,14
7/11/2005,7,0,8,1,16
7/12/2005,5,0,2,11,18
7/13/2005,6,0,8,13,27
7/14/2005,2,0,6,0,8
7/15/2005,5,0,6,4,15
7/16/2005,3,0,8,8,19
7/17/2005,6,0,8,3,17
7/18/2005,5,0,2,7,14
7/19/2005,2,0,4,8,14
7/20/2005,5,0,7,2,14
7/21/2005,2,0,3,12,17
7/22/2005,5,0,7,12,24
7/23/2005,2,0,2,2,6
7/24/2005,4,0,3,8,15
7/25/2005,6,0,7,4,17
7/26/2005,6,0,4,12,22
7/27/2005,5,0,6,8,19
7/28/2005,6,0,2,2,10
7/29/2005,6,0,4,11,21
7/30/2005,6,0,5,10,21
7/31/2005,4,0,7,4,15
8/1/2005,7,0,3,9,19
8/2/2005,3,0,2,13,18
8/3/2005,3,0,7,8,18
8/4/2005,2,0,4,12,18
8/5/2005,3,0,7,8,18
8/6/2005,8,0,4,10,22
8/7/2005,7,0,2,7,16
8/8/2005,8,0,3,13,24
8/9/2005,2,0,8,3,13
8/10/2005,8,0,5,8,21
8/11/2005,6,0,3,1,10
8/12/2005,2,0,6,13,21
8/13/2005,8,0,8,2,18
8/14/2005,2,0,3,13,18
8/15/2005,3,0,8,12,23
8/16/2005,8,0,4,7,19
8/17/2005,2,0,2,5,9
8/18/2005,4,0,7,7,18
8/19/2005,7,0,5,5,17
8/20/2005,4,0,2,0,6
8/21/2005,5,0,8,11,24
8/22/2005,4,0,7,11,22
8/23/2005,8,0,2,11,21
8/24/2005,7,0,2,13,22
8/25/2005,5,0,6,5,16
8/26/2005,3,0,5,4,12
8/27/2005,5,0,2,0,7
8/28/2005,4,0,4,1,9
8/29/2005,4,0,4,0,8
8/30/2005,2,0,2,6,10
8/31/2005,5,0,3,5,13
9/1/2005,3,0,8,5,16
9/2/2005,6,0,6,0,12
9/3/2005,4,0,4,1,9
9/4/2005,3,0,3,7,13
9/5/2005,7,0,7,12,26
9/6/2005,4,0,4,5,13
9/7/2005,2,0,7,9,18
9/8/2005,4,0,3,10,17
9/9/2005,8,0,7,4,19
9/10/2005,7,0,3,9,19
9/11/2005,7,0,8,11,26
9/12/2005,2,0,7,12,21
9/13/2005,2,0,8,7,17
9/14/2005,2,0,3,6,11
9/15/2005,4,0,4,0,8
9/16/2005,7,0,5,1,13
9/17/2005,6,0,5,1,12
9/18/2005,6,0,5,12,23
9/19/2005,7,0,3,4,14
9/20/2005,7,0,5,12,24
9/21/2005,3,0,8,11,22
9/22/2005,6,0,6,5,17
9/23/2005,4,0,4,8,16
9/24/2005,2,0,4,1,7
9/25/2005,8,0,4,10,22
9/26/2005,8,0,4,8,20
9/27/2005,2,0,5,2,9
9/28/2005,4,0,5,4,13
9/29/2005,2,0,8,10,20
9/30/2005,3,0,7,9,19
10/1/2005,2,0,4,1,7
10/2/2005,2,0,7,2,11
10/3/2005,2,0,7,0,9
10/4/2005,7,0,4,12,23
10/5/2005,8,0,3,11,22
10/6/2005,8,0,7,6,21
10/7/2005,2,0,7,8,17
10/8/2005,5,0,7,9,21
10/9/2005,7,0,3,10,20
10/10/2005,4,0,5,0,9
10/11/2005,4,0,3,3,10
10/12/2005,6,0,6,13,25
10/13/2005,3,0,8,4,15
10/14/2005,6,0,5,0,11
10/15/2005,8,0,8,3,19
10/16/2005,8,0,6,1,15
10/17/2005,8,0,3,3,14
10/18/2005,2,0,6,6,14
10/19/2005,2,0,7,10,19
10/20/2005,7,0,5,11,23
10/21/2005,7,0,7,7,21
10/22/2005,8,0,7,13,28
10/23/2005,3,0,8,1,12
10/24/2005,3,0,7,3,13
10/25/2005,2,0,2,8,12
10/26/2005,3,0,3,5,11
10/27/2005,8,0,8,11,27
10/28/2005,3,0,7,11,21
10/29/2005,5,0,5,6,16
10/30/2005,6,0,4,8,18
10/31/2005,8,0,8,6,22
11/1/2005,3,0,4,6,13
11/2/2005,7,0,3,1,11
11/3/2005,3,0,5,8,16
11/4/2005,7,0,6,7,20
11/5/2005,3,0,3,12,18
11/6/2005,8,0,5,4,17
11/7/2005,4,0,5,8,17
11/8/2005,3,0,6,3,12
11/9/2005,2,0,3,13,18
11/10/2005,4,0,2,3,9
11/11/2005,7,0,5,13,25
11/12/2005,6,0,3,11,20
11/13/2005,2,0,3,11,16
11/14/2005,8,0,2,3,13
11/15/2005,6,0,8,4,18
11/16/2005,4,0,3,7,14
11/17/2005,4,0,6,2,12
11/18/2005,6,0,8,9,23
11/19/2005,2,0,5,4,11
11/20/2005,8,0,3,10,21
11/21/2005,2,0,4,9,15
11/22/2005,2,0,2,1,5
11/23/2005,8,0,7,10,25
11/24/2005,8,0,7,9,24
11/25/2005,2,0,5,5,12
11/26/2005,6,0,4,12,22
11/27/2005,4,0,3,2,9
11/28/2005,7,0,8,6,21
11/29/2005,2,0,7,7,16
11/30/2005,4,0,4,6,14
12/1/2005,5,0,4,13,22
12/2/2005,5,0,3,13,21
12/3/2005,3,0,8,9,20
12/4/2005,3,0,2,8,13
12/5/2005,3,0,2,12,17
12/6/2005,8,0,5,2,15
12/7/2005,4,0,3,6,13
12/8/2005,4,0,6,3,13
12/9/2005,8,0,8,4,20
12/10/2005,5,0,6,10,21
12/11/2005,3,0,7,6,16
12/12/2005,2,0,2,11,15
12/13/2005,8,0,4,10,22
12/14/2005,2,0,7,8,17
12/15/2005,5,0,3,0,8
12/16/2005,2,0,7,9,18
12/17/2005,4,0,2,1,7
12/18/2005,8,0,7,4,19
12/19/2005,6,0,7,3,16
12/20/2005,8,0,5,6,19
12/21/2005,3,0,2,13,18
12/22/2005,3,0,5,2,10
12/23/2005,4,0,4,5,13
12/24/2005,4,0,5,10,19
12/25/2005,4,0,2,5,11
12/26/2005,7,0,8,1,16
12/27/2005,5,0,2,12,19
12/28/2005,3,0,4,1,8
12/29/2005,5,0,4,6,15
12/30/2005,8,0,3,7,18
12/31/2005,8,0,2,4,14
1/1/2006,6,0,5,3,14
1/2/2006,2,0,8,8,18
1/3/2006,7,0,6,10,23
1/4/2006,5,0,2,2,9
1/5/2006,2,0,3,12,17
1/6/2006,3,0,3,6,12
1/7/2006,3,0,2,5,10
1/8/2006,5,0,2,3,10
1/9/2006,6,0,5,11,22
1/10/2006,2,0,4,8,14
1/11/2006,3,0,8,1,12
1/12/2006,6,0,4,8,18
1/13/2006,5,0,5,11,21
1/14/2006,6,0,7,7,20
1/15/2006,3,0,3,3,9
1/16/2006,5,0,2,5,12
1/17/2006,7,0,5,8,20
1/18/2006,7,0,3,1,11
1/19/2006,2,0,6,2,10
1/20/2006,7,0,4,8,19
1/21/2006,4,0,4,3,11
1/22/2006,6,0,2,9,17
1/23/2006,8,0,7,10,25
1/24/2006,6,0,6,1,13
1/25/2006,3,0,5,2,10
1/26/2006,3,0,3,8,14
1/27/2006,8,0,4,0,12
1/28/2006,7,0,8,2,17
1/29/2006,8,0,3,12,23
1/30/2006,8,0,3,1,12
1/31/2006,7,0,8,6,21
2/1/2006,5,0,8,1,14
2/2/2006,2,0,2,11,15
2/3/2006,2,0,7,5,14
2/4/2006,6,0,4,12,22
2/5/2006,7,0,5,6,18
2/6/2006,3,0,7,0,10
2/7/2006,6,0,7,13,26
2/8/2006,3,0,4,1,8
2/9/2006,2,0,3,5,10
2/10/2006,7,0,3,2,12
2/11/2006,7,0,3,4,14
2/12/2006,3,0,3,2,8
2/13/2006,6,0,5,12,23
2/14/2006,2,0,5,11,18
2/15/2006,7,0,3,4,14
2/16/2006,7,0,2,9,18
2/17/2006,3,0,2,4,9
2/18/2006,4,0,7,12,23
2/19/2006,7,0,4,7,18
2/20/2006,5,0,4,13,22
2/21/2006,6,0,6,7,19
2/22/2006,7,0,5,13,25
2/23/2006,2,0,8,0,10
2/24/2006,4,0,4,10,18
2/25/2006,2,0,5,11,18
2/26/2006,5,0,8,3,16
2/27/2006,2,0,6,3,11
2/28/2006,4,0,2,5,11
3/1/2006,2,0,7,6,15
3/2/2006,2,0,3,12,17
3/3/2006,5,0,2,11,18
3/4/2006,5,0,7,7,19
3/5/2006,6,0,3,11,20
3/6/2006,2,0,8,0,10
3/7/2006,5,0,2,9,16
3/8/2006,2,0,3,2,7
3/9/2006,7,0,2,4,13
3/10/2006,8,0,2,0,10
3/11/2006,8,0,3,4,15
3/12/2006,2,0,3,6,11
3/13/2006,7,0,4,13,24
3/14/2006,6,0,4,8,18
3/15/2006,8,0,6,9,23
3/16/2006,8,0,6,13,27
3/17/2006,7,0,7,7,21
3/18/2006,7,0,8,12,27
3/19/2006,4,0,3,9,16
3/20/2006,3,0,4,3,10
3/21/2006,7,0,5,13,25
3/22/2006,4,0,4,11,19
3/23/2006,5,0,5,2,12
3/24/2006,6,0,7,10,23
3/25/2006,3,0,5,0,8
3/26/2006,4,0,7,13,24
3/27/2006,7,0,5,0,12
3/28/2006,7,0,6,8,21
3/29/2006,8,0,4,11,23
3/30/2006,3,0,3,4,10
3/31/2006,6,0,8,10,24
4/1/2006,7,0,8,8,23
4/2/2006,3,0,4,13,20
4/3/2006,6,0,7,13,26
4/4/2006,4,0,4,11,19
4/5/2006,8,0,2,10,20
4/6/2006,3,0,2,7,12
4/7/2006,6,0,3,11,20
4/8/2006,3,0,5,0,8
4/9/2006,3,0,4,2,9
4/10/2006,4,0,2,3,9
4/11/2006,8,0,6,2,16
4/12/2006,6,0,7,7,20
4/13/2006,6,0,6,6,18
4/14/2006,8,0,8,0,16
4/15/2006,6,0,7,9,22
4/16/2006,8,0,8,2,18
4/17/2006,4,0,2,4,10
4/18/2006,5,0,2,7,14
4/19/2006,4,0,4,7,15
4/20/2006,7,0,5,3,15
4/21/2006,3,0,8,8,19
4/22/2006,5,0,3,9,17
4/23/2006,5,0,3,1,9
4/24/2006,7,0,8,12,27
4/25/2006,5,0,7,2,14
4/26/2006,4,0,6,12,22
4/27/2006,4,0,5,0,9
4/28/2006,2,0,8,4,14
4/29/2006,3,0,5,3,11
4/30/2006,2,0,4,6,12
5/1/2006,6,0,5,8,19
5/2/2006,2,0,3,2,7
5/3/2006,7,0,5,9,21
5/4/2006,5,0,8,13,26
5/5/2006,2,0,4,11,17
5/6/2006,7,0,8,1,16
5/7/2006,7,0,2,3,12
5/8/2006,2,0,7,4,13
5/9/2006,3,0,4,3,10
5/10/2006,3,0,7,4,14
5/11/2006,6,0,2,2,10
5/12/2006,6,0,2,12,20
5/13/2006,3,0,8,5,16
5/14/2006,7,0,6,7,20
5/15/2006,4,0,4,4,12
5/16/2006,5,0,4,5,14
5/17/2006,6,0,4,8,18
5/18/2006,4,0,2,3,9
5/19/2006,7,0,6,13,26
5/20/2006,7,0,7,12,26
5/21/2006,7,0,6,12,25
5/22/2006,5,0,4,5,14
5/23/2006,8,0,7,12,27
5/24/2006,4,0,7,10,21
5/25/2006,6,0,5,2,13
5/26/2006,6,0,7,4,17
5/27/2006,2,0,6,5,13
5/28/2006,5,0,7,13,25
5/29/2006,6,0,2,2,10
5/30/2006,4,0,3,10,17
5/31/2006,2,0,8,2,12
6/1/2006,3,0,2,7,12
6/2/2006,8,0,8,7,23
6/3/2006,8,0,5,8,21
6/4/2006,6,0,5,9,20
6/5/2006,8,0,4,12,24
6/6/2006,6,0,4,3,13
6/7/2006,7,0,4,6,17
6/8/2006,6,0,7,10,23
6/9/2006,3,0,3,8,14
6/10/2006,7,0,2,0,9
6/11/2006,6,0,2,12,20
6/12/2006,8,0,4,0,12
6/13/2006,2,0,8,2,12
6/14/2006,8,0,6,4,18
6/15/2006,8,0,8,8,24
6/16/2006,8,0,2,4,14
6/17/2006,3,0,6,0,9
6/18/2006,5,0,4,7,16
6/19/2006,3,0,6,12,21
6/20/2006,8,0,3,7,18
6/21/2006,3,0,5,3,11
6/22/2006,7,0,3,5,15
6/23/2006,6,0,6,13,25
6/24/2006,5,0,3,11,19
6/25/2006,2,0,6,0,8
6/26/2006,5,0,6,2,13
6/27/2006,2,0,6,5,13
6/28/2006,3,0,2,1,6
6/29/2006,5,0,5,3,13
6/30/2006,4,0,7,0,11
7/1/2006,5,0,4,9,18
7/2/2006,8,0,3,8,19
7/3/2006,7,0,6,1,14
7/4/2006,6,0,4,4,14
7/5/2006,6,0,7,13,26
7/6/2006,2,0,4,2,8
7/7/2006,8,0,8,5,21
7/8/2006,6,0,2,8,16
7/9/2006,5,0,6,9,20
7/10/2006,4,0,4,3,11
7/11/2006,3,0,2,6,11
7/12/2006,5,0,8,5,18
7/13/2006,2,0,6,11,19
7/14/2006,2,0,6,7,15
7/15/2006,2,0,3,2,7
7/16/2006,7,0,3,13,23
7/17/2006,4,0,2,10,16
7/18/2006,8,0,3,10,21
7/19/2006,4,0,3,3,10
7/20/2006,5,0,4,3,12
7/21/2006,7,0,4,5,16
7/22/2006,2,0,8,2,12
7/23/2006,5,0,7,2,14
7/24/2006,3,0,8,4,15
7/25/2006,2,0,3,6,11
7/26/2006,4,0,3,10,17
7/27/2006,4,0,4,10,18
7/28/2006,4,0,6,13,23
7/29/2006,6,0,2,9,17
7/30/2006,6,0,2,9,17
7/31/2006,6,0,7,8,21
8/1/2006,2,0,3,10,15
8/2/2006,2,0,5,11,18
8/3/2006,4,0,7,7,18
8/4/2006,6,0,2,4,12
8/5/2006,7,0,2,10,19
8/6/2006,4,0,2,9,15
8/7/2006,5,0,7,5,17
8/8/2006,2,0,2,3,7
8/9/2006,8,0,6,12,26
8/10/2006,3,0,3,7,13
8/11/2006,6,0,7,0,13
8/12/2006,6,0,2,11,19
8/13/2006,8,0,5,12,25
8/14/2006,5,0,5,4,14
8/15/2006,5,0,2,1,8
8/16/2006,6,0,4,10,20
8/17/2006,5,0,5,9,19
8/18/2006,2,0,6,11,19
8/19/2006,5,0,5,13,23
8/20/2006,4,0,5,2,11
8/21/2006,2,0,4,0,6
8/22/2006,4,0,6,10,20
8/23/2006,8,0,4,8,20
8/24/2006,3,0,4,3,10
8/25/2006,8,0,6,4,18
8/26/2006,6,0,3,6,15
8/27/2006,2,0,7,10,19
8/28/2006,5,0,7,9,21
8/29/2006,3,0,4,6,13
8/30/2006,4,0,3,8,15
8/31/2006,8,0,7,13,28
9/1/2006,3,0,7,4,14
9/2/2006,4,0,7,8,19
9/3/2006,5,0,3,13,21
9/4/2006,8,0,5,11,24
9/5/2006,6,0,6,7,19
9/6/2006,2,0,3,8,13
9/7/2006,8,0,3,5,16
9/8/2006,8,0,7,5,20
9/9/2006,2,0,5,12,19
9/10/2006,2,0,7,13,22
9/11/2006,6,0,4,3,13
9/12/2006,2,0,2,5,9
9/13/2006,5,0,8,0,13
9/14/2006,8,0,7,12,27
9/15/2006,4,0,7,8,19
9/16/2006,7,0,6,10,23
9/17/2006,7,0,2,3,12
9/18/2006,4,0,8,0,12
9/19/2006,4,0,3,8,15
9/20/2006,5,0,7,7,19
9/21/2006,5,0,4,5,14
9/22/2006,4,0,7,9,20
9/23/2006,4,0,3,0,7
9/24/2006,5,0,8,10,23
9/25/2006,6,0,7,7,20
9/26/2006,2,0,4,1,7
9/27/2006,3,0,8,4,15
9/28/2006,6,0,6,13,25
9/29/2006,3,0,6,1,10
9/30/2006,6,0,7,5,18
10/1/2006,4,0,7,4,15
10/2/2006,6,0,3,0,9
10/3/2006,6,0,7,0,13
10/4/2006,6,0,7,0,13
10/5/2006,5,0,5,1,11
10/6/2006,6,0,7,9,22
10/7/2006,2,0,8,11,21
10/8/2006,3,0,3,10,16
10/9/2006,8,0,3,0,11
10/10/2006,2,0,4,3,9
10/11/2006,7,0,8,8,23
10/12/2006,6,0,2,6,14
10/13/2006,3,0,5,13,21
10/14/2006,5,0,6,3,14
10/15/2006,5,0,6,13,24
10/16/2006,8,0,8,0,16
10/17/2006,4,0,4,6,14
10/18/2006,7,0,5,10,22
10/19/2006,7,0,6,7,20
10/20/2006,5,0,3,8,16
10/21/2006,6,0,5,9,20
10/22/2006,5,0,4,13,22
10/23/2006,2,0,6,7,15
10/24/2006,6,0,5,7,18
10/25/2006,4,0,7,13,24
10/26/2006,6,0,3,4,13
10/27/2006,3,0,3,3,9
10/28/2006,5,0,6,9,20
10/29/2006,4,0,3,11,18
10/30/2006,5,0,3,11,19
10/31/2006,6,0,7,4,17
11/1/2006,8,0,4,5,17
11/2/2006,8,0,2,9,19
11/3/2006,5,0,2,11,18
11/4/2006,5,0,6,9,20
11/5/2006,5,0,4,9,18
11/6/2006,4,0,7,0,11
11/7/2006,2,0,2,11,15
11/8/2006,5,0,6,9,20
11/9/2006,4,0,3,5,12
11/10/2006,5,0,6,5,16
11/11/2006,7,0,2,2,11
11/12/2006,5,0,2,7,14
11/13/2006,7,0,4,13,24
11/14/2006,5,0,5,1,11
11/15/2006,2,0,7,12,21
11/16/2006,3,0,2,13,18
11/17/2006,7,0,3,10,20
11/18/2006,5,0,2,2,9
11/19/2006,3,0,4,6,13
11/20/2006,5,0,7,10,22
11/21/2006,2,0,2,13,17
11/22/2006,8,0,5,1,14
11/23/2006,7,0,3,10,20
11/24/2006,3,0,2,3,8
11/25/2006,3,0,3,6,12
11/26/2006,8,0,5,10,23
11/27/2006,4,0,6,11,21
11/28/2006,2,0,4,4,10
11/29/2006,5,0,7,4,16
11/30/2006,2,0,3,5,10
12/1/2006,6,0,5,3,14
12/2/2006,5,0,2,7,14
12/3/2006,7,0,5,7,19
12/4/2006,8,0,4,1,13
12/5/2006,3,0,7,8,18
12/6/2006,3,0,2,3,8
12/7/2006,8,0,7,8,23
12/8/2006,5,0,7,1,13
12/9/2006,4,0,5,3,12
12/10/2006,6,0,3,11,20
12/11/2006,3,0,7,13,23
12/12/2006,6,0,5,5,16
12/13/2006,7,0,7,5,19
12/14/2006,5,0,3,1,9
12/15/2006,3,0,8,3,14
12/16/2006,5,0,2,7,14
12/17/2006,8,0,6,9,23
12/18/2006,5,0,3,12,20
12/19/2006,4,0,2,9,15
12/20/2006,7,0,4,13,24
12/21/2006,7,0,8,2,17
12/22/2006,6,0,4,11,21
12/23/2006,4,0,2,5,11
12/24/2006,5,0,5,5,15
12/25/2006,2,0,8,7,17
12/26/2006,4,0,2,8,14
12/27/2006,8,0,7,10,25
12/28/2006,5,0,4,9,18
12/29/2006,6,0,4,6,16
12/30/2006,7,0,8,0,15
12/31/2006,5,0,7,6,18
1/1/2007,2,0,4,6,12
1/2/2007,3,0,6,6,15
1/3/2007,5,0,2,4,11
1/4/2007,7,0,5,10,22
1/5/2007,8,0,3,8,19
1/6/2007,5,0,2,7,14
1/7/2007,8,0,7,3,18
1/8/2007,5,0,4,9,18
1/9/2007,3,0,8,13,24
1/10/2007,2,0,7,3,12
1/11/2007,5,0,7,4,16
1/12/2007,2,0,2,10,14
1/13/2007,5,0,7,9,21
1/14/2007,8,0,8,8,24
1/15/2007,5,0,5,7,17
1/16/2007,6,0,3,10,19
1/17/2007,7,0,7,13,27
1/18/2007,5,0,8,13,26
1/19/2007,6,0,5,5,16
1/20/2007,5,0,6,12,23
1/21/2007,7,0,7,3,17
1/22/2007,3,0,4,3,10
1/23/2007,3,0,6,0,9
1/24/2007,3,0,3,12,18
1/25/2007,5,0,4,1,10
1/26/2007,6,0,4,9,19
1/27/2007,3,0,7,2,12
1/28/2007,3,0,2,13,18
1/29/2007,6,0,2,4,12
1/30/2007,7,0,6,13,26
1/31/2007,8,0,2,10,20
2/1/2007,5,0,7,3,15
2/2/2007,5,0,6,4,15
2/3/2007,8,0,7,4,19
2/4/2007,2,0,6,5,13
2/5/2007,2,0,5,13,20
2/6/2007,5,0,2,5,12
2/7/2007,5,0,3,8,16
2/8/2007,3,0,4,6,13
2/9/2007,2,0,6,7,15
2/10/2007,4,0,7,9,20
2/11/2007,4,0,6,3,13
2/12/2007,8,0,6,13,27
2/13/2007,4,0,6,9,19
2/14/2007,6,0,6,12,24
2/15/2007,6,0,7,0,13
2/16/2007,6,0,8,2,16
2/17/2007,2,0,5,9,16
2/18/2007,2,0,5,9,16
2/19/2007,5,0,2,6,13
2/20/2007,8,0,4,11,23
2/21/2007,6,0,5,12,23
2/22/2007,3,0,2,8,13
2/23/2007,6,0,2,9,17
2/24/2007,4,0,7,4,15
2/25/2007,6,0,5,0,11
2/26/2007,4,0,2,6,12
2/27/2007,7,0,5,3,15
2/28/2007,5,0,2,10,17
3/1/2007,6,0,7,5,18
3/2/2007,8,0,2,9,19
3/3/2007,6,0,6,1,13
3/4/2007,2,0,8,11,21
3/5/2007,2,0,2,11,15
3/6/2007,5,0,5,1,11
3/7/2007,2,0,3,10,15
3/8/2007,3,0,5,4,12
3/9/2007,3,0,2,2,7
3/10/2007,8,0,3,9,20
3/11/2007,2,0,5,4,11
3/12/2007,7,0,3,13,23
3/13/2007,2,0,3,11,16
3/14/2007,4,0,6,0,10
3/15/2007,8,0,7,0,15
3/16/2007,3,0,8,6,17
3/17/2007,4,0,6,2,12
3/18/2007,6,0,4,7,17
3/19/2007,2,0,7,9,18
3/20/2007,7,0,6,10,23
3/21/2007,7,0,7,13,27
3/22/2007,6,0,4,7,17
3/23/2007,7,0,6,3,16
3/24/2007,8,0,5,8,21
3/25/2007,3,0,6,8,17
3/26/2007,7,0,8,2,17
3/27/2007,5,0,3,12,20
3/28/2007,3,0,3,9,15
3/29/2007,5,0,6,3,14
3/30/2007,7,0,8,0,15
3/31/2007,5,0,8,2,15
4/1/2007,5,0,6,13,24
4/2/2007,5,0,5,1,11
4/3/2007,7,0,8,9,24
4/4/2007,5,0,4,5,14
4/5/2007,7,0,3,13,23
4/6/2007,7,0,4,11,22
4/7/2007,3,0,8,12,23
4/8/2007,3,0,3,4,10
4/9/2007,8,0,4,10,22
4/10/2007,5,0,6,10,21
4/11/2007,7,0,7,10,24
4/12/2007,6,0,6,3,15
4/13/2007,7,0,3,13,23
4/14/2007,3,0,5,4,12
4/15/2007,8,0,5,1,14
4/16/2007,3,0,6,12,21
4/17/2007,2,0,2,2,6
4/18/2007,8,0,7,9,24
4/19/2007,5,0,6,2,13
4/20/2007,2,0,6,12,20
4/21/2007,6,0,8,0,14
4/22/2007,4,0,3,11,18
4/23/2007,6,0,4,0,10
4/24/2007,6,0,2,6,14
4/25/2007,7,0,6,4,17
4/26/2007,5,0,7,9,21
4/27/2007,7,0,6,8,21
4/28/2007,6,0,4,4,14
4/29/2007,5,0,4,11,20
4/30/2007,6,0,6,13,25
5/1/2007,3,0,8,2,13
5/2/2007,4,0,7,3,14
5/3/2007,8,0,3,5,16
5/4/2007,6,0,7,9,22
5/5/2007,6,0,6,1,13
5/6/2007,8,0,3,5,16
5/7/2007,8,0,8,13,29
5/8/2007,8,0,6,0,14
5/9/2007,7,0,5,5,17
5/10/2007,5,0,5,7,17
5/11/2007,7,0,3,8,18
5/12/2007,6,0,3,9,18
5/13/2007,3,0,5,6,14
5/14/2007,3,0,4,2,9
5/15/2007,7,0,5,7,19
5/16/2007,6,0,5,2,13
5/17/2007,6,0,4,11,21
5/18/2007,4,0,6,9,19
5/19/2007,2,0,6,9,17
5/20/2007,7,0,7,7,21
5/21/2007,2,0,6,12,20
5/22/2007,5,0,6,9,20
5/23/2007,2,0,8,10,20
5/24/2007,5,0,8,8,21
5/25/2007,6,0,4,12,22
5/26/2007,5,0,2,7,14
5/27/2007,5,0,4,5,14
5/28/2007,5,0,4,11,20
5/29/2007,5,0,8,6,19
5/30/2007,6,0,2,11,19
5/31/2007,6,0,8,4,18
6/1/2007,8,0,8,7,23
6/2/2007,7,0,5,3,15
6/3/2007,2,0,8,3,13
6/4/2007,8,0,2,6,16
6/5/2007,2,0,4,6,12
6/6/2007,3,0,7,5,15
6/7/2007,3,0,5,0,8
6/8/2007,3,0,3,0,6
6/9/2007,3,0,4,6,13
6/10/2007,2,0,6,0,8
6/11/2007,5,0,5,1,11
6/12/2007,4,0,3,0,7
6/13/2007,4,0,2,3,9
6/14/2007,7,0,8,9,24
6/15/2007,6,0,2,11,19
6/16/2007,8,0,2,7,17
6/17/2007,4,0,2,3,9
6/18/2007,4,0,2,12,18
6/19/2007,3,0,7,9,19
6/20/2007,7,0,5,11,23
6/21/2007,4,0,3,12,19
6/22/2007,8,0,5,10,23
6/23/2007,8,0,8,7,23
6/24/2007,4,0,4,1,9
6/25/2007,8,0,5,11,24
6/26/2007,2,0,7,6,15
6/27/2007,5,0,6,13,24
6/28/2007,5,0,3,13,21
6/29/2007,7,0,6,8,21
6/30/2007,4,0,7,10,21
7/1/2007,4,0,5,5,14
7/2/2007,6,0,5,7,18
7/3/2007,3,0,2,1,6
7/4/2007,4,0,2,7,13
7/5/2007,4,0,2,11,17
7/6/2007,7,0,3,3,13
7/7/2007,5,0,5,11,21
7/8/2007,6,0,6,8,20
7/9/2007,2,0,4,4,10
7/10/2007,3,0,4,12,19
7/11/2007,6,0,6,12,24
7/12/2007,6,0,5,9,20
7/13/2007,8,0,5,0,13
7/14/2007,4,0,7,1,12
7/15/2007,8,0,8,6,22
7/16/2007,3,0,3,6,12
7/17/2007,8,0,4,1,13
7/18/2007,6,0,8,4,18
7/19/2007,5,0,2,2,9
7/20/2007,2,0,8,3,13
7/21/2007,5,0,5,3,13
7/22/2007,2,0,3,11,16
7/23/2007,4,0,5,7,16
7/24/2007,4,0,4,12,20
7/25/2007,4,0,8,1,13
7/26/2007,4,0,4,11,19
7/27/2007,7,0,7,4,18
7/28/2007,8,0,5,2,15
7/29/2007,5,0,6,13,24
7/30/2007,5,0,5,2,12
7/31/2007,7,0,6,0,13
8/1/2007,6,0,6,9,21
8/2/2007,3,0,4,5,12
8/3/2007,4,0,7,12,23
8/4/2007,6,0,6,2,14
8/5/2007,4,0,8,10,22
8/6/2007,6,0,8,6,20
8/7/2007,5,0,2,7,14
8/8/2007,7,0,5,0,12
8/9/2007,4,0,7,1,12
8/10/2007,7,0,7,10,24
8/11/2007,3,0,4,1,8
8/12/2007,3,0,4,10,17
8/13/2007,8,0,8,5,21
8/14/2007,2,0,4,5,11
8/15/2007,3,0,4,8,15
8/16/2007,5,0,8,9,22
8/17/2007,8,0,4,0,12
8/18/2007,4,0,6,13,23
8/19/2007,3,0,4,13,20
8/20/2007,4,0,3,1,8
8/21/2007,3,0,8,4,15
8/22/2007,4,0,2,2,8
8/23/2007,5,0,4,8,17
8/24/2007,5,0,4,12,21
8/25/2007,6,0,8,5,19
8/26/2007,3,0,6,6,15
8/27/2007,5,0,8,3,16
8/28/2007,3,0,8,7,18
8/29/2007,6,0,3,9,18
8/30/2007,7,0,8,12,27
8/31/2007,7,0,3,1,11
9/1/2007,4,0,5,12,21
9/2/2007,6,0,3,0,9
9/3/2007,7,0,5,9,21
9/4/2007,4,0,2,9,15
9/5/2007,6,0,7,0,13
9/6/2007,8,0,7,0,15
9/7/2007,8,0,2,6,16
9/8/2007,6,0,7,11,24
9/9/2007,4,0,5,11,20
9/10/2007,5,0,7,11,23
9/11/2007,3,0,7,3,13
9/12/2007,8,0,5,10,23
9/13/2007,4,0,4,2,10
9/14/2007,5,0,7,9,21
9/15/2007,2,0,5,1,8
9/16/2007,8,0,5,10,23
9/17/2007,7,0,7,9,23
9/18/2007,7,0,5,0,12
9/19/2007,4,0,2,13,19
9/20/2007,4,0,7,8,19
9/21/2007,6,0,2,10,18
9/22/2007,2,0,6,7,15
9/23/2007,4,0,8,9,21
9/24/2007,3,0,2,12,17
9/25/2007,7,0,8,2,17
9/26/2007,2,0,6,12,20
9/27/2007,7,0,3,1,11
9/28/2007,4,0,5,6,15
9/29/2007,6,0,8,12,26
9/30/2007,4,0,6,11,21
10/1/2007,8,0,7,7,22
10/2/2007,3,0,5,12,20
10/3/2007,4,0,4,4,12
10/4/2007,3,0,3,4,10
10/5/2007,6,0,5,7,18
10/6/2007,6,0,6,13,25
10/7/2007,2,0,2,1,5
10/8/2007,7,0,7,8,22
10/9/2007,3,0,3,1,7
10/10/2007,2,0,5,11,18
10/11/2007,4,0,8,9,21
10/12/2007,4,0,6,9,19
10/13/2007,8,0,3,1,12
10/14/2007,7,0,3,4,14
10/15/2007,2,0,6,1,9
10/16/2007,3,0,5,2,10
10/17/2007,4,0,7,1,12
10/18/2007,7,0,3,7,17
10/19/2007,6,0,4,10,20
10/20/2007,5,0,4,8,17
10/21/2007,5,0,7,11,23
10/22/2007,3,0,8,8,19
10/23/2007,8,0,5,1,14
10/24/2007,2,0,6,6,14
10/25/2007,8,0,4,7,19
10/26/2007,8,0,3,4,15
10/27/2007,5,0,3,9,17
10/28/2007,8,0,4,1,13
10/29/2007,3,0,4,10,17
10/30/2007,5,0,7,1,13
10/31/2007,7,0,5,0,12
11/1/2007,2,0,3,6,11
11/2/2007,2,0,6,6,14
11/3/2007,7,0,7,6,20
11/4/2007,5,0,7,2,14
11/5/2007,8,0,6,1,15
11/6/2007,4,0,5,7,16
11/7/2007,7,0,6,13,26
11/8/2007,2,0,4,10,16
11/9/2007,5,0,6,9,20
11/10/2007,7,0,5,3,15
11/11/2007,6,0,8,0,14
11/12/2007,8,0,3,7,18
11/13/2007,4,0,7,6,17
11/14/2007,6,0,6,1,13
11/15/2007,8,0,3,9,20
11/16/2007,5,0,7,7,19
11/17/2007,6,0,4,11,21
11/18/2007,2,0,4,7,13
11/19/2007,3,0,2,12,17
11/20/2007,6,0,8,12,26
11/21/2007,5,0,5,13,23
11/22/2007,5,0,8,0,13
11/23/2007,8,0,5,6,19
11/24/2007,6,0,5,5,16
11/25/2007,2,0,6,11,19
11/26/2007,4,0,4,10,18
11/27/2007,2,0,7,1,10
11/28/2007,6,0,5,6,17
11/29/2007,3,0,4,13,20
11/30/2007,5,0,7,12,24
12/1/2007,5,0,4,10,19
12/2/2007,2,0,7,4,13
12/3/2007,5,0,8,5,18
12/4/2007,3,0,8,6,17
12/5/2007,5,0,2,9,16
12/6/2007,8,0,5,3,16
12/7/2007,4,0,5,3,12
12/8/2007,4,0,6,8,18
12/9/2007,6,0,3,12,21
12/10/2007,6,0,2,13,21
12/11/2007,5,0,3,3,11
12/12/2007,3,0,6,5,14
12/13/2007,3,0,2,10,15
12/14/2007,3,0,8,9,20
12/15/2007,7,0,4,10,21
12/16/2007,8,0,6,10,24
12/17/2007,7,0,5,7,19
12/18/2007,4,0,7,3,14
12/19/2007,3,0,7,0,10
12/20/2007,3,0,6,8,17
12/21/2007,3,0,6,0,9
12/22/2007,7,0,4,12,23
12/23/2007,4,0,7,6,17
12/24/2007,7,0,6,11,24
12/25/2007,8,0,3,12,23
12/26/2007,8,0,3,7,18
12/27/2007,6,0,3,6,15
12/28/2007,5,0,7,6,18
12/29/2007,7,0,6,1,14
12/30/2007,5,0,5,2,12
12/31/2007,4,0,6,6,16
1/1/2008,2,0,4,11,17
1/2/2008,7,0,2,0,9
1/3/2008,7,0,3,12,22
1/4/2008,4,0,7,5,16
1/5/2008,2,0,6,8,16
1/6/2008,5,0,8,5,18
1/7/2008,3,0,4,1,8
1/8/2008,5,0,3,7,15
1/9/2008,8,0,8,8,24
1/10/2008,4,0,8,10,22
1/11/2008,2,0,5,9,16
1/12/2008,2,0,4,6,12
1/13/2008,6,0,3,10,19
1/14/2008,4,0,6,11,21
1/15/2008,2,0,2,6,10
1/16/2008,7,0,2,11,20
1/17/2008,8,0,6,12,26
1/18/2008,8,0,7,5,20
1/19/2008,7,0,2,13,22
1/20/2008,7,0,6,13,26
1/21/2008,7,0,4,1,12
1/22/2008,6,0,8,1,15
1/23/2008,4,0,6,1,11
1/24/2008,4,0,3,13,20
1/25/2008,2,0,7,11,20
1/26/2008,6,0,7,12,25
1/27/2008,7,0,3,5,15
1/28/2008,4,0,3,1,8
1/29/2008,3,0,2,10,15
1/30/2008,7,0,6,4,17
1/31/2008,2,0,7,4,13
2/1/2008,3,0,6,1,10
2/2/2008,6,0,7,0,13
2/3/2008,7,0,8,3,18
2/4/2008,2,0,8,6,16
2/5/2008,3,0,6,1,10
2/6/2008,7,0,7,9,23
2/7/2008,5,0,4,10,19
2/8/2008,5,0,8,4,17
2/9/2008,6,0,3,5,14
2/10/2008,2,0,4,13,19
2/11/2008,4,0,7,7,18
2/12/2008,6,0,7,12,25
2/13/2008,2,0,8,12,22
2/14/2008,8,0,3,13,24
2/15/2008,8,0,2,3,13
2/16/2008,8,0,8,8,24
2/17/2008,3,0,5,11,19
2/18/2008,6,0,2,11,19
2/19/2008,6,0,3,1,10
2/20/2008,8,0,3,11,22
2/21/2008,8,0,8,6,22
2/22/2008,5,0,7,5,17
2/23/2008,7,0,6,7,20
2/24/2008,4,0,8,5,17
2/25/2008,6,0,5,12,23
2/26/2008,2,0,5,7,14
2/27/2008,7,0,7,6,20
2/28/2008,8,0,2,1,11
2/29/2008,7,0,7,13,27
3/1/2008,3,0,2,13,18
3/2/2008,7,0,3,13,23
3/3/2008,5,0,2,1,8
3/4/2008,4,0,2,13,19
3/5/2008,4,0,3,1,8
3/6/2008,8,0,3,1,12
3/7/2008,8,0,5,3,16
3/8/2008,5,0,5,7,17
3/9/2008,3,0,7,1,11
3/10/2008,4,0,2,11,17
3/11/2008,7,0,7,1,15
3/12/2008,2,0,8,6,16
3/13/2008,2,0,4,3,9
3/14/2008,4,0,3,7,14
3/15/2008,3,0,4,0,7
3/16/2008,3,0,6,3,12
3/17/2008,3,0,4,12,19
3/18/2008,8,0,6,12,26
3/19/2008,5,0,7,10,22
3/20/2008,6,0,2,13,21
3/21/2008,2,0,8,3,13
3/22/2008,5,0,5,2,12
3/23/2008,3,0,6,11,20
3/24/2008,4,0,5,0,9
3/25/2008,6,0,8,10,24
3/26/2008,4,0,3,11,18
3/27/2008,6,0,2,3,11
3/28/2008,5,0,2,6,13
3/29/2008,6,0,6,13,25
3/30/2008,2,0,2,4,8
3/31/2008,7,0,5,1,13
4/1/2008,3,0,6,4,13
4/2/2008,2,0,5,13,20
4/3/2008,4,0,6,3,13
4/4/2008,5,0,8,4,17
4/5/2008,8,0,4,2,14
4/6/2008,3,0,7,5,15
4/7/2008,5,0,5,11,21
4/8/2008,5,0,2,5,12
4/9/2008,7,0,6,4,17
4/10/2008,8,0,6,9,23
4/11/2008,5,0,2,9,16
4/12/2008,6,0,4,11,21
4/13/2008,2,0,5,8,15
4/14/2008,2,0,8,0,10
4/15/2008,3,0,8,9,20
4/16/2008,2,0,7,13,22
4/17/2008,6,0,5,2,13
4/18/2008,8,0,6,2,16
4/19/2008,8,0,3,12,23
4/20/2008,8,0,5,12,25
4/21/2008,8,0,7,13,28
4/22/2008,8,0,7,8,23
4/23/2008,3,0,8,7,18
4/24/2008,4,0,4,9,17
4/25/2008,6,0,3,7,16
4/26/2008,5,0,8,0,13
4/27/2008,5,0,3,4,12
4/28/2008,5,0,7,11,23
4/29/2008,6,0,3,4,13
4/30/2008,4,0,6,1,11
5/1/2008,7,0,6,7,20
5/2/2008,6,0,3,9,18
5/3/2008,6,0,4,13,23
5/4/2008,3,0,3,13,19
5/5/2008,7,0,7,11,25
5/6/2008,7,0,6,10,23
5/7/2008,6,0,2,0,8
5/8/2008,2,0,8,10,20
5/9/2008,2,0,8,10,20
5/10/2008,7,0,8,13,28
5/11/2008,5,0,7,7,19
5/12/2008,8,0,2,5,15
5/13/2008,4,0,5,7,16
5/14/2008,4,0,4,10,18
5/15/2008,4,0,7,2,13
5/16/2008,8,0,2,8,18
5/17/2008,2,0,2,1,5
5/18/2008,3,0,8,13,24
5/19/2008,8,0,6,0,14
5/20/2008,6,0,3,12,21
5/21/2008,5,0,8,13,26
5/22/2008,7,0,2,4,13
5/23/2008,2,0,4,2,8
5/24/2008,4,0,6,13,23
5/25/2008,2,0,7,11,20
5/26/2008,4,0,7,0,11
5/27/2008,8,0,7,13,28
5/28/2008,5,0,6,5,16
5/29/2008,4,0,6,13,23
5/30/2008,5,0,3,1,9
5/31/2008,8,0,5,1,14
6/1/2008,3,0,2,12,17
6/2/2008,8,0,7,6,21
6/3/2008,2,0,5,9,16
6/4/2008,7,0,6,11,24
6/5/2008,5,0,6,11,22
6/6/2008,6,0,6,6,18
6/7/2008,6,0,4,0,10
6/8/2008,3,0,7,3,13
6/9/2008,4,0,4,11,19
6/10/2008,8,0,7,9,24
6/11/2008,3,0,3,7,13
6/12/2008,7,0,4,5,16
6/13/2008,6,0,3,3,12
6/14/2008,8,0,2,6,16
6/15/2008,4,0,7,2,13
6/16/2008,2,0,2,6,10
6/17/2008,8,0,6,3,17
6/18/2008,3,0,6,1,10
6/19/2008,7,0,8,1,16
6/20/2008,5,0,6,2,13
6/21/2008,7,0,5,3,15
6/22/2008,6,0,6,11,23
6/23/2008,6,0,8,9,23
6/24/2008,8,0,5,13,26
6/25/2008,7,0,7,9,23
6/26/2008,6,0,7,4,17
6/27/2008,7,0,8,3,18
6/28/2008,6,0,5,3,14
6/29/2008,6,0,8,10,24
6/30/2008,3,0,4,12,19
7/1/2008,3,0,8,8,19
7/2/2008,3,0,4,2,9
7/3/2008,6,0,5,10,21
7/4/2008,3,0,7,9,19
7/5/2008,2,0,8,11,21
7/6/2008,8,0,8,6,22
7/7/2008,5,0,3,7,15
7/8/2008,7,0,2,11,20
7/9/2008,7,0,7,1,15
7/10/2008,4,0,6,10,20
7/11/2008,5,0,7,8,20
7/12/2008,5,0,8,0,13
7/13/2008,4,0,8,13,25
7/14/2008,5,0,8,6,19
7/15/2008,5,0,6,3,14
7/16/2008,4,0,8,6,18
7/17/2008,5,0,2,13,20
7/18/2008,2,0,5,2,9
7/19/2008,7,0,8,13,28
7/20/2008,8,0,7,6,21
7/21/2008,2,0,5,11,18
7/22/2008,4,0,5,9,18
7/23/2008,8,0,3,7,18
7/24/2008,2,0,7,11,20
7/25/2008,6,0,5,9,20
7/26/2008,8,0,5,0,13
7/27/2008,7,0,5,11,23
7/28/2008,5,0,5,13,23
7/29/2008,4,0,4,10,18
7/30/2008,8,0,5,4,17
7/31/2008,5,0,6,0,11
8/1/2008,4,0,7,0,11
8/2/2008,7,0,8,3,18
8/3/2008,6,0,2,9,17
8/4/2008,7,0,3,4,14
8/5/2008,7,0,2,4,13
8/6/2008,6,0,3,9,18
8/7/2008,5,0,3,3,11
8/8/2008,5,0,5,7,17
8/9/2008,3,0,7,10,20
8/10/2008,8,0,3,6,17
8/11/2008,7,0,8,5,20
8/12/2008,5,0,5,12,22
8/13/2008,6,0,5,13,24
8/14/2008,8,0,2,9,19
8/15/2008,8,0,3,10,21
8/16/2008,8,0,6,11,25
8/17/2008,4,0,4,4,12
8/18/2008,8,0,8,6,22
8/19/2008,7,0,6,5,18
8/20/2008,8,0,2,1,11
8/21/2008,4,0,4,6,14
8/22/2008,2,0,2,9,13
8/23/2008,2,0,2,5,9
8/24/2008,3,0,2,3,8
8/25/2008,8,0,8,1,17
8/26/2008,4,0,4,4,12
8/27/2008,7,0,6,4,17
8/28/2008,6,0,2,0,8
8/29/2008,3,0,4,5,12
8/30/2008,8,0,7,10,25
8/31/2008,5,0,3,4,12
9/1/2008,6,0,4,6,16
9/2/2008,5,0,4,7,16
9/3/2008,4,0,7,13,24
9/4/2008,3,0,5,1,9
9/5/2008,2,0,7,1,10
9/6/2008,6,0,6,2,14
9/7/2008,5,0,2,0,7
9/8/2008,2,0,2,0,4
9/9/2008,2,0,8,11,21
9/10/2008,6,0,5,1,12
9/11/2008,2,0,3,13,18
9/12/2008,4,0,4,0,8
9/13/2008,6,0,7,2,15
9/14/2008,4,0,2,0,6
9/15/2008,8,0,6,6,20
9/16/2008,8,0,5,9,22
9/17/2008,4,0,8,9,21
9/18/2008,3,0,5,12,20
9/19/2008,3,0,3,10,16
9/20/2008,3,0,5,4,12
9/21/2008,4,0,2,0,6
9/22/2008,4,0,3,5,12
9/23/2008,6,0,4,10,20
9/24/2008,3,0,5,13,21
9/25/2008,4,0,5,11,20
9/26/2008,2,0,6,11,19
9/27/2008,4,0,5,0,9
9/28/2008,7,0,7,11,25
9/29/2008,7,0,6,10,23
9/30/2008,4,0,5,11,20
10/1/2008,5,0,2,5,12
10/2/2008,3,0,6,6,15
10/3/2008,3,0,2,0,5
10/4/2008,7,0,7,5,19
10/5/2008,7,0,7,2,16
10/6/2008,6,0,3,10,19
10/7/2008,5,0,2,6,13
10/8/2008,5,0,2,4,11
10/9/2008,5,0,6,6,17
10/10/2008,3,0,8,1,12
10/11/2008,5,0,6,10,21
10/12/2008,2,0,6,11,19
10/13/2008,7,0,5,10,22
10/14/2008,7,0,5,0,12
10/15/2008,7,0,2,1,10
10/16/2008,8,0,3,11,22
10/17/2008,4,0,4,8,16
10/18/2008,5,0,4,0,9
10/19/2008,4,0,2,7,13
10/20/2008,4,0,6,9,19
10/21/2008,4,0,7,5,16
10/22/2008,7,0,4,3,14
10/23/2008,2,0,4,3,9
10/24/2008,7,0,3,13,23
10/25/2008,7,0,4,5,16
10/26/2008,4,0,7,6,17
10/27/2008,6,0,5,4,15
10/28/2008,8,0,6,7,21
10/29/2008,6,0,2,2,10
10/30/2008,8,0,7,12,27
10/31/2008,2,0,7,1,10
11/1/2008,7,0,2,12,21
11/2/2008,5,0,3,6,14
11/3/2008,4,0,5,8,17
11/4/2008,3,0,3,1,7
11/5/2008,2,0,8,8,18
11/6/2008,6,0,8,10,24
11/7/2008,8,0,5,7,20
11/8/2008,5,0,7,4,16
11/9/2008,5,0,8,0,13
11/10/2008,2,0,8,5,15
11/11/2008,4,0,6,4,14
11/12/2008,6,0,4,0,10
11/13/2008,7,0,3,7,17
11/14/2008,4,0,8,7,19
11/15/2008,7,0,8,3,18
11/16/2008,7,0,8,9,24
11/17/2008,7,0,4,12,23
11/18/2008,8,0,3,11,22
11/19/2008,2,0,2,11,15
11/20/2008,6,0,7,4,17
11/21/2008,8,0,4,12,24
11/22/2008,2,0,8,2,12
11/23/2008,4,0,6,11,21
11/24/2008,7,0,6,8,21
11/25/2008,4,0,7,4,15
11/26/2008,4,0,2,13,19
11/27/2008,5,0,4,2,11
11/28/2008,8,0,8,10,26
11/29/2008,8,0,5,12,25
11/30/2008,2,0,3,3,8
12/1/2008,3,0,8,9,20
12/2/2008,2,0,5,5,12
12/3/2008,5,0,3,10,18
12/4/2008,8,0,4,3,15
12/5/2008,2,0,8,7,17
12/6/2008,8,0,4,1,13
12/7/2008,2,0,2,2,6
12/8/2008,3,0,4,1,8
12/9/2008,5,0,2,7,14
12/10/2008,2,0,6,13,21
12/11/2008,2,0,2,12,16
12/12/2008,7,0,2,9,18
12/13/2008,2,0,3,8,13
12/14/2008,6,0,6,11,23
12/15/2008,4,0,4,10,18
12/16/2008,4,0,5,1,10
12/17/2008,7,0,2,6,15
12/18/2008,2,0,5,6,13
12/19/2008,6,0,8,4,18
12/20/2008,7,0,7,1,15
12/21/2008,6,0,6,1,13
12/22/2008,2,0,7,8,17
12/23/2008,5,0,5,10,20
12/24/2008,5,0,3,2,10
12/25/2008,2,0,5,13,20
12/26/2008,8,0,4,2,14
12/27/2008,8,0,6,6,20
12/28/2008,6,0,2,6,14
12/29/2008,7,0,2,10,19
12/30/2008,3,0,3,5,11
12/31/2008,6,0,5,0,11
1/1/2009,3,0,7,9,19
1/2/2009,5,0,5,11,21
1/3/2009,6,0,4,1,11
1/4/2009,7,0,6,4,17
1/5/2009,7,0,2,6,15
1/6/2009,8,0,5,6,19
1/7/2009,3,0,4,6,13
1/8/2009,8,0,3,11,22
1/9/2009,4,0,4,2,10
1/10/2009,2,0,7,13,22
1/11/2009,6,0,7,3,16
1/12/2009,5,0,2,7,14
1/13/2009,8,0,6,3,17
1/14/2009,2,0,4,10,16
1/15/2009,6,0,6,8,20
1/16/2009,3,0,6,7,16
1/17/2009,6,0,6,2,14
1/18/2009,7,0,5,1,13
1/19/2009,8,0,7,8,23
1/20/2009,7,0,3,12,22
1/21/2009,4,0,7,4,15
1/22/2009,5,0,7,0,12
1/23/2009,2,0,3,4,9
1/24/2009,7,0,8,6,21
1/25/2009,7,0,4,13,24
1/26/2009,5,0,6,11,22
1/27/2009,3,0,8,1,12
1/28/2009,3,0,6,8,17
1/29/2009,8,0,4,6,18
1/30/2009,4,0,7,10,21
1/31/2009,4,0,3,6,13
2/1/2009,2,0,7,5,14
2/2/2009,7,0,6,10,23
2/3/2009,3,0,2,1,6
2/4/2009,5,0,4,9,18
2/5/2009,7,0,7,8,22
2/6/2009,8,0,6,4,18
2/7/2009,2,0,7,3,12
2/8/2009,2,0,3,11,16
2/9/2009,4,0,3,12,19
2/10/2009,4,0,3,1,8
2/11/2009,3,0,2,1,6
2/12/2009,8,0,5,9,22
2/13/2009,3,0,4,12,19
2/14/2009,5,0,3,10,18
2/15/2009,4,0,6,10,20
2/16/2009,4,0,8,1,13
2/17/2009,4,0,2,4,10
2/18/2009,8,0,3,1,12
2/19/2009,7,0,6,3,16
2/20/2009,4,0,4,8,16
2/21/2009,3,0,8,13,24
2/22/2009,8,0,3,12,23
2/23/2009,4,0,6,4,14
2/24/2009,6,0,5,11,22
2/25/2009,5,0,8,13,26
2/26/2009,6,0,6,8,20
2/27/2009,3,0,7,11,21
2/28/2009,2,0,4,3,9
3/1/2009,8,0,3,1,12
3/2/2009,4,0,5,10,19
3/3/2009,6,0,3,13,22
3/4/2009,3,0,4,3,10
3/5/2009,7,0,5,6,18
3/6/2009,3,0,6,13,22
3/7/2009,3,0,4,12,19
3/8/2009,4,0,7,13,24
3/9/2009,5,0,2,4,11
3/10/2009,8,0,7,12,27
3/11/2009,4,0,6,9,19
3/12/2009,8,0,3,9,20
3/13/2009,6,0,6,10,22
3/14/2009,7,0,7,2,16
3/15/2009,5,0,2,5,12
3/16/2009,4,0,7,11,22
3/17/2009,2,0,6,1,9
3/18/2009,6,0,2,10,18
3/19/2009,6,0,7,4,17
3/20/2009,7,0,8,1,16
3/21/2009,2,0,7,7,16
3/22/2009,5,0,3,2,10
3/23/2009,8,0,4,4,16
3/24/2009,2,0,3,0,5
3/25/2009,3,0,5,6,14
3/26/2009,5,0,3,13,21
3/27/2009,3,0,6,9,18
3/28/2009,3,0,6,5,14
3/29/2009,7,0,2,13,22
3/30/2009,4,0,4,7,15
3/31/2009,8,0,7,2,17
4/1/2009,8,0,3,6,17
4/2/2009,2,0,7,8,17
4/3/2009,5,0,4,12,21
4/4/2009,6,0,4,4,14
4/5/2009,7,0,3,4,14
4/6/2009,3,0,3,1,7
4/7/2009,3,0,3,10,16
4/8/2009,3,0,8,3,14
4/9/2009,3,0,6,1,10
4/10/2009,6,0,6,3,15
4/11/2009,6,0,5,8,19
4/12/2009,5,0,2,10,17
4/13/2009,8,0,3,10,21
4/14/2009,8,0,5,8,21
4/15/2009,4,0,4,0,8
4/16/2009,7,0,2,2,11
4/17/2009,6,0,7,1,14
4/18/2009,8,0,6,1,15
4/19/2009,7,0,3,6,16
4/20/2009,4,0,4,12,20
4/21/2009,5,0,7,11,23
4/22/2009,6,0,6,13,25
4/23/2009,7,0,4,12,23
4/24/2009,6,0,4,7,17
4/25/2009,8,0,6,6,20
4/26/2009,6,0,6,2,14
4/27/2009,5,0,4,7,16
4/28/2009,4,0,2,6,12
4/29/2009,6,0,2,9,17
4/30/2009,2,0,3,7,12
5/1/2009,8,0,4,12,24
5/2/2009,5,0,7,13,25
5/3/2009,2,0,7,0,9
5/4/2009,7,0,7,11,25
5/5/2009,8,0,8,7,23
5/6/2009,5,0,4,2,11
5/7/2009,3,0,6,2,11
5/8/2009,7,0,3,2,12
5/9/2009,7,0,7,1,15
5/10/2009,8,0,7,12,27
5/11/2009,4,0,2,1,7
5/12/2009,5,0,6,6,17
5/13/2009,3,0,7,6,16
5/14/2009,3,0,8,7,18
5/15/2009,6,0,8,0,14
5/16/2009,3,0,6,9,18
5/17/2009,2,0,4,11,17
5/18/2009,7,0,2,12,21
5/19/2009,5,0,4,0,9
5/20/2009,2,0,6,12,20
5/21/2009,3,0,8,7,18
5/22/2009,6,0,6,10,22
5/23/2009,5,0,7,0,12
5/24/2009,4,0,3,10,17
5/25/2009,4,0,4,7,15
5/26/2009,5,0,3,5,13
5/27/2009,8,0,7,10,25
5/28/2009,2,0,7,5,14
5/29/2009,6,0,8,11,25
5/30/2009,8,0,4,6,18
5/31/2009,2,0,7,3,12
6/1/2009,4,0,4,9,17
6/2/2009,4,0,8,4,16
6/3/2009,2,0,8,4,14
6/4/2009,3,0,6,12,21
6/5/2009,5,0,3,1,9
6/6/2009,3,0,7,0,10
6/7/2009,3,0,4,3,10
6/8/2009,5,0,4,12,21
6/9/2009,8,0,8,1,17
6/10/2009,7,0,3,9,19
6/11/2009,8,0,7,4,19
6/12/2009,5,0,3,5,13
6/13/2009,8,0,6,13,27
6/14/2009,4,0,5,10,19
6/15/2009,7,0,3,7,17
6/16/2009,4,0,5,8,17
6/17/2009,5,0,3,4,12
6/18/2009,2,0,8,12,22
6/19/2009,5,0,4,7,16
6/20/2009,4,0,2,11,17
6/21/2009,6,0,8,2,16
6/22/2009,3,0,8,0,11
6/23/2009,6,0,2,4,12
6/24/2009,6,0,4,6,16
6/25/2009,8,0,3,11,22
6/26/2009,8,0,5,1,14
6/27/2009,2,0,6,0,8
6/28/2009,5,0,5,5,15
6/29/2009,3,0,7,6,16
6/30/2009,4,0,6,7,17
7/1/2009,3,0,6,8,17
7/2/2009,8,0,2,4,14
7/3/2009,5,0,2,6,13
7/4/2009,3,0,4,2,9
7/5/2009,2,0,3,3,8
7/6/2009,2,0,2,9,13
7/7/2009,3,0,4,13,20
7/8/2009,5,0,8,2,15
7/9/2009,3,0,4,2,9
7/10/2009,2,0,4,8,14
7/11/2009,4,0,8,13,25
7/12/2009,5,0,8,8,21
7/13/2009,7,0,3,10,20
7/14/2009,3,0,7,1,11
7/15/2009,4,0,7,1,12
7/16/2009,7,0,3,10,20
7/17/2009,3,0,3,9,15
7/18/2009,8,0,5,4,17
7/19/2009,5,0,7,7,19
7/20/2009,8,0,7,1,16
7/21/2009,6,0,5,6,17
7/22/2009,8,0,7,10,25
7/23/2009,8,0,5,5,18
7/24/2009,6,0,7,13,26
7/25/2009,2,0,5,11,18
7/26/2009,6,0,6,6,18
7/27/2009,7,0,7,12,26
7/28/2009,7,0,2,1,10
7/29/2009,3,0,3,3,9
7/30/2009,2,0,2,9,13
7/31/2009,7,0,7,5,19
8/1/2009,3,0,2,1,6
8/2/2009,3,0,6,12,21
8/3/2009,4,0,4,4,12
8/4/2009,3,0,2,13,18
8/5/2009,5,0,7,3,15
8/6/2009,2,0,7,11,20
8/7/2009,7,0,2,13,22
8/8/2009,5,0,8,1,14
8/9/2009,2,0,8,1,11
8/10/2009,3,0,4,1,8
8/11/2009,3,0,6,0,9
8/12/2009,8,0,7,3,18
8/13/2009,2,0,6,4,12
8/14/2009,2,0,4,6,12
8/15/2009,6,0,6,3,15
8/16/2009,5,0,6,9,20
8/17/2009,8,0,2,3,13
8/18/2009,5,0,6,4,15
8/19/2009,3,0,4,7,14
8/20/2009,5,0,7,9,21
8/21/2009,4,0,5,2,11
8/22/2009,2,0,2,9,13
8/23/2009,8,0,4,0,12
8/24/2009,5,0,5,13,23
8/25/2009,8,0,6,2,16
8/26/2009,3,0,8,1,12
8/27/2009,8,0,2,1,11
8/28/2009,3,0,4,12,19
8/29/2009,4,0,5,4,13
8/30/2009,3,0,5,12,20
8/31/2009,6,0,5,3,14
9/1/2009,2,0,8,11,21
9/2/2009,2,0,2,13,17
9/3/2009,4,0,4,1,9
9/4/2009,5,0,7,2,14
9/5/2009,8,0,7,13,28
9/6/2009,3,0,8,9,20
9/7/2009,7,0,4,6,17
9/8/2009,4,0,5,13,22
9/9/2009,7,0,6,3,16
9/10/2009,3,0,2,10,15
9/11/2009,7,0,3,7,17
9/12/2009,3,0,7,8,18
9/13/2009,5,0,5,5,15
9/14/2009,7,0,2,7,16
9/15/2009,6,0,6,9,21
9/16/2009,6,0,3,12,21
9/17/2009,4,0,3,0,7
9/18/2009,5,0,3,2,10
9/19/2009,3,0,7,10,20
9/20/2009,3,0,3,7,13
9/21/2009,6,0,6,5,17
9/22/2009,5,0,2,8,15
9/23/2009,4,0,4,4,12
9/24/2009,2,0,3,1,6
9/25/2009,4,0,8,7,19
9/26/2009,5,0,3,5,13
9/27/2009,7,0,4,7,18
9/28/2009,6,0,4,1,11
9/29/2009,6,0,6,5,17
9/30/2009,7,0,7,10,24
10/1/2009,7,0,7,11,25
10/2/2009,5,0,6,10,21
10/3/2009,5,0,5,10,20
10/4/2009,4,0,6,8,18
10/5/2009,7,0,5,10,22
10/6/2009,7,0,8,3,18
10/7/2009,2,0,2,7,11
10/8/2009,3,0,2,3,8
10/9/2009,5,0,4,8,17
10/10/2009,2,0,6,3,11
10/11/2009,3,0,4,4,11
10/12/2009,8,0,4,6,18
10/13/2009,4,0,3,4,11
10/14/2009,7,0,8,2,17
10/15/2009,3,0,7,8,18
10/16/2009,2,0,4,0,6
10/17/2009,8,0,5,13,26
10/18/2009,5,0,5,5,15
10/19/2009,2,0,5,10,17
10/20/2009,6,0,2,8,16
10/21/2009,6,0,8,6,20
10/22/2009,7,0,2,13,22
10/23/2009,4,0,8,7,19
10/24/2009,4,0,8,13,25
10/25/2009,4,0,3,9,16
10/26/2009,5,0,4,1,10
10/27/2009,5,0,5,13,23
10/28/2009,3,0,8,5,16
10/29/2009,5,0,7,5,17
10/30/2009,6,0,8,9,23
10/31/2009,5,0,3,7,15
11/1/2009,2,0,3,12,17
11/2/2009,2,0,4,3,9
11/3/2009,3,0,8,3,14
11/4/2009,5,0,4,4,13
11/5/2009,6,0,3,5,14
11/6/2009,8,0,6,1,15
11/7/2009,7,0,8,12,27
11/8/2009,3,0,3,3,9
11/9/2009,8,0,6,2,16
11/10/2009,8,0,2,2,12
11/11/2009,8,0,7,11,26
11/12/2009,4,0,3,7,14
11/13/2009,8,0,8,13,29
11/14/2009,8,0,4,8,20
11/15/2009,6,0,6,13,25
11/16/2009,4,0,5,11,20
11/17/2009,6,0,2,6,14
11/18/2009,2,0,5,12,19
11/19/2009,7,0,2,3,12
11/20/2009,8,0,3,8,19
11/21/2009,8,0,5,3,16
11/22/2009,8,0,8,12,28
11/23/2009,4,0,7,0,11
11/24/2009,5,0,6,10,21
11/25/2009,3,0,8,11,22
11/26/2009,4,0,7,3,14
11/27/2009,6,0,7,11,24
11/28/2009,5,0,4,9,18
11/29/2009,2,0,6,2,10
11/30/2009,6,0,6,13,25
12/1/2009,6,0,3,2,11
12/2/2009,5,0,7,10,22
12/3/2009,7,0,5,7,19
12/4/2009,7,0,4,2,13
12/5/2009,6,0,5,0,11
12/6/2009,8,0,7,9,24
12/7/2009,7,0,8,0,15
12/8/2009,5,0,6,2,13
12/9/2009,3,0,3,9,15
12/10/2009,7,0,7,6,20
12/11/2009,7,0,3,11,21
12/12/2009,4,0,2,9,15
12/13/2009,8,0,7,4,19
12/14/2009,6,0,4,7,17
12/15/2009,5,0,4,11,20
12/16/2009,5,0,5,11,21
12/17/2009,2,0,8,5,15
12/18/2009,6,0,4,12,22
12/19/2009,8,0,3,10,21
12/20/2009,4,0,8,1,13
12/21/2009,5,0,6,4,15
12/22/2009,7,0,2,2,11
12/23/2009,8,0,3,6,17
12/24/2009,7,0,5,5,17
12/25/2009,8,0,2,12,22
12/26/2009,3,0,8,1,12
12/27/2009,8,0,8,1,17
12/28/2009,8,0,4,6,18
12/29/2009,7,0,4,4,15
12/30/2009,4,0,7,13,24
12/31/2009,6,0,2,12,20
1/1/2010,2,0,6,2,10
1/2/2010,8,0,7,7,22
1/3/2010,2,0,7,8,17
1/4/2010,3,0,2,11,16
1/5/2010,4,0,5,4,13
1/6/2010,8,0,8,3,19
1/7/2010,4,0,8,2,14
1/8/2010,7,0,4,10,21
1/9/2010,6,0,7,12,25
1/10/2010,2,0,4,7,13
1/11/2010,3,0,5,1,9
1/12/2010,5,0,6,9,20
1/13/2010,5,0,4,9,18
1/14/2010,4,0,7,11,22
1/15/2010,5,0,7,10,22
1/16/2010,8,0,6,6,20
1/17/2010,8,0,7,2,17
1/18/2010,6,0,4,11,21
1/19/2010,7,0,5,9,21
1/20/2010,7,0,6,9,22
1/21/2010,6,0,5,0,11
1/22/2010,6,0,2,7,15
1/23/2010,6,0,7,0,13
1/24/2010,6,0,8,10,24
1/25/2010,7,0,6,3,16
1/26/2010,6,0,3,13,22
1/27/2010,7,0,7,7,21
1/28/2010,2,0,4,2,8
1/29/2010,6,0,4,1,11
1/30/2010,3,0,5,0,8
1/31/2010,8,0,5,2,15
2/1/2010,4,0,7,7,18
2/2/2010,7,0,4,11,22
2/3/2010,7,0,5,12,24
2/4/2010,2,0,7,11,20
2/5/2010,3,0,8,9,20
2/6/2010,2,0,5,12,19
2/7/2010,5,0,8,11,24
2/8/2010,4,0,8,2,14
2/9/2010,8,0,2,0,10
2/10/2010,2,0,8,0,10
2/11/2010,8,0,7,4,19
2/12/2010,2,0,4,12,18
2/13/2010,2,0,6,11,19
2/14/2010,7,0,5,10,22
2/15/2010,6,0,6,4,16
2/16/2010,3,0,4,1,8
2/17/2010,5,0,7,0,12
2/18/2010,7,0,7,10,24
2/19/2010,2,0,8,1,11
2/20/2010,8,0,4,2,14
2/21/2010,7,0,7,7,21
2/22/2010,2,0,5,4,11
2/23/2010,2,0,8,12,22
2/24/2010,3,0,8,1,12
2/25/2010,3,0,2,1,6
2/26/2010,6,0,3,12,21
2/27/2010,8,0,3,10,21
2/28/2010,7,0,8,9,24
3/1/2010,8,0,8,6,22
3/2/2010,4,0,3,10,17
3/3/2010,6,0,2,1,9
3/4/2010,8,0,4,1,13
3/5/2010,2,0,7,8,17
3/6/2010,6,0,8,3,17
3/7/2010,2,0,6,5,13
3/8/2010,2,0,6,4,12
3/9/2010,4,0,5,8,17
3/10/2010,3,0,5,7,15
3/11/2010,8,0,3,11,22
3/12/2010,3,0,3,4,10
3/13/2010,2,0,2,13,17
3/14/2010,8,0,7,10,25
3/15/2010,6,0,5,3,14
3/16/2010,5,0,2,7,14
3/17/2010,5,0,6,2,13
3/18/2010,3,0,8,4,15
3/19/2010,4,0,7,2,13
3/20/2010,4,0,4,2,10
3/21/2010,6,0,3,7,16
3/22/2010,6,0,3,12,21
3/23/2010,7,0,3,9,19
3/24/2010,2,0,2,11,15
3/25/2010,8,0,5,0,13
3/26/2010,8,0,8,4,20
3/27/2010,3,0,4,1,8
3/28/2010,4,0,4,11,19
3/29/2010,8,0,4,7,19
3/30/2010,2,0,4,12,18
3/31/2010,2,0,4,2,8
4/1/2010,4,0,8,2,14
4/2/2010,5,0,5,6,16
4/3/2010,2,0,2,3,7
4/4/2010,6,0,8,10,24
4/5/2010,6,0,3,3,12
4/6/2010,8,0,2,4,14
4/7/2010,7,0,3,11,21
4/8/2010,5,0,6,11,22
4/9/2010,8,0,4,0,12
4/10/2010,3,0,5,6,14
4/11/2010,2,0,8,3,13
4/12/2010,3,0,7,5,15
4/13/2010,2,0,7,1,10
4/14/2010,3,0,8,10,21
4/15/2010,2,0,7,6,15
4/16/2010,7,0,3,7,17
4/17/2010,3,0,7,6,16
4/18/2010,4,0,8,1,13
4/19/2010,2,0,4,11,17
4/20/2010,8,0,8,9,25
4/21/2010,4,0,6,0,10
4/22/2010,8,0,4,6,18
4/23/2010,6,0,8,10,24
4/24/2010,7,0,5,9,21
4/25/2010,3,0,2,10,15
4/26/2010,6,0,7,13,26
4/27/2010,4,0,5,8,17
4/28/2010,5,0,4,6,15
4/29/2010,3,0,6,3,12
4/30/2010,4,0,8,7,19
5/1/2010,3,0,3,7,13
5/2/2010,7,0,4,13,24
5/3/2010,8,0,6,11,25
5/4/2010,8,0,7,12,27
5/5/2010,5,0,4,6,15
5/6/2010,5,0,5,10,20
5/7/2010,2,0,3,6,11
5/8/2010,4,0,8,8,20
5/9/2010,2,0,2,3,7
5/10/2010,6,0,7,3,16
5/11/2010,7,0,2,11,20
5/12/2010,3,0,3,9,15
5/13/2010,4,0,3,5,12
5/14/2010,2,0,7,6,15
5/15/2010,8,0,4,4,16
5/16/2010,6,0,2,9,17
5/17/2010,5,0,7,6,18
5/18/2010,2,0,3,8,13
5/19/2010,7,0,8,13,28
5/20/2010,5,0,2,3,10
5/21/2010,6,0,4,4,14
5/22/2010,7,0,6,1,14
5/23/2010,2,0,6,11,19
5/24/2010,4,0,7,7,18
5/25/2010,2,0,2,2,6
5/26/2010,5,0,6,6,17
5/27/2010,7,0,7,11,25
5/28/2010,6,0,4,12,22
5/29/2010,3,0,3,5,11
5/30/2010,3,0,2,8,13
5/31/2010,4,0,7,2,13
6/1/2010,8,0,5,10,23
6/2/2010,8,0,8,0,16
6/3/2010,2,0,6,1,9
6/4/2010,2,0,7,5,14
6/5/2010,7,0,6,0,13
6/6/2010,3,0,4,10,17
6/7/2010,5,0,7,7,19
6/8/2010,6,0,5,9,20
6/9/2010,8,0,5,5,18
6/10/2010,5,0,7,1,13
6/11/2010,4,0,8,3,15
6/12/2010,5,0,2,3,10
6/13/2010,5,0,5,6,16
6/14/2010,2,0,6,0,8
6/15/2010,8,0,3,4,15
6/16/2010,6,0,3,1,10
6/17/2010,5,0,6,12,23
6/18/2010,3,0,3,9,15
6/19/2010,7,0,7,0,14
6/20/2010,4,0,8,7,19
6/21/2010,6,0,8,0,14
6/22/2010,3,0,3,2,8
6/23/2010,4,0,4,1,9
6/24/2010,2,0,6,11,19
6/25/2010,3,0,7,4,14
6/26/2010,5,0,4,9,18
6/27/2010,3,0,7,11,21
6/28/2010,8,0,8,0,16
6/29/2010,4,0,3,7,14
6/30/2010,3,0,2,9,14
7/1/2010,3,0,6,7,16
7/2/2010,3,0,5,0,8
7/3/2010,8,0,8,1,17
7/4/2010,3,0,3,5,11
7/5/2010,7,0,8,2,17
7/6/2010,8,0,7,12,27
7/7/2010,6,0,4,9,19
7/8/2010,4,0,2,2,8
7/9/2010,2,0,3,8,13
7/10/2010,3,0,5,13,21
7/11/2010,6,0,4,2,12
7/12/2010,8,0,8,13,29
7/13/2010,8,0,5,4,17
7/14/2010,5,0,4,7,16
7/15/2010,5,0,4,0,9
7/16/2010,8,0,7,10,25
7/17/2010,4,0,5,12,21
7/18/2010,6,0,4,0,10
7/19/2010,6,0,4,12,22
7/20/2010,8,0,6,8,22
7/21/2010,5,0,3,11,19
7/22/2010,3,0,4,5,12
7/23/2010,5,0,3,1,9
7/24/2010,2,0,3,9,14
7/25/2010,5,0,4,7,16
7/26/2010,5,0,2,1,8
7/27/2010,4,0,8,3,15
7/28/2010,6,0,7,8,21
7/29/2010,3,0,3,0,6
7/30/2010,4,0,5,3,12
7/31/2010,6,0,5,7,18
8/1/2010,2,0,2,6,10
8/2/2010,3,0,2,12,17
8/3/2010,5,0,2,4,11
8/4/2010,7,0,2,7,16
8/5/2010,5,0,2,10,17
8/6/2010,5,0,8,11,24
8/7/2010,5,0,3,11,19
8/8/2010,7,0,5,4,16
8/9/2010,7,0,2,8,17
8/10/2010,3,0,8,1,12
8/11/2010,5,0,6,0,11
8/12/2010,4,0,2,4,10
8/13/2010,8,0,5,7,20
8/14/2010,3,0,8,10,21
8/15/2010,4,0,3,4,11
8/16/2010,5,0,2,2,9
8/17/2010,3,0,8,5,16
8/18/2010,2,0,4,7,13
8/19/2010,6,0,7,3,16
8/20/2010,2,0,2,6,10
8/21/2010,3,0,8,5,16
8/22/2010,6,0,3,4,13
8/23/2010,2,0,2,11,15
8/24/2010,3,0,2,2,7
8/25/2010,7,0,7,9,23
8/26/2010,7,0,5,0,12
8/27/2010,7,0,6,8,21
8/28/2010,4,0,6,1,11
8/29/2010,7,0,6,10,23
8/30/2010,8,0,5,4,17
8/31/2010,4,0,5,13,22
9/1/2010,4,0,8,10,22
9/2/2010,8,0,3,12,23
9/3/2010,7,0,6,0,13
9/4/2010,7,0,8,11,26
9/5/2010,3,0,3,12,18
9/6/2010,6,0,4,11,21
9/7/2010,6,0,4,3,13
9/8/2010,6,0,4,0,10
9/9/2010,4,0,4,9,17
9/10/2010,8,0,3,11,22
9/11/2010,5,0,8,10,23
9/12/2010,3,0,2,8,13
9/13/2010,8,0,8,8,24
9/14/2010,4,0,6,7,17
9/15/2010,5,0,2,12,19
9/16/2010,4,0,5,6,15
9/17/2010,6,0,8,13,27
9/18/2010,6,0,5,10,21
9/19/2010,8,0,8,2,18
9/20/2010,3,0,3,10,16
9/21/2010,6,0,4,4,14
9/22/2010,7,0,2,3,12
9/23/2010,4,0,3,5,12
9/24/2010,2,0,8,0,10
9/25/2010,6,0,6,1,13
9/26/2010,5,0,7,4,16
9/27/2010,4,0,7,4,15
9/28/2010,5,0,3,12,20
9/29/2010,7,0,6,2,15
9/30/2010,2,0,7,6,15
10/1/2010,6,0,4,1,11
10/2/2010,7,0,8,10,25
10/3/2010,4,0,5,1,10
10/4/2010,3,0,7,5,15
10/5/2010,4,0,7,8,19
10/6/2010,2,0,7,10,19
10/7/2010,4,0,2,11,17
10/8/2010,6,0,7,9,22
10/9/2010,6,0,4,7,17
10/10/2010,5,0,4,11,20
10/11/2010,3,0,3,9,15
10/12/2010,4,0,2,11,17
10/13/2010,6,0,6,0,12
10/14/2010,2,0,4,12,18
10/15/2010,6,0,4,8,18
10/16/2010,3,0,2,8,13
10/17/2010,8,0,3,11,22
10/18/2010,2,0,4,9,15
10/19/2010,7,0,3,9,19
10/20/2010,2,0,2,3,7
10/21/2010,4,0,8,11,23
10/22/2010,4,0,8,12,24
10/23/2010,2,0,7,5,14
10/24/2010,2,0,6,3,11
10/25/2010,6,0,2,9,17
10/26/2010,2,0,3,4,9
10/27/2010,6,0,7,10,23
10/28/2010,5,0,4,12,21
10/29/2010,7,0,4,4,15
10/30/2010,7,0,8,4,19
10/31/2010,4,0,2,0,6
11/1/2010,7,0,3,12,22
11/2/2010,6,0,5,9,20
11/3/2010,6,0,3,5,14
11/4/2010,6,0,7,8,21
11/5/2010,3,0,2,8,13
11/6/2010,2,0,2,9,13
11/7/2010,4,0,2,9,15
11/8/2010,5,0,7,12,24
11/9/2010,7,0,5,13,25
11/10/2010,6,0,6,5,17
11/11/2010,8,0,7,9,24
11/12/2010,2,0,5,1,8
11/13/2010,3,0,3,5,11
11/14/2010,2,0,2,9,13
11/15/2010,3,0,4,5,12
11/16/2010,8,0,2,9,19
11/17/2010,3,0,3,9,15
11/18/2010,4,0,4,3,11
11/19/2010,2,0,4,4,10
11/20/2010,3,0,4,1,8
11/21/2010,5,0,3,2,10
11/22/2010,7,0,8,2,17
11/23/2010,7,0,2,11,20
11/24/2010,8,0,8,7,23
11/25/2010,7,0,8,12,27
11/26/2010,8,0,8,13,29
11/27/2010,4,0,4,0,8
11/28/2010,3,0,5,2,10
11/29/2010,2,0,8,7,17
11/30/2010,3,0,8,12,23
12/1/2010,5,0,8,2,15
12/2/2010,6,0,3,0,9
12/3/2010,7,0,8,9,24
12/4/2010,6,0,8,12,26
12/5/2010,8,0,8,0,16
12/6/2010,8,0,5,4,17
12/7/2010,4,0,3,11,18
12/8/2010,8,0,2,8,18
12/9/2010,4,0,6,1,11
12/10/2010,5,0,3,5,13
12/11/2010,6,0,6,0,12
12/12/2010,6,0,2,7,15
12/13/2010,7,0,5,9,21
12/14/2010,3,0,2,7,12
12/15/2010,5,0,4,7,16
12/16/2010,3,0,2,8,13
12/17/2010,8,0,8,13,29
12/18/2010,7,0,4,2,13
12/19/2010,5,0,3,2,10
12/20/2010,3,0,8,10,21
12/21/2010,6,0,8,0,14
12/22/2010,3,0,4,12,19
12/23/2010,8,0,2,0,10
12/24/2010,8,0,4,10,22
12/25/2010,7,0,8,1,16
12/26/2010,6,0,6,6,18
12/27/2010,2,0,2,2,6
12/28/2010,3,0,2,3,8
12/29/2010,6,0,5,1,12
12/30/2010,8,0,7,5,20
12/31/2010,4,0,2,10,16
1/1/2011,7,0,7,13,27
1/2/2011,6,0,2,4,12
1/3/2011,6,0,8,8,22
1/4/2011,6,0,7,5,18
1/5/2011,8,0,8,0,16
1/6/2011,4,0,6,13,23
1/7/2011,2,0,4,13,19
1/8/2011,6,0,3,13,22
1/9/2011,8,0,7,9,24
1/10/2011,8,0,8,7,23
1/11/2011,7,0,8,12,27
1/12/2011,4,0,5,9,18
1/13/2011,7,0,5,10,22
1/14/2011,3,0,4,10,17
1/15/2011,2,0,8,8,18
1/16/2011,3,0,6,8,17
1/17/2011,8,0,2,1,11
1/18/2011,8,0,4,11,23
1/19/2011,6,0,8,11,25
1/20/2011,4,0,4,13,21
1/21/2011,8,0,5,9,22
1/22/2011,8,0,6,8,22
1/23/2011,4,0,5,2,11
1/24/2011,6,0,3,6,15
1/25/2011,2,0,6,12,20
1/26/2011,2,0,4,2,8
1/27/2011,5,0,8,10,23
1/28/2011,8,0,6,0,14
1/29/2011,3,0,3,7,13
1/30/2011,8,0,5,3,16
1/31/2011,5,0,8,9,22
2/1/2011,4,0,5,1,10
2/2/2011,5,0,2,13,20
2/3/2011,6,0,4,5,15
2/4/2011,8,0,3,1,12
2/5/2011,2,0,2,5,9
2/6/2011,8,0,6,3,17
2/7/2011,6,0,7,7,20
2/8/2011,8,0,3,3,14
2/9/2011,5,0,2,9,16
2/10/2011,8,0,5,8,21
2/11/2011,3,0,7,6,16
2/12/2011,4,0,2,4,10
2/13/2011,3,0,2,4,9
2/14/2011,8,0,8,1,17
2/15/2011,8,0,6,12,26
2/16/2011,5,0,6,9,20
2/17/2011,4,0,7,8,19
2/18/2011,6,0,3,2,11
2/19/2011,6,0,4,12,22
2/20/2011,8,0,7,3,18
2/21/2011,4,0,5,10,19
2/22/2011,8,0,7,11,26
2/23/2011,6,0,2,4,12
2/24/2011,4,0,4,11,19
2/25/2011,6,0,2,2,10
2/26/2011,5,0,2,4,11
2/27/2011,7,0,6,8,21
2/28/2011,8,0,5,8,21
3/1/2011,2,0,7,11,20
3/2/2011,5,0,2,13,20
3/3/2011,6,0,5,0,11
3/4/2011,2,0,6,1,9
3/5/2011,5,0,4,11,20
3/6/2011,7,0,4,12,23
3/7/2011,5,0,3,12,20
3/8/2011,6,0,2,3,11
3/9/2011,2,0,3,12,17
3/10/2011,4,0,7,8,19
3/11/2011,5,0,4,12,21
3/12/2011,7,0,5,5,17
3/13/2011,3,0,7,4,14
3/14/2011,3,0,5,7,15
3/15/2011,6,0,2,11,19
3/16/2011,6,0,3,11,20
3/17/2011,2,0,3,4,9
3/18/2011,7,0,8,3,18
3/19/2011,2,0,2,11,15
3/20/2011,8,0,2,4,14
3/21/2011,2,0,6,3,11
3/22/2011,4,0,4,1,9
3/23/2011,8,0,2,2,12
3/24/2011,4,0,8,8,20
3/25/2011,8,0,4,0,12
3/26/2011,6,0,4,0,10
3/27/2011,5,0,6,3,14
3/28/2011,2,0,3,11,16
3/29/2011,4,0,2,6,12
3/30/2011,2,0,8,5,15
3/31/2011,3,0,7,11,21
4/1/2011,5,0,7,7,19
4/2/2011,3,0,7,7,17
4/3/2011,7,0,5,2,14
4/4/2011,6,0,2,4,12
4/5/2011,6,0,6,1,13
4/6/2011,8,0,4,11,23
4/7/2011,3,0,8,4,15
4/8/2011,4,0,8,3,15
4/9/2011,6,0,8,8,22
4/10/2011,4,0,5,12,21
4/11/2011,7,0,5,9,21
4/12/2011,8,0,7,9,24
4/13/2011,8,0,4,3,15
4/14/2011,8,0,8,6,22
4/15/2011,2,0,2,1,5
4/16/2011,7,0,5,5,17
4/17/2011,2,0,4,1,7
4/18/2011,8,0,4,3,15
4/19/2011,8,0,3,10,21
4/20/2011,4,0,7,0,11
4/21/2011,4,0,8,13,25
4/22/2011,5,0,6,12,23
4/23/2011,6,0,2,3,11
4/24/2011,7,0,6,11,24
4/25/2011,4,0,8,8,20
4/26/2011,5,0,3,2,10
4/27/2011,3,0,5,10,18
4/28/2011,6,0,4,10,20
4/29/2011,8,0,6,2,16
4/30/2011,7,0,2,5,14
5/1/2011,4,0,4,10,18
5/2/2011,5,0,7,5,17
5/3/2011,7,0,2,9,18
5/4/2011,2,0,6,11,19
5/5/2011,7,0,3,4,14
5/6/2011,5,0,7,0,12
5/7/2011,8,0,7,0,15
5/8/2011,7,0,3,11,21
5/9/2011,7,0,4,4,15
5/10/2011,5,0,2,5,12
5/11/2011,4,0,5,2,11
5/12/2011,4,0,3,7,14
5/13/2011,8,0,3,13,24
5/14/2011,2,0,4,7,13
5/15/2011,3,0,3,11,17
5/16/2011,8,0,5,9,22
5/17/2011,4,0,7,10,21
5/18/2011,6,0,6,7,19
5/19/2011,7,0,5,5,17
5/20/2011,7,0,8,13,28
5/21/2011,2,0,3,6,11
5/22/2011,5,0,6,7,18
5/23/2011,6,0,6,10,22
5/24/2011,6,0,2,9,17
5/25/2011,7,0,6,4,17
5/26/2011,5,0,2,13,20
5/27/2011,8,0,3,7,18
5/28/2011,3,0,3,6,12
5/29/2011,2,0,8,5,15
5/30/2011,4,0,4,5,13
5/31/2011,4,0,7,10,21
6/1/2011,2,0,2,9,13
6/2/2011,4,0,8,5,17
6/3/2011,3,0,4,5,12
6/4/2011,3,0,8,11,22
6/5/2011,3,0,7,9,19
6/6/2011,2,0,2,10,14
6/7/2011,3,0,5,1,9
6/8/2011,5,0,7,10,22
6/9/2011,8,0,4,10,22
6/10/2011,2,0,6,13,21
6/11/2011,8,0,5,2,15
6/12/2011,2,0,2,7,11
6/13/2011,4,0,7,0,11
6/14/2011,5,0,4,11,20
6/15/2011,3,0,7,5,15
6/16/2011,4,0,6,12,22
6/17/2011,6,0,2,2,10
6/18/2011,8,0,7,13,28
6/19/2011,5,0,3,9,17
6/20/2011,3,0,3,12,18
6/21/2011,6,0,3,4,13
6/22/2011,7,0,4,6,17
6/23/2011,2,0,8,9,19
6/24/2011,6,0,7,9,22
6/25/2011,7,0,7,4,18
6/26/2011,3,0,3,7,13
6/27/2011,4,0,3,11,18
6/28/2011,8,0,2,2,12
6/29/2011,8,0,2,5,15
6/30/2011,8,0,4,8,20
7/1/2011,3,0,5,11,19
7/2/2011,7,0,5,6,18
7/3/2011,5,0,2,11,18
7/4/2011,6,0,4,1,11
7/5/2011,3,0,5,6,14
7/6/2011,5,0,2,9,16
7/7/2011,5,0,6,10,21
7/8/2011,3,0,8,5,16
7/9/2011,5,0,8,9,22
7/10/2011,2,0,2,6,10
7/11/2011,3,0,4,8,15
7/12/2011,7,0,6,10,23
7/13/2011,2,0,2,12,16
7/14/2011,3,0,8,5,16
7/15/2011,3,0,2,11,16
7/16/2011,8,0,3,1,12
7/17/2011,4,0,7,2,13
7/18/2011,6,0,4,13,23
7/19/2011,2,0,5,7,14
7/20/2011,5,0,3,3,11
7/21/2011,2,0,4,7,13
7/22/2011,2,0,3,4,9
7/23/2011,5,0,8,7,20
7/24/2011,3,0,2,0,5
7/25/2011,5,0,4,5,14
7/26/2011,3,0,8,1,12
7/27/2011,6,0,2,13,21
7/28/2011,2,0,6,4,12
7/29/2011,6,0,8,10,24
7/30/2011,8,0,2,13,23
7/31/2011,8,0,3,13,24
8/1/2011,6,0,3,0,9
8/2/2011,3,0,8,11,22
8/3/2011,7,0,4,4,15
8/4/2011,4,0,8,6,18
8/5/2011,5,0,6,3,14
8/6/2011,7,0,4,5,16
8/7/2011,6,0,8,4,18
8/8/2011,8,0,4,2,14
8/9/2011,8,0,7,11,26
8/10/2011,8,0,4,1,13
8/11/2011,6,0,8,8,22
8/12/2011,2,0,7,2,11
8/13/2011,7,0,6,3,16
8/14/2011,2,0,5,5,12
8/15/2011,6,0,6,11,23
8/16/2011,5,0,2,1,8
8/17/2011,6,0,7,4,17
8/18/2011,2,0,6,12,20
8/19/2011,8,0,5,4,17
8/20/2011,8,0,7,11,26
8/21/2011,8,0,2,6,16
8/22/2011,3,0,2,9,14
8/23/2011,6,0,8,5,19
8/24/2011,6,0,8,11,25
8/25/2011,6,0,5,2,13
8/26/2011,3,0,6,4,13
8/27/2011,6,0,3,2,11
8/28/2011,8,0,7,2,17
8/29/2011,4,0,3,6,13
8/30/2011,7,0,8,4,19
8/31/2011,7,0,4,7,18
9/1/2011,4,0,4,10,18
9/2/2011,2,0,8,13,23
9/3/2011,4,0,6,9,19
9/4/2011,3,0,5,11,19
9/5/2011,5,0,3,11,19
9/6/2011,2,0,4,2,8
9/7/2011,5,0,7,7,19
9/8/2011,8,0,8,7,23
9/9/2011,8,0,2,2,12
9/10/2011,6,0,8,11,25
9/11/2011,7,0,5,10,22
9/12/2011,4,0,4,3,11
9/13/2011,7,0,7,0,14
9/14/2011,5,0,3,5,13
9/15/2011,3,0,5,9,17
9/16/2011,5,0,8,4,17
9/17/2011,8,0,4,4,16
9/18/2011,5,0,2,8,15
9/19/2011,8,0,4,9,21
9/20/2011,4,0,5,12,21
9/21/2011,6,0,4,5,15
9/22/2011,8,0,2,6,16
9/23/2011,7,0,8,0,15
9/24/2011,2,0,2,9,13
9/25/2011,7,0,2,10,19
9/26/2011,8,0,4,3,15
9/27/2011,8,0,7,3,18
9/28/2011,7,0,8,9,24
9/29/2011,6,0,7,0,13
9/30/2011,6,0,5,9,20
10/1/2011,4,0,2,9,15
10/2/2011,7,0,2,8,17
10/3/2011,4,0,6,0,10
10/4/2011,2,0,3,5,10
10/5/2011,5,0,8,1,14
10/6/2011,5,0,7,11,23
10/7/2011,2,0,2,10,14
10/8/2011,7,0,6,3,16
10/9/2011,2,0,2,8,12
10/10/2011,5,0,7,2,14
10/11/2011,5,0,3,5,13
10/12/2011,7,0,2,8,17
10/13/2011,7,0,5,4,16
10/14/2011,6,0,4,9,19
10/15/2011,2,0,4,9,15
10/16/2011,2,0,4,4,10
10/17/2011,3,0,5,5,13
10/18/2011,5,0,5,12,22
10/19/2011,6,0,2,12,20
10/20/2011,4,0,4,13,21
10/21/2011,6,0,5,9,20
10/22/2011,8,0,6,0,14
10/23/2011,8,0,2,1,11
10/24/2011,6,0,3,3,12
10/25/2011,2,0,3,4,9
10/26/2011,2,0,6,0,8
10/27/2011,5,0,6,2,13
10/28/2011,2,0,4,11,17
10/29/2011,8,0,3,7,18
10/30/2011,8,0,4,1,13
10/31/2011,6,0,3,13,22
11/1/2011,2,0,7,3,12
11/2/2011,3,0,4,1,8
11/3/2011,7,0,2,11,20
11/4/2011,5,0,8,13,26
11/5/2011,3,0,7,0,10
11/6/2011,3,0,3,4,10
11/7/2011,3,0,2,1,6
11/8/2011,3,0,2,0,5
11/9/2011,6,0,7,1,14
11/10/2011,4,0,3,1,8
11/11/2011,7,0,7,9,23
11/12/2011,6,0,2,6,14
11/13/2011,8,0,6,9,23
11/14/2011,6,0,5,9,20
11/15/2011,7,0,5,12,24
11/16/2011,4,0,7,9,20
11/17/2011,7,0,3,5,15
11/18/2011,3,0,6,9,18
11/19/2011,5,0,3,2,10
11/20/2011,6,0,3,2,11
11/21/2011,7,0,5,0,12
11/22/2011,5,0,5,4,14
11/23/2011,8,0,7,10,25
11/24/2011,7,0,2,5,14
11/25/2011,8,0,2,10,20
11/26/2011,5,0,2,3,10
11/27/2011,7,0,7,0,14
11/28/2011,5,0,2,10,17
11/29/2011,7,0,6,0,13
11/30/2011,7,0,7,11,25
12/1/2011,6,0,3,9,18
12/2/2011,7,0,3,1,11
12/3/2011,6,0,2,9,17
12/4/2011,8,0,2,5,15
12/5/2011,6,0,4,8,18
12/6/2011,8,0,5,0,13
12/7/2011,7,0,6,1,14
12/8/2011,8,0,2,0,10
12/9/2011,7,0,8,8,23
12/10/2011,7,0,8,10,25
12/11/2011,3,0,4,3,10
12/12/2011,6,0,6,12,24
12/13/2011,4,0,6,13,23
12/14/2011,6,0,5,7,18
12/15/2011,8,0,3,11,22
12/16/2011,6,0,5,1,12
12/17/2011,4,0,6,0,10
12/18/2011,5,0,4,0,9
12/19/2011,7,0,5,5,17
12/20/2011,5,0,8,0,13
12/21/2011,4,0,4,4,12
12/22/2011,6,0,4,2,12
12/23/2011,7,0,5,13,25
12/24/2011,3,0,2,12,17
12/25/2011,2,0,8,13,23
12/26/2011,8,0,8,12,28
12/27/2011,8,0,3,4,15
12/28/2011,3,0,2,5,10
12/29/2011,6,0,8,5,19
12/30/2011,8,0,2,12,22
12/31/2011,5,0,8,6,19
1/1/2012,4,0,4,6,14
1/2/2012,6,0,3,13,22
1/3/2012,5,0,6,6,17
1/4/2012,8,0,6,1,15
1/5/2012,6,0,2,9,17
1/6/2012,2,0,6,8,16
1/7/2012,7,0,3,13,23
1/8/2012,4,0,5,11,20
1/9/2012,4,0,8,0,12
1/10/2012,2,0,3,10,15
1/11/2012,2,0,2,7,11
1/12/2012,7,0,4,7,18
1/13/2012,6,0,5,0,11
1/14/2012,7,0,8,13,28
1/15/2012,3,0,7,3,13
1/16/2012,7,0,5,7,19
1/17/2012,7,0,5,8,20
1/18/2012,3,0,7,11,21
1/19/2012,7,0,5,4,16
1/20/2012,2,0,7,0,9
1/21/2012,3,0,8,5,16
1/22/2012,2,0,8,4,14
1/23/2012,2,0,5,6,13
1/24/2012,7,0,7,1,15
1/25/2012,4,0,7,10,21
1/26/2012,6,0,4,6,16
1/27/2012,4,0,7,2,13
1/28/2012,4,0,2,8,14
1/29/2012,7,0,2,10,19
1/30/2012,5,0,7,6,18
1/31/2012,5,0,4,1,10
2/1/2012,2,0,3,1,6
2/2/2012,4,0,6,10,20
2/3/2012,3,0,7,2,12
2/4/2012,7,0,2,10,19
2/5/2012,7,0,2,1,10
2/6/2012,2,0,6,11,19
2/7/2012,6,0,7,0,13
2/8/2012,3,0,5,10,18
2/9/2012,4,0,2,13,19
2/10/2012,5,0,2,9,16
2/11/2012,5,0,5,3,13
2/12/2012,3,0,4,6,13
2/13/2012,4,0,8,6,18
2/14/2012,2,0,5,5,12
2/15/2012,2,0,8,11,21
2/16/2012,4,0,4,12,20
2/17/2012,7,0,4,2,13
2/18/2012,8,0,8,1,17
2/19/2012,3,0,4,12,19
2/20/2012,8,0,3,12,23
2/21/2012,4,0,6,13,23
2/22/2012,3,0,6,1,10
2/23/2012,6,0,5,5,16
2/24/2012,2,0,6,9,17
2/25/2012,8,0,3,12,23
2/26/2012,4,0,6,1,11
2/27/2012,7,0,6,5,18
2/28/2012,5,0,3,1,9
2/29/2012,6,0,6,11,23
3/1/2012,7,0,8,1,16
3/2/2012,4,0,3,8,15
3/3/2012,3,0,2,9,14
3/4/2012,6,0,6,12,24
3/5/2012,4,0,5,13,22
3/6/2012,6,0,2,9,17
3/7/2012,5,0,8,0,13
3/8/2012,2,0,8,9,19
3/9/2012,3,0,3,13,19
3/10/2012,3,0,3,6,12
3/11/2012,4,0,4,7,15
3/12/2012,7,0,8,0,15
3/13/2012,4,0,6,10,20
3/14/2012,7,0,7,13,27
3/15/2012,2,0,2,3,7
3/16/2012,2,0,5,7,14
3/17/2012,3,0,3,9,15
3/18/2012,7,0,2,10,19
3/19/2012,5,0,8,13,26
3/20/2012,2,0,3,11,16
3/21/2012,4,0,3,9,16
3/22/2012,7,0,5,0,12
3/23/2012,8,0,5,9,22
3/24/2012,3,0,7,11,21
3/25/2012,3,0,4,0,7
3/26/2012,3,0,2,9,14
3/27/2012,2,0,5,3,10
3/28/2012,5,0,3,8,16
3/29/2012,8,0,3,11,22
3/30/2012,5,0,8,9,22
3/31/2012,6,0,6,11,23
4/1/2012,6,0,8,2,16
4/2/2012,5,0,6,5,16
4/3/2012,7,0,3,9,19
4/4/2012,5,0,2,1,8
4/5/2012,3,0,4,2,9
4/6/2012,4,0,7,10,21
4/7/2012,5,0,7,10,22
4/8/2012,6,0,5,2,13
4/9/2012,2,0,6,8,16
4/10/2012,2,0,2,11,15
4/11/2012,5,0,4,3,12
4/12/2012,8,0,6,1,15
4/13/2012,8,0,8,13,29
4/14/2012,4,0,6,1,11
4/15/2012,8,0,7,2,17
4/16/2012,6,0,3,12,21
4/17/2012,2,0,3,3,8
4/18/2012,8,0,4,8,20
4/19/2012,8,0,2,13,23
4/20/2012,7,0,8,4,19
4/21/2012,5,0,5,10,20
4/22/2012,7,0,8,3,18
4/23/2012,2,0,6,10,18
4/24/2012,2,0,4,7,13
4/25/2012,3,0,3,9,15
4/26/2012,3,0,6,12,21
4/27/2012,5,0,4,0,9
4/28/2012,2,0,7,4,13
4/29/2012,6,0,2,5,13
4/30/2012,3,0,6,4,13
5/1/2012,8,0,2,4,14
5/2/2012,3,0,8,7,18
5/3/2012,3,0,2,10,15
5/4/2012,8,0,4,6,18
5/5/2012,8,0,7,9,24
5/6/2012,8,0,8,1,17
5/7/2012,3,0,2,0,5
5/8/2012,2,0,2,7,11
5/9/2012,7,0,2,1,10
5/10/2012,3,0,4,8,15
5/11/2012,4,0,5,3,12
5/12/2012,5,0,3,9,17
5/13/2012,2,0,4,0,6
5/14/2012,6,0,6,5,17
5/15/2012,5,0,4,13,22
5/16/2012,5,0,3,5,13
5/17/2012,2,0,7,13,22
5/18/2012,4,0,2,2,8
5/19/2012,3,0,2,2,7
5/20/2012,5,0,7,3,15
5/21/2012,4,0,2,6,12
5/22/2012,8,0,5,6,19
5/23/2012,8,0,5,5,18
5/24/2012,8,0,5,4,17
5/25/2012,7,0,4,2,13
5/26/2012,5,0,7,12,24
5/27/2012,8,0,2,2,12
5/28/2012,4,0,2,4,10
5/29/2012,4,0,6,5,15
5/30/2012,7,0,4,8,19
5/31/2012,3,0,7,0,10
6/1/2012,6,0,3,4,13
6/2/2012,5,0,2,7,14
6/3/2012,6,0,7,1,14
6/4/2012,5,0,2,3,10
6/5/2012,5,0,5,9,19
6/6/2012,5,0,5,11,21
6/7/2012,7,0,7,10,24
6/8/2012,7,0,5,5,17
6/9/2012,3,0,7,7,17
6/10/2012,6,0,6,3,15
6/11/2012,6,0,6,6,18
6/12/2012,2,0,7,8,17
6/13/2012,4,0,4,10,18
6/14/2012,2,0,8,11,21
6/15/2012,8,0,3,2,13
6/16/2012,4,0,6,5,15
6/17/2012,5,0,2,12,19
6/18/2012,8,0,7,11,26
6/19/2012,6,0,4,2,12
6/20/2012,5,0,6,7,18
6/21/2012,2,0,7,4,13
6/22/2012,7,0,4,10,21
6/23/2012,3,0,4,1,8
6/24/2012,5,0,6,1,12
6/25/2012,3,0,3,12,18
6/26/2012,3,0,6,8,17
6/27/2012,8,0,8,8,24
6/28/2012,6,0,6,6,18
6/29/2012,7,0,7,6,20
6/30/2012,6,0,7,9,22
7/1/2012,4,0,4,4,12
7/2/2012,4,0,3,9,16
7/3/2012,5,0,8,13,26
7/4/2012,5,0,2,6,13
7/5/2012,8,0,7,1,16
7/6/2012,7,0,2,7,16
7/7/2012,6,0,8,1,15
7/8/2012,7,0,5,0,12
7/9/2012,2,0,2,5,9
7/10/2012,5,0,4,4,13
7/11/2012,6,0,5,1,12
7/12/2012,5,0,8,1,14
7/13/2012,3,0,8,9,20
7/14/2012,5,0,8,4,17
7/15/2012,3,0,7,0,10
7/16/2012,4,0,5,3,12
7/17/2012,2,0,3,10,15
7/18/2012,6,0,4,3,13
7/19/2012,5,0,8,6,19
7/20/2012,7,0,5,13,25
7/21/2012,7,0,7,2,16
7/22/2012,7,0,2,11,20
7/23/2012,2,0,6,13,21
7/24/2012,2,0,5,13,20
7/25/2012,4,0,4,7,15
7/26/2012,5,0,4,9,18
7/27/2012,3,0,3,9,15
7/28/2012,8,0,5,2,15
7/29/2012,7,0,6,10,23
7/30/2012,8,0,4,12,24
7/31/2012,6,0,5,6,17
8/1/2012,8,0,5,2,15
8/2/2012,2,0,4,10,16
8/3/2012,6,0,2,5,13
8/4/2012,6,0,5,6,17
8/5/2012,6,0,2,1,9
8/6/2012,7,0,2,9,18
8/7/2012,3,0,3,13,19
8/8/2012,7,0,4,10,21
8/9/2012,6,0,7,4,17
8/10/2012,8,0,4,12,24
8/11/2012,7,0,2,5,14
8/12/2012,5,0,7,13,25
8/13/2012,3,0,7,2,12
8/14/2012,6,0,3,6,15
8/15/2012,4,0,6,12,22
8/16/2012,2,0,5,6,13
8/17/2012,7,0,7,1,15
8/18/2012,3,0,7,4,14
8/19/2012,4,0,8,11,23
8/20/2012,4,0,5,1,10
8/21/2012,3,0,5,0,8
8/22/2012,5,0,3,2,10
8/23/2012,8,0,4,2,14
8/24/2012,8,0,5,8,21
8/25/2012,5,0,6,7,18
8/26/2012,2,0,2,6,10
8/27/2012,6,0,8,8,22
8/28/2012,7,0,4,11,22
8/29/2012,8,0,7,8,23
8/30/2012,7,0,8,2,17
8/31/2012,2,0,5,0,7
9/1/2012,3,0,2,10,15
9/2/2012,3,0,5,1,9
9/3/2012,5,0,8,1,14
9/4/2012,2,0,2,8,12
9/5/2012,7,0,2,12,21
9/6/2012,7,0,3,12,22
9/7/2012,4,0,8,9,21
9/8/2012,6,0,3,1,10
9/9/2012,3,0,2,4,9
9/10/2012,4,0,5,5,14
9/11/2012,3,0,4,13,20
9/12/2012,2,0,7,4,13
9/13/2012,4,0,3,13,20
9/14/2012,3,0,7,5,15
9/15/2012,6,0,2,7,15
9/16/2012,8,0,2,6,16
9/17/2012,3,0,4,0,7
9/18/2012,5,0,3,12,20
9/19/2012,3,0,4,1,8
9/20/2012,5,0,2,11,18
9/21/2012,5,0,4,0,9
9/22/2012,4,0,8,1,13
9/23/2012,2,0,6,4,12
9/24/2012,8,0,6,13,27
9/25/2012,5,0,3,0,8
9/26/2012,3,0,3,4,10
9/27/2012,7,0,7,11,25
9/28/2012,6,0,3,3,12
9/29/2012,6,0,6,7,19
9/30/2012,4,0,8,2,14
10/1/2012,3,0,4,8,15
10/2/2012,5,0,2,9,16
10/3/2012,7,0,3,5,15
10/4/2012,5,0,8,12,25
10/5/2012,5,0,7,6,18
10/6/2012,2,0,2,6,10
10/7/2012,4,0,7,10,21
10/8/2012,3,0,5,9,17
10/9/2012,2,0,5,10,17
10/10/2012,7,0,8,2,17
10/11/2012,4,0,3,3,10
10/12/2012,3,0,6,13,22
10/13/2012,3,0,5,12,20
10/14/2012,8,0,5,5,18
10/15/2012,8,0,5,3,16
10/16/2012,8,0,3,9,20
10/17/2012,4,0,7,3,14
10/18/2012,3,0,6,10,19
10/19/2012,8,0,2,6,16
10/20/2012,6,0,5,8,19
10/21/2012,6,0,5,1,12
10/22/2012,8,0,7,9,24
10/23/2012,6,0,7,6,19
10/24/2012,7,0,7,7,21
10/25/2012,8,0,3,12,23
10/26/2012,7,0,2,1,10
10/27/2012,6,0,4,4,14
10/28/2012,6,0,6,0,12
10/29/2012,7,0,3,5,15
10/30/2012,2,0,2,0,4
10/31/2012,5,0,8,2,15
11/1/2012,7,0,5,9,21
11/2/2012,8,0,3,4,15
11/3/2012,5,0,7,7,19
11/4/2012,8,0,2,11,21
11/5/2012,4,0,3,11,18
11/6/2012,3,0,3,8,14
11/7/2012,2,0,5,4,11
11/8/2012,2,0,3,4,9
11/9/2012,2,0,4,11,17
11/10/2012,4,0,4,2,10
11/11/2012,5,0,4,2,11
11/12/2012,7,0,3,11,21
11/13/2012,2,0,3,2,7
11/14/2012,2,0,2,4,8
11/15/2012,7,0,4,12,23
11/16/2012,6,0,8,2,16
11/17/2012,3,0,6,7,16
11/18/2012,3,0,3,13,19
11/19/2012,2,0,8,6,16
11/20/2012,4,0,8,9,21
11/21/2012,3,0,4,2,9
11/22/2012,5,0,4,6,15
11/23/2012,3,0,6,13,22
11/24/2012,2,0,5,1,8
11/25/2012,7,0,8,6,21
11/26/2012,8,0,8,6,22
11/27/2012,7,0,5,10,22
11/28/2012,5,0,7,13,25
11/29/2012,3,0,4,0,7
11/30/2012,2,0,6,12,20
12/1/2012,7,0,8,2,17
12/2/2012,7,0,5,5,17
12/3/2012,2,0,3,10,15
12/4/2012,4,0,5,7,16
12/5/2012,4,0,2,11,17
12/6/2012,7,0,3,6,16
12/7/2012,4,0,2,6,12
12/8/2012,2,0,7,12,21
12/9/2012,2,0,8,8,18
12/10/2012,7,0,5,1,13
12/11/2012,4,0,7,4,15
12/12/2012,6,0,8,5,19
12/13/2012,5,0,5,6,16
12/14/2012,8,0,6,3,17
12/15/2012,6,0,7,10,23
12/16/2012,2,0,8,8,18
12/17/2012,3,0,2,7,12
12/18/2012,2,0,3,12,17
12/19/2012,7,0,2,12,21
12/20/2012,5,0,4,7,16
12/21/2012,6,0,6,10,22
12/22/2012,6,0,7,12,25
12/23/2012,7,0,3,9,19
12/24/2012,7,0,5,7,19
12/25/2012,8,0,2,7,17
12/26/2012,5,0,8,6,19
12/27/2012,3,0,7,12,22
12/28/2012,5,0,7,11,23
12/29/2012,8,0,5,9,22
12/30/2012,4,0,8,3,15
12/31/2012,2,0,7,5,14
1/1/2013,6,0,4,6,16
1/2/2013,2,0,5,8,15
1/3/2013,7,0,2,10,19
1/4/2013,5,0,7,3,15
1/5/2013,7,0,3,13,23
1/6/2013,5,0,7,9,21
1/7/2013,4,0,2,9,15
1/8/2013,7,0,3,9,19
1/9/2013,7,0,6,5,18
1/10/2013,5,0,6,0,11
1/11/2013,3,0,5,6,14
1/12/2013,4,0,3,9,16
1/13/2013,7,0,2,11,20
1/14/2013,7,0,3,6,16
1/15/2013,5,0,4,2,11
1/16/2013,5,0,4,0,9
1/17/2013,3,0,8,8,19
1/18/2013,4,0,8,5,17
1/19/2013,2,0,6,9,17
1/20/2013,3,0,2,2,7
1/21/2013,2,0,6,1,9
1/22/2013,3,0,8,10,21
1/23/2013,6,0,3,7,16
1/24/2013,8,0,6,6,20
1/25/2013,7,0,3,9,19
1/26/2013,6,0,8,7,21
1/27/2013,4,0,4,9,17
1/28/2013,6,0,6,2,14
1/29/2013,6,0,6,5,17
1/30/2013,6,0,2,0,8
1/31/2013,6,0,2,9,17
2/1/2013,2,0,8,4,14
2/2/2013,6,0,3,9,18
2/3/2013,3,0,4,9,16
2/4/2013,7,0,8,4,19
2/5/2013,2,0,3,0,5
2/6/2013,4,0,6,2,12
2/7/2013,7,0,4,7,18
2/8/2013,3,0,4,9,16
2/9/2013,4,0,8,6,18
2/10/2013,3,0,6,12,21
2/11/2013,2,0,5,6,13
2/12/2013,2,0,8,10,20
2/13/2013,5,0,6,2,13
2/14/2013,8,0,2,9,19
2/15/2013,5,0,2,7,14
2/16/2013,5,0,3,11,19
2/17/2013,5,0,3,3,11
2/18/2013,2,0,2,9,13
2/19/2013,7,0,2,5,14
2/20/2013,8,0,6,11,25
2/21/2013,3,0,8,6,17
2/22/2013,5,0,2,11,18
2/23/2013,2,0,2,12,16
2/24/2013,3,0,6,6,15
2/25/2013,2,0,8,10,20
2/26/2013,4,0,4,0,8
2/27/2013,5,0,2,5,12
2/28/2013,6,0,6,13,25
3/1/2013,5,0,7,3,15
3/2/2013,8,0,5,3,16
3/3/2013,8,0,6,13,27
3/4/2013,5,0,5,3,13
3/5/2013,2,0,2,2,6
3/6/2013,4,0,3,2,9
3/7/2013,7,0,7,11,25
3/8/2013,5,0,3,0,8
3/9/2013,7,0,7,11,25
3/10/2013,2,0,6,11,19
3/11/2013,3,0,5,2,10
3/12/2013,6,0,8,4,18
3/13/2013,8,0,8,5,21
3/14/2013,6,0,2,10,18
3/15/2013,4,0,7,0,11
3/16/2013,2,0,3,12,17
3/17/2013,7,0,4,8,19
3/18/2013,4,0,3,7,14
3/19/2013,4,0,3,2,9
3/20/2013,6,0,3,10,19
3/21/2013,5,0,4,4,13
3/22/2013,5,0,4,13,22
3/23/2013,8,0,8,7,23
3/24/2013,7,0,3,3,13
3/25/2013,4,0,8,6,18
3/26/2013,4,0,5,13,22
3/27/2013,6,0,6,11,23
3/28/2013,8,0,2,6,16
3/29/2013,3,0,3,1,7
3/30/2013,6,0,5,13,24
3/31/2013,3,0,7,3,13
4/1/2013,2,0,2,7,11
4/2/2013,6,0,3,12,21
4/3/2013,6,0,2,2,10
4/4/2013,5,0,6,12,23
4/5/2013,7,0,3,13,23
4/6/2013,2,0,5,7,14
4/7/2013,4,0,3,13,20
4/8/2013,4,0,7,12,23
4/9/2013,4,0,2,1,7
4/10/2013,8,0,2,2,12
4/11/2013,8,0,5,6,19
4/12/2013,5,0,6,5,16
4/13/2013,6,0,4,5,15
4/14/2013,2,0,5,2,9
4/15/2013,8,0,8,2,18
4/16/2013,7,0,5,2,14
4/17/2013,2,0,3,12,17
4/18/2013,8,0,3,2,13
4/19/2013,8,0,4,6,18
4/20/2013,2,0,2,13,17
4/21/2013,2,0,4,0,6
4/22/2013,7,0,7,2,16
4/23/2013,8,0,5,11,24
4/24/2013,8,0,2,4,14
4/25/2013,3,0,7,4,14
4/26/2013,3,0,3,2,8
4/27/2013,5,0,3,10,18
4/28/2013,2,0,3,7,12
4/29/2013,3,0,4,10,17
4/30/2013,5,0,3,12,20
5/1/2013,4,0,2,9,15
5/2/2013,6,0,3,8,17
5/3/2013,5,0,8,1,14
5/4/2013,3,0,2,10,15
5/5/2013,3,0,7,3,13
5/6/2013,3,0,3,0,6
5/7/2013,7,0,6,8,21
5/8/2013,6,0,4,0,10
5/9/2013,2,0,8,9,19
5/10/2013,6,0,3,5,14
5/11/2013,2,0,5,9,16
5/12/2013,4,0,5,3,12
5/13/2013,8,0,2,6,16
5/14/2013,4,0,6,0,10
5/15/2013,2,0,3,8,13
5/16/2013,8,0,3,5,16
5/17/2013,4,0,8,13,25
5/18/2013,4,0,8,6,18
5/19/2013,5,0,7,13,25
5/20/2013,7,0,4,2,13
5/21/2013,3,0,2,11,16
5/22/2013,8,0,8,12,28
5/23/2013,8,0,2,11,21
5/24/2013,2,0,3,0,5
5/25/2013,8,0,8,0,16
5/26/2013,8,0,6,8,22
5/27/2013,8,0,7,13,28
5/28/2013,7,0,3,4,14
5/29/2013,7,0,5,7,19
5/30/2013,2,0,2,13,17
5/31/2013,3,0,5,6,14
6/1/2013,4,0,4,13,21
6/2/2013,7,0,8,9,24
6/3/2013,5,0,2,0,7
6/4/2013,4,0,6,1,11
6/5/2013,6,0,3,1,10
6/6/2013,3,0,7,7,17
6/7/2013,3,0,8,5,16
6/8/2013,3,0,3,0,6
6/9/2013,6,0,3,10,19
6/10/2013,2,0,3,7,12
6/11/2013,7,0,7,7,21
6/12/2013,6,0,4,12,22
6/13/2013,7,0,2,8,17
6/14/2013,8,0,7,7,22
6/15/2013,2,0,6,11,19
6/16/2013,5,0,8,2,15
6/17/2013,6,0,4,12,22
6/18/2013,5,0,6,0,11
6/19/2013,5,0,5,13,23
6/20/2013,3,0,8,4,15
6/21/2013,4,0,4,13,21
6/22/2013,3,0,7,12,22
6/23/2013,5,0,8,3,16
6/24/2013,3,0,7,7,17
6/25/2013,7,0,6,7,20
6/26/2013,2,0,2,0,4
6/27/2013,3,0,2,8,13
6/28/2013,2,0,3,3,8
6/29/2013,4,0,4,1,9
6/30/2013,4,0,3,5,12
7/1/2013,5,0,3,1,9
7/2/2013,7,0,2,0,9
7/3/2013,4,0,2,4,10
7/4/2013,8,0,4,3,15
7/5/2013,4,0,5,7,16
7/6/2013,6,0,5,0,11
7/7/2013,4,0,5,3,12
7/8/2013,3,0,3,0,6
7/9/2013,3,0,2,2,7
7/10/2013,2,0,7,1,10
7/11/2013,7,0,3,12,22
7/12/2013,4,0,6,6,16
7/13/2013,5,0,2,6,13
7/14/2013,6,0,4,6,16
7/15/2013,7,0,8,12,27
7/16/2013,6,0,6,12,24
7/17/2013,5,0,4,2,11
7/18/2013,8,0,2,7,17
7/19/2013,7,0,3,12,22
7/20/2013,4,0,6,8,18
7/21/2013,4,0,3,10,17
7/22/2013,7,0,4,8,19
7/23/2013,2,0,8,8,18
7/24/2013,5,0,6,13,24
7/25/2013,2,0,3,9,14
7/26/2013,7,0,2,9,18
7/27/2013,2,0,2,7,11
7/28/2013,3,0,7,8,18
7/29/2013,2,0,7,0,9
7/30/2013,4,0,6,6,16
7/31/2013,6,0,2,4,12
8/1/2013,6,0,8,10,24
8/2/2013,3,0,7,4,14
8/3/2013,3,0,7,4,14
8/4/2013,8,0,6,0,14
8/5/2013,8,0,2,6,16
8/6/2013,4,0,7,3,14
8/7/2013,3,0,3,9,15
8/8/2013,5,0,3,0,8
8/9/2013,4,0,7,12,23
8/10/2013,3,0,6,0,9
8/11/2013,2,0,7,1,10
8/12/2013,6,0,6,12,24
8/13/2013,3,0,2,12,17
8/14/2013,6,0,5,9,20
8/15/2013,7,0,8,1,16
8/16/2013,2,0,8,3,13
8/17/2013,6,0,4,6,16
8/18/2013,7,0,4,12,23
8/19/2013,2,0,4,1,7
8/20/2013,3,0,2,13,18
8/21/2013,6,0,4,12,22
8/22/2013,2,0,5,1,8
8/23/2013,2,0,8,13,23
8/24/2013,2,0,6,4,12
8/25/2013,5,0,2,9,16
8/26/2013,6,0,2,10,18
8/27/2013,5,0,2,9,16
8/28/2013,8,0,5,5,18
8/29/2013,4,0,4,4,12
8/30/2013,8,0,6,0,14
8/31/2013,2,0,3,13,18
9/1/2013,3,0,7,1,11
9/2/2013,3,0,4,6,13
9/3/2013,5,0,2,7,14
9/4/2013,8,0,8,8,24
9/5/2013,2,0,2,7,11
9/6/2013,6,0,4,12,22
9/7/2013,6,0,5,0,11
9/8/2013,2,0,4,13,19
9/9/2013,6,0,6,10,22
9/10/2013,8,0,7,10,25
9/11/2013,3,0,8,0,11
9/12/2013,8,0,8,12,28
9/13/2013,3,0,7,6,16
9/14/2013,4,0,4,10,18
9/15/2013,2,0,4,3,9
9/16/2013,5,0,8,3,16
9/17/2013,6,0,6,10,22
9/18/2013,6,0,6,1,13
9/19/2013,4,0,3,12,19
9/20/2013,6,0,7,13,26
9/21/2013,4,0,8,3,15
9/22/2013,5,0,4,13,22
9/23/2013,7,0,8,7,22
9/24/2013,7,0,2,3,12
9/25/2013,6,0,2,0,8
9/26/2013,4,0,6,7,17
9/27/2013,6,0,4,0,10
9/28/2013,3,0,4,12,19
9/29/2013,6,0,8,0,14
9/30/2013,7,0,4,5,16
10/1/2013,5,0,7,9,21
10/2/2013,2,0,3,0,5
10/3/2013,3,0,7,2,12
10/4/2013,7,0,2,9,18
10/5/2013,4,0,4,12,20
10/6/2013,7,0,2,8,17
10/7/2013,8,0,6,3,17
10/8/2013,8,0,7,9,24
10/9/2013,2,0,5,9,16
10/10/2013,5,0,6,4,15
10/11/2013,3,0,8,0,11
10/12/2013,2,0,5,0,7
10/13/2013,5,0,4,8,17
10/14/2013,6,0,6,3,15
10/15/2013,4,0,3,11,18
10/16/2013,2,0,2,1,5
10/17/2013,5,0,3,7,15
10/18/2013,2,0,8,6,16
10/19/2013,8,0,4,3,15
10/20/2013,3,0,2,7,12
10/21/2013,2,0,2,9,13
10/22/2013,6,0,3,11,20
10/23/2013,8,0,6,11,25
10/24/2013,8,0,8,1,17
10/25/2013,7,0,2,0,9
10/26/2013,3,0,5,5,13
10/27/2013,7,0,7,1,15
10/28/2013,7,0,3,9,19
10/29/2013,3,0,6,5,14
10/30/2013,5,0,7,13,25
10/31/2013,7,0,3,6,16
11/1/2013,4,0,2,5,11
11/2/2013,2,0,5,2,9
11/3/2013,7,0,6,9,22
11/4/2013,7,0,7,2,16
11/5/2013,5,0,2,7,14
11/6/2013,8,0,3,5,16
11/7/2013,7,0,8,3,18
11/8/2013,5,0,2,0,7
11/9/2013,2,0,6,11,19
11/10/2013,2,0,3,10,15
11/11/2013,7,0,3,2,12
11/12/2013,3,0,8,11,22
11/13/2013,8,0,4,7,19
11/14/2013,2,0,2,0,4
11/15/2013,8,0,4,10,22
11/16/2013,8,0,5,10,23
11/17/2013,8,0,8,2,18
11/18/2013,5,0,6,11,22
11/19/2013,3,0,3,1,7
11/20/2013,5,0,7,12,24
11/21/2013,7,0,2,11,20
11/22/2013,4,0,3,10,17
11/23/2013,4,0,6,6,16
11/24/2013,5,0,3,7,15
11/25/2013,5,0,7,10,22
11/26/2013,6,0,3,1,10
11/27/2013,8,0,8,12,28
11/28/2013,2,0,2,0,4
11/29/2013,7,0,2,11,20
11/30/2013,7,0,8,9,24
12/1/2013,5,0,6,3,14
12/2/2013,5,0,2,13,20
12/3/2013,2,0,8,0,10
12/4/2013,6,0,5,0,11
12/5/2013,4,0,2,6,12
12/6/2013,4,0,7,8,19
12/7/2013,6,0,8,2,16
12/8/2013,3,0,2,5,10
12/9/2013,6,0,4,2,12
12/10/2013,4,0,2,1,7
12/11/2013,2,0,8,13,23
12/12/2013,7,0,8,4,19
12/13/2013,7,0,4,2,13
12/14/2013,7,0,6,5,18
12/15/2013,7,0,7,7,21
12/16/2013,2,0,3,5,10
12/17/2013,3,0,5,5,13
12/18/2013,6,0,6,2,14
12/19/2013,2,0,6,6,14
12/20/2013,4,0,3,6,13
12/21/2013,7,0,6,4,17
12/22/2013,8,0,3,12,23
12/23/2013,2,0,4,13,19
12/24/2013,6,0,2,6,14
12/25/2013,4,0,2,6,12
12/26/2013,6,0,8,2,16
12/27/2013,4,0,3,12,19
12/28/2013,3,0,8,4,15
12/29/2013,5,0,3,3,11
12/30/2013,2,0,3,4,9
12/31/2013,5,0,8,1,14
1/1/2014,5,0,6,7,18
1/2/2014,3,0,4,9,16
1/3/2014,8,0,8,12,28
1/4/2014,4,0,2,2,8
1/5/2014,5,0,8,4,17
1/6/2014,8,0,6,8,22
1/7/2014,4,0,4,3,11
1/8/2014,2,0,2,2,6
1/9/2014,7,0,4,0,11
1/10/2014,8,0,3,9,20
1/11/2014,4,0,4,3,11
1/12/2014,6,0,2,0,8
1/13/2014,8,0,5,4,17
1/14/2014,5,0,7,11,23
1/15/2014,4,0,3,5,12
1/16/2014,7,0,5,7,19
1/17/2014,6,0,8,6,20
1/18/2014,2,0,5,3,10
1/19/2014,6,0,3,8,17
1/20/2014,6,0,2,5,13
1/21/2014,7,0,8,8,23
1/22/2014,8,0,2,5,15
1/23/2014,2,0,6,1,9
1/24/2014,2,0,2,12,16
1/25/2014,4,0,4,3,11
1/26/2014,2,0,2,6,10
1/27/2014,2,0,2,0,4
1/28/2014,8,0,8,3,19
1/29/2014,2,0,6,0,8
1/30/2014,6,0,8,8,22
1/31/2014,7,0,4,9,20
2/1/2014,3,0,4,2,9
2/2/2014,3,0,4,8,15
2/3/2014,5,0,6,0,11
2/4/2014,7,0,6,13,26
2/5/2014,5,0,6,1,12
2/6/2014,5,0,4,11,20
2/7/2014,6,0,2,1,9
2/8/2014,3,0,7,11,21
2/9/2014,6,0,5,7,18
2/10/2014,6,0,2,0,8
2/11/2014,6,0,4,1,11
2/12/2014,5,0,2,10,17
2/13/2014,8,0,8,3,19
2/14/2014,4,0,6,2,12
2/15/2014,2,0,8,9,19
2/16/2014,4,0,2,7,13
2/17/2014,4,0,2,0,6
2/18/2014,8,0,8,3,19
2/19/2014,6,0,2,0,8
2/20/2014,5,0,2,13,20
2/21/2014,3,0,7,10,20
2/22/2014,5,0,4,10,19
2/23/2014,2,0,6,4,12
2/24/2014,2,0,6,13,21
2/25/2014,7,0,8,0,15
2/26/2014,5,0,2,5,12
2/27/2014,3,0,8,12,23
2/28/2014,5,0,8,6,19
3/1/2014,4,0,6,1,11
3/2/2014,5,0,7,4,16
3/3/2014,6,0,5,7,18
3/4/2014,8,0,2,1,11
3/5/2014,3,0,2,4,9
3/6/2014,2,0,6,12,20
3/7/2014,3,0,6,7,16
3/8/2014,7,0,5,6,18
3/9/2014,5,0,8,2,15
3/10/2014,5,0,4,1,10
3/11/2014,8,0,5,8,21
3/12/2014,2,0,7,5,14
3/13/2014,7,0,7,9,23
3/14/2014,6,0,3,10,19
3/15/2014,7,0,5,13,25
3/16/2014,6,0,5,1,12
3/17/2014,6,0,8,12,26
3/18/2014,3,0,4,6,13
3/19/2014,7,0,8,5,20
3/20/2014,2,0,4,12,18
3/21/2014,4,0,7,12,23
3/22/2014,2,0,4,9,15
3/23/2014,5,0,2,9,16
3/24/2014,6,0,7,12,25
3/25/2014,4,0,8,7,19
3/26/2014,5,0,4,8,17
3/27/2014,4,0,6,10,20
3/28/2014,7,0,3,12,22
3/29/2014,8,0,4,6,18
3/30/2014,2,0,6,2,10
3/31/2014,6,0,7,4,17
4/1/2014,2,0,2,1,5
4/2/2014,4,0,4,1,9
4/3/2014,6,0,6,9,21
4/4/2014,5,0,2,5,12
4/5/2014,4,0,5,4,13
4/6/2014,8,0,2,5,15
4/7/2014,2,0,7,2,11
4/8/2014,2,0,6,8,16
4/9/2014,2,0,2,4,8
4/10/2014,6,0,3,11,20
4/11/2014,5,0,7,1,13
4/12/2014,4,0,6,3,13
4/13/2014,3,0,6,9,18
4/14/2014,4,0,3,0,7
4/15/2014,3,0,7,2,12
4/16/2014,3,0,5,12,20
4/17/2014,2,0,5,1,8
4/18/2014,7,0,2,5,14
4/19/2014,5,0,6,10,21
4/20/2014,7,0,6,5,18
4/21/2014,2,0,4,1,7
4/22/2014,3,0,5,7,15
4/23/2014,2,0,3,0,5
4/24/2014,3,0,6,8,17
4/25/2014,5,0,7,5,17
4/26/2014,2,0,7,2,11
4/27/2014,3,0,7,6,16
4/28/2014,4,0,7,5,16
4/29/2014,8,0,7,4,19
4/30/2014,3,0,4,5,12
5/1/2014,2,0,6,12,20
5/2/2014,4,0,5,11,20
5/3/2014,5,0,7,6,18
5/4/2014,6,0,3,4,13
5/5/2014,4,0,7,0,11
5/6/2014,5,0,8,10,23
5/7/2014,7,0,2,6,15
5/8/2014,6,0,4,1,11
5/9/2014,7,0,2,2,11
5/10/2014,7,0,7,7,21
5/11/2014,5,0,3,1,9
5/12/2014,6,0,5,3,14
5/13/2014,2,0,8,9,19
5/14/2014,5,0,7,8,20
5/15/2014,8,0,8,1,17
5/16/2014,2,0,3,0,5
5/17/2014,3,0,4,0,7
5/18/2014,8,0,8,11,27
5/19/2014,7,0,3,7,17
5/20/2014,3,0,4,8,15
5/21/2014,3,0,4,5,12
5/22/2014,8,0,3,6,17
5/23/2014,5,0,2,10,17
5/24/2014,7,0,3,10,20
5/25/2014,7,0,4,0,11
5/26/2014,3,0,2,0,5
5/27/2014,8,0,5,0,13
5/28/2014,8,0,2,6,16
5/29/2014,8,0,5,9,22
5/30/2014,2,0,5,6,13
5/31/2014,8,0,8,8,24
6/1/2014,8,0,2,5,15
6/2/2014,5,0,8,11,24
6/3/2014,2,0,7,1,10
6/4/2014,2,0,3,3,8
6/5/2014,6,0,8,4,18
6/6/2014,6,0,2,5,13
6/7/2014,3,0,5,11,19
6/8/2014,8,0,8,5,21
6/9/2014,3,0,7,4,14
6/10/2014,3,0,8,9,20
6/11/2014,2,0,6,5,13
6/12/2014,4,0,3,6,13
6/13/2014,4,0,4,1,9
6/14/2014,6,0,8,6,20
6/15/2014,8,0,5,0,13
6/16/2014,5,0,6,4,15
6/17/2014,7,0,7,1,15
6/18/2014,6,0,3,3,12
6/19/2014,3,0,2,2,7
6/20/2014,6,0,5,12,23
6/21/2014,5,0,6,6,17
6/22/2014,2,0,8,12,22
6/23/2014,6,0,8,0,14
6/24/2014,4,0,2,4,10
6/25/2014,4,0,7,13,24
6/26/2014,6,0,2,1,9
6/27/2014,8,0,7,10,25
6/28/2014,6,0,3,7,16
6/29/2014,5,0,7,5,17
6/30/2014,7,0,3,12,22
7/1/2014,6,0,4,10,20
7/2/2014,3,0,3,2,8
7/3/2014,5,0,3,2,10
7/4/2014,2,0,3,9,14
7/5/2014,6,0,2,1,9
7/6/2014,6,0,6,11,23
7/7/2014,3,0,6,10,19
7/8/2014,3,0,6,4,13
7/9/2014,6,0,4,11,21
7/10/2014,6,0,4,10,20
7/11/2014,4,0,5,3,12
7/12/2014,5,0,7,5,17
7/13/2014,3,0,2,13,18
7/14/2014,3,0,8,11,22
7/15/2014,8,0,4,2,14
7/16/2014,6,0,6,5,17
7/17/2014,8,0,7,7,22
7/18/2014,7,0,4,4,15
7/19/2014,4,0,5,13,22
7/20/2014,7,0,6,12,25
7/21/2014,6,0,4,6,16
7/22/2014,4,0,2,13,19
7/23/2014,8,0,3,11,22
7/24/2014,4,0,3,2,9
7/25/2014,2,0,8,0,10
7/26/2014,6,0,2,13,21
7/27/2014,4,0,7,10,21
7/28/2014,4,0,4,10,18
7/29/2014,7,0,5,1,13
7/30/2014,5,0,2,8,15
7/31/2014,3,0,6,0,9
8/1/2014,2,0,7,3,12
8/2/2014,2,0,7,9,18
8/3/2014,7,0,2,5,14
8/4/2014,4,0,3,8,15
8/5/2014,8,0,8,0,16
8/6/2014,2,0,2,13,17
8/7/2014,8,0,3,9,20
8/8/2014,7,0,2,0,9
8/9/2014,3,0,2,6,11
8/10/2014,3,0,3,2,8
8/11/2014,5,0,4,2,11
8/12/2014,2,0,5,2,9
8/13/2014,6,0,8,1,15
8/14/2014,2,0,4,11,17
8/15/2014,3,0,5,5,13
8/16/2014,6,0,3,3,12
8/17/2014,7,0,4,11,22
8/18/2014,8,0,2,5,15
8/19/2014,6,0,4,12,22
8/20/2014,4,0,8,10,22
8/21/2014,3,0,7,0,10
8/22/2014,4,0,7,3,14
8/23/2014,2,0,3,2,7
8/24/2014,6,0,8,6,20
8/25/2014,3,0,8,6,17
8/26/2014,4,0,8,3,15
8/27/2014,8,0,8,13,29
8/28/2014,8,0,8,7,23
8/29/2014,3,0,3,12,18
8/30/2014,8,0,8,11,27
8/31/2014,8,0,6,3,17
9/1/2014,2,0,6,12,20
9/2/2014,7,0,4,5,16
9/3/2014,3,0,6,1,10
9/4/2014,2,0,6,9,17
9/5/2014,4,0,3,11,18
9/6/2014,2,0,6,7,15
9/7/2014,8,0,8,13,29
9/8/2014,3,0,2,5,10
9/9/2014,3,0,5,6,14
9/10/2014,5,0,6,8,19
9/11/2014,4,0,3,11,18
9/12/2014,3,0,3,6,12
9/13/2014,8,0,2,12,22
9/14/2014,2,0,4,9,15
9/15/2014,7,0,5,3,15
9/16/2014,8,0,3,10,21
9/17/2014,5,0,8,4,17
9/18/2014,3,0,8,13,24
9/19/2014,3,0,7,6,16
9/20/2014,3,0,8,10,21
9/21/2014,4,0,3,12,19
9/22/2014,3,0,8,0,11
9/23/2014,8,0,2,0,10
9/24/2014,2,0,7,2,11
9/25/2014,3,0,5,1,9
9/26/2014,7,0,4,10,21
9/27/2014,2,0,7,13,22
9/28/2014,4,0,4,6,14
9/29/2014,2,0,6,5,13
9/30/2014,6,0,2,7,15
10/1/2014,3,0,3,10,16
10/2/2014,3,0,5,2,10
10/3/2014,7,0,2,6,15
10/4/2014,5,0,8,13,26
10/5/2014,4,0,6,2,12
10/6/2014,2,0,6,13,21
10/7/2014,2,0,4,4,10
10/8/2014,7,0,6,6,19
10/9/2014,4,0,7,0,11
10/10/2014,5,0,8,10,23
10/11/2014,3,0,2,9,14
10/12/2014,3,0,8,8,19
10/13/2014,6,0,8,1,15
10/14/2014,4,0,8,10,22
10/15/2014,2,0,3,0,5
10/16/2014,6,0,2,9,17
10/17/2014,6,0,5,1,12
10/18/2014,8,0,5,6,19
10/19/2014,6,0,7,13,26
10/20/2014,2,0,2,11,15
10/21/2014,4,0,7,7,18
10/22/2014,6,0,3,7,16
10/23/2014,2,0,5,12,19
10/24/2014,6,0,4,2,12
10/25/2014,5,0,5,11,21
10/26/2014,8,0,7,1,16
10/27/2014,7,0,4,1,12
10/28/2014,6,0,3,8,17
10/29/2014,6,0,6,7,19
10/30/2014,3,0,7,0,10
10/31/2014,7,0,6,1,14
11/1/2014,4,0,4,8,16
11/2/2014,7,0,2,2,11
11/3/2014,3,0,7,11,21
11/4/2014,2,0,7,0,9
11/5/2014,8,0,5,8,21
11/6/2014,5,0,7,6,18
11/7/2014,4,0,5,9,18
11/8/2014,5,0,5,10,20
11/9/2014,8,0,4,13,25
11/10/2014,3,0,7,3,13
11/11/2014,4,0,5,3,12
11/12/2014,7,0,5,7,19
11/13/2014,7,0,5,10,22
11/14/2014,8,0,3,12,23
11/15/2014,8,0,5,8,21
11/16/2014,2,0,6,5,13
11/17/2014,4,0,8,12,24
11/18/2014,7,0,4,11,22
11/19/2014,8,0,3,11,22
11/20/2014,4,0,8,4,16
11/21/2014,2,0,3,2,7
11/22/2014,3,0,2,10,15
11/23/2014,6,0,7,0,13
11/24/2014,7,0,6,0,13
11/25/2014,6,0,4,12,22
11/26/2014,4,0,8,3,15
11/27/2014,2,0,8,5,15
11/28/2014,2,0,2,4,8
11/29/2014,4,0,4,11,19
11/30/2014,4,0,3,4,11
12/1/2014,3,0,3,8,14
12/2/2014,4,0,2,4,10
12/3/2014,4,0,6,2,12
12/4/2014,7,0,4,3,14
12/5/2014,4,0,2,10,16
12/6/2014,3,0,6,12,21
12/7/2014,3,0,2,8,13
12/8/2014,4,0,4,10,18
12/9/2014,6,0,5,9,20
12/10/2014,6,0,8,13,27
12/11/2014,2,0,6,12,20
12/12/2014,3,0,5,5,13
12/13/2014,4,0,3,0,7
12/14/2014,2,0,6,3,11
12/15/2014,6,0,4,7,17
12/16/2014,4,0,7,4,15
12/17/2014,3,0,4,3,10
12/18/2014,4,0,6,11,21
12/19/2014,2,0,7,5,14
12/20/2014,8,0,7,8,23
12/21/2014,6,0,4,11,21
12/22/2014,6,0,4,2,12
12/23/2014,4,0,4,12,20
12/24/2014,4,0,3,9,16
12/25/2014,4,0,4,3,11
12/26/2014,6,0,6,3,15
12/27/2014,7,0,8,9,24
12/28/2014,2,0,3,9,14
12/29/2014,6,0,6,7,19
12/30/2014,5,0,6,8,19
12/31/2014,6,0,5,4,15
1/1/2015,2,0,6,3,11
1/2/2015,5,0,7,4,16
1/3/2015,7,0,6,9,22
1/4/2015,2,0,7,7,16
1/5/2015,3,0,3,8,14
1/6/2015,8,0,5,12,25
1/7/2015,6,0,4,7,17
1/8/2015,5,0,3,10,18
1/9/2015,6,0,4,3,13
1/10/2015,2,0,2,7,11
1/11/2015,8,0,6,6,20
1/12/2015,8,0,7,8,23
1/13/2015,5,0,3,2,10
1/14/2015,4,0,5,1,10
1/15/2015,8,0,8,1,17
1/16/2015,3,0,5,4,12
1/17/2015,5,0,4,8,17
1/18/2015,6,0,7,3,16
1/19/2015,2,0,4,0,6
1/20/2015,5,0,4,10,19
1/21/2015,4,0,4,8,16
1/22/2015,2,0,5,2,9
1/23/2015,3,0,5,11,19
1/24/2015,5,0,4,12,21
1/25/2015,3,0,6,5,14
1/26/2015,8,0,2,9,19
1/27/2015,2,0,8,11,21
1/28/2015,5,0,7,10,22
1/29/2015,4,0,3,1,8
1/30/2015,5,0,2,1,8
1/31/2015,7,0,3,12,22
2/1/2015,8,0,4,3,15
2/2/2015,8,0,4,5,17
2/3/2015,5,0,8,1,14
2/4/2015,5,0,2,7,14
2/5/2015,2,0,2,11,15
2/6/2015,7,0,4,13,24
2/7/2015,6,0,3,0,9
2/8/2015,7,0,4,6,17
2/9/2015,4,0,7,12,23
2/10/2015,2,0,7,8,17
2/11/2015,4,0,4,9,17
2/12/2015,7,0,2,7,16
2/13/2015,5,0,4,0,9
2/14/2015,6,0,4,8,18
2/15/2015,6,0,3,2,11
2/16/2015,4,0,6,10,20
2/17/2015,3,0,4,4,11
2/18/2015,5,0,3,2,10
2/19/2015,7,0,8,4,19
2/20/2015,5,0,3,13,21
2/21/2015,3,0,5,1,9
2/22/2015,7,0,8,13,28
2/23/2015,2,0,8,8,18
2/24/2015,6,0,5,8,19
2/25/2015,4,0,6,7,17
2/26/2015,8,0,3,3,14
2/27/2015,2,0,8,0,10
2/28/2015,2,0,2,11,15
3/1/2015,2,0,5,4,11
3/2/2015,4,0,4,10,18
3/3/2015,3,0,6,8,17
3/4/2015,8,0,3,13,24
3/5/2015,8,0,4,2,14
3/6/2015,7,0,2,6,15
3/7/2015,4,0,8,13,25
3/8/2015,6,0,3,11,20
3/9/2015,7,0,2,5,14
3/10/2015,8,0,4,8,20
3/11/2015,4,0,7,0,11
3/12/2015,5,0,2,8,15
3/13/2015,6,0,4,5,15
3/14/2015,6,0,5,9,20
3/15/2015,8,0,3,3,14
3/16/2015,7,0,6,12,25
3/17/2015,5,0,2,4,11
3/18/2015,3,0,3,9,15
3/19/2015,6,0,6,5,17
3/20/2015,4,0,7,0,11
3/21/2015,2,0,4,4,10
3/22/2015,8,0,2,2,12
3/23/2015,4,0,5,1,10
3/24/2015,6,0,5,13,24
3/25/2015,8,0,3,7,18
3/26/2015,4,0,8,11,23
3/27/2015,6,0,6,10,22
3/28/2015,6,0,6,2,14
3/29/2015,6,0,4,2,12
3/30/2015,2,0,7,9,18
3/31/2015,5,0,3,4,12
4/1/2015,2,0,7,13,22
4/2/2015,8,0,2,10,20
4/3/2015,6,0,8,13,27
4/4/2015,8,0,2,7,17
4/5/2015,3,0,8,2,13
4/6/2015,3,0,8,11,22
4/7/2015,7,0,7,0,14
4/8/2015,5,0,7,6,18
4/9/2015,6,0,5,3,14
4/10/2015,8,0,7,2,17
4/11/2015,6,0,2,3,11
4/12/2015,4,0,8,6,18
4/13/2015,2,0,8,9,19
4/14/2015,8,0,4,3,15
4/15/2015,5,0,2,13,20
4/16/2015,3,0,3,9,15
4/17/2015,6,0,2,6,14
4/18/2015,2,0,5,3,10
4/19/2015,8,0,7,9,24
4/20/2015,2,0,3,11,16
4/21/2015,7,0,3,8,18
4/22/2015,2,0,8,2,12
4/23/2015,8,0,4,2,14
4/24/2015,7,0,6,13,26
4/25/2015,8,0,3,11,22
4/26/2015,7,0,2,0,9
4/27/2015,3,0,2,4,9
4/28/2015,6,0,5,3,14
4/29/2015,3,0,8,1,12
4/30/2015,6,0,6,5,17
5/1/2015,8,0,4,10,22
5/2/2015,3,0,7,5,15
5/3/2015,6,0,3,13,22
5/4/2015,5,0,5,11,21
5/5/2015,4,0,2,2,8
5/6/2015,4,0,2,11,17
5/7/2015,3,0,3,1,7
5/8/2015,6,0,5,13,24
5/9/2015,7,0,3,11,21
5/10/2015,3,0,2,13,18
5/11/2015,7,0,3,11,21
5/12/2015,3,0,8,1,12
5/13/2015,8,0,6,9,23
5/14/2015,7,0,2,5,14
5/15/2015,8,0,4,11,23
5/16/2015,4,0,4,3,11
5/17/2015,5,0,5,2,12
5/18/2015,8,0,2,3,13
5/19/2015,4,0,2,13,19
5/20/2015,7,0,2,7,16
5/21/2015,8,0,3,3,14
5/22/2015,6,0,3,0,9
5/23/2015,4,0,3,5,12
5/24/2015,2,0,7,9,18
5/25/2015,2,0,4,0,6
5/26/2015,2,0,3,1,6
5/27/2015,5,0,4,11,20
5/28/2015,7,0,8,12,27
5/29/2015,7,0,8,3,18
5/30/2015,5,0,5,10,20
5/31/2015,2,0,8,8,18
6/1/2015,4,0,6,10,20
6/2/2015,7,0,4,12,23
6/3/2015,6,0,7,13,26
6/4/2015,7,0,7,12,26
6/5/2015,3,0,4,13,20
6/6/2015,3,0,7,0,10
6/7/2015,4,0,7,4,15
6/8/2015,7,0,3,12,22
6/9/2015,3,0,6,4,13
6/10/2015,7,0,5,8,20
6/11/2015,6,0,3,5,14
6/12/2015,2,0,7,13,22
6/13/2015,4,0,5,10,19
6/14/2015,8,0,2,0,10
6/15/2015,8,0,2,13,23
6/16/2015,2,0,4,4,10
6/17/2015,2,0,3,10,15
6/18/2015,5,0,2,2,9
6/19/2015,6,0,7,1,14
6/20/2015,2,0,4,1,7
6/21/2015,6,0,6,2,14
6/22/2015,3,0,5,10,18
6/23/2015,6,0,3,8,17
6/24/2015,6,0,7,10,23
6/25/2015,6,0,3,8,17
6/26/2015,6,0,8,6,20
6/27/2015,2,0,4,5,11
6/28/2015,7,0,5,12,24
6/29/2015,7,0,4,12,23
6/30/2015,7,0,7,7,21
7/1/2015,6,0,2,5,13
7/2/2015,5,0,5,7,17
7/3/2015,4,0,6,3,13
7/4/2015,4,0,2,10,16
7/5/2015,8,0,3,6,17
7/6/2015,8,0,6,11,25
7/7/2015,2,0,6,3,11
7/8/2015,8,0,8,10,26
7/9/2015,4,0,4,9,17
7/10/2015,4,0,4,11,19
7/11/2015,4,0,7,6,17
7/12/2015,5,0,6,2,13
7/13/2015,7,0,5,11,23
7/14/2015,5,0,3,8,16
7/15/2015,3,0,5,1,9
7/16/2015,7,0,4,5,16
7/17/2015,8,0,4,12,24
7/18/2015,8,0,7,11,26
7/19/2015,6,0,6,5,17
7/20/2015,2,0,7,4,13
7/21/2015,6,0,2,6,14
7/22/2015,5,0,6,2,13
7/23/2015,3,0,8,3,14
7/24/2015,7,0,5,6,18
7/25/2015,2,0,4,9,15
7/26/2015,2,0,2,3,7
7/27/2015,5,0,4,5,14
7/28/2015,7,0,3,12,22
7/29/2015,8,0,6,4,18
7/30/2015,4,0,4,1,9
7/31/2015,4,0,5,8,17
8/1/2015,3,0,6,2,11
8/2/2015,4,0,2,3,9
8/3/2015,6,0,3,12,21
8/4/2015,7,0,6,12,25
8/5/2015,8,0,4,9,21
8/6/2015,4,0,6,8,18
8/7/2015,4,0,4,7,15
8/8/2015,6,0,2,4,12
8/9/2015,7,0,3,4,14
8/10/2015,6,0,8,7,21
8/11/2015,3,0,5,6,14
8/12/2015,2,0,7,11,20
8/13/2015,4,0,6,0,10
8/14/2015,5,0,5,1,11
8/15/2015,5,0,7,7,19
8/16/2015,6,0,8,11,25
8/17/2015,2,0,3,13,18
8/18/2015,4,0,7,2,13
8/19/2015,8,0,4,7,19
8/20/2015,5,0,5,6,16
8/21/2015,5,0,3,6,14
8/22/2015,6,0,8,1,15
8/23/2015,7,0,6,6,19
8/24/2015,5,0,2,3,10
8/25/2015,7,0,6,12,25
8/26/2015,2,0,6,10,18
8/27/2015,3,0,6,9,18
8/28/2015,3,0,5,2,10
8/29/2015,7,0,7,1,15
8/30/2015,7,0,2,9,18
8/31/2015,7,0,3,12,22
9/1/2015,5,0,5,7,17
9/2/2015,5,0,6,13,24
9/3/2015,2,0,8,7,17
9/4/2015,3,0,7,10,20
9/5/2015,5,0,2,9,16
9/6/2015,3,0,3,7,13
9/7/2015,6,0,4,0,10
9/8/2015,2,0,3,11,16
9/9/2015,7,0,7,9,23
9/10/2015,8,0,8,7,23
9/11/2015,6,0,4,1,11
9/12/2015,4,0,6,9,19
9/13/2015,4,0,4,0,8
9/14/2015,5,0,2,6,13
9/15/2015,3,0,3,12,18
9/16/2015,8,0,7,13,28
9/17/2015,7,0,5,2,14
9/18/2015,7,0,3,12,22
9/19/2015,8,0,4,0,12
9/20/2015,2,0,3,1,6
9/21/2015,8,0,5,7,20
9/22/2015,2,0,8,0,10
9/23/2015,2,0,8,5,15
9/24/2015,2,0,6,4,12
9/25/2015,5,0,8,7,20
9/26/2015,6,0,8,2,16
9/27/2015,8,0,6,12,26
9/28/2015,4,0,3,1,8
9/29/2015,3,0,5,6,14
9/30/2015,4,0,6,13,23
10/1/2015,3,0,7,12,22
10/2/2015,7,0,2,4,13
10/3/2015,5,0,7,12,24
10/4/2015,4,0,4,13,21
10/5/2015,2,0,3,2,7
10/6/2015,7,0,4,10,21
10/7/2015,8,0,6,7,21
10/8/2015,7,0,3,5,15
10/9/2015,5,0,7,8,20
10/10/2015,6,0,7,13,26
10/11/2015,3,0,6,13,22
10/12/2015,3,0,3,6,12
10/13/2015,2,0,6,13,21
10/14/2015,4,0,3,4,11
10/15/2015,2,0,6,1,9
10/16/2015,3,0,2,9,14
10/17/2015,6,0,7,6,19
10/18/2015,6,0,5,1,12
10/19/2015,8,0,8,2,18
10/20/2015,5,0,8,5,18
10/21/2015,8,0,4,9,21
10/22/2015,7,0,2,0,9
10/23/2015,6,0,3,10,19
10/24/2015,6,0,6,4,16
10/25/2015,6,0,3,6,15
10/26/2015,2,0,8,6,16
10/27/2015,5,0,2,9,16
10/28/2015,3,0,7,2,12
10/29/2015,5,0,3,0,8
10/30/2015,7,0,5,7,19
10/31/2015,3,0,3,6,12
11/1/2015,3,0,7,13,23
11/2/2015,8,0,3,1,12
11/3/2015,7,0,7,1,15
11/4/2015,7,0,2,7,16
11/5/2015,7,0,3,8,18
11/6/2015,8,0,8,4,20
11/7/2015,3,0,7,10,20
11/8/2015,5,0,5,12,22
11/9/2015,3,0,3,4,10
11/10/2015,8,0,8,11,27
11/11/2015,8,0,6,4,18
11/12/2015,7,0,5,4,16
11/13/2015,4,0,7,1,12
11/14/2015,6,0,2,6,14
11/15/2015,3,0,5,9,17
11/16/2015,3,0,2,3,8
11/17/2015,4,0,3,12,19
11/18/2015,6,0,4,8,18
11/19/2015,3,0,6,2,11
11/20/2015,6,0,5,10,21
11/21/2015,3,0,5,11,19
11/22/2015,3,0,2,4,9
11/23/2015,7,0,3,6,16
11/24/2015,6,0,3,7,16
11/25/2015,5,0,7,10,22
11/26/2015,3,0,8,10,21
11/27/2015,8,0,4,4,16
11/28/2015,4,0,8,3,15
11/29/2015,8,0,8,4,20
11/30/2015,3,0,4,8,15
12/1/2015,2,0,5,6,13
12/2/2015,7,0,7,3,17
12/3/2015,8,0,2,12,22
12/4/2015,6,0,6,0,12
12/5/2015,2,0,8,3,13
12/6/2015,5,0,4,0,9
12/7/2015,5,0,4,8,17
12/8/2015,8,0,7,10,25
12/9/2015,6,0,7,0,13
12/10/2015,3,0,7,6,16
12/11/2015,5,0,5,13,23
12/12/2015,2,0,8,1,11
12/13/2015,4,0,2,5,11
12/14/2015,6,0,4,4,14
12/15/2015,6,0,5,7,18
12/16/2015,3,0,4,13,20
12/17/2015,6,0,5,9,20
12/18/2015,5,0,7,7,19
12/19/2015,8,0,7,4,19
12/20/2015,4,0,7,10,21
12/21/2015,3,0,3,9,15
12/22/2015,5,0,8,4,17
12/23/2015,8,0,2,6,16
12/24/2015,2,0,8,6,16
12/25/2015,8,0,3,9,20
12/26/2015,4,0,6,3,13
12/27/2015,5,0,3,10,18
12/28/2015,8,0,5,6,19
12/29/2015,6,0,6,11,23
12/30/2015,5,0,3,7,15
12/31/2015,5,0,5,2,12
1/1/2016,7,0,2,10,19
1/2/2016,7,0,4,12,23
1/3/2016,5,0,4,13,22
1/4/2016,6,0,6,12,24
1/5/2016,2,0,5,10,17
1/6/2016,8,0,3,5,16
1/7/2016,8,0,6,0,14
1/8/2016,5,0,4,5,14
1/9/2016,2,0,4,13,19
1/10/2016,4,0,6,5,15
1/11/2016,8,0,4,11,23
1/12/2016,8,0,5,10,23
1/13/2016,5,0,7,9,21
1/14/2016,3,0,3,3,9
1/15/2016,4,0,3,7,14
1/16/2016,7,0,2,6,15
1/17/2016,2,0,5,13,20
1/18/2016,5,0,3,2,10
1/19/2016,2,0,4,10,16
1/20/2016,4,0,4,13,21
1/21/2016,4,0,8,4,16
1/22/2016,6,0,8,8,22
1/23/2016,8,0,2,11,21
1/24/2016,5,0,7,11,23
1/25/2016,3,0,6,6,15
1/26/2016,6,0,2,5,13
1/27/2016,7,0,2,7,16
1/28/2016,5,0,6,7,18
1/29/2016,3,0,5,8,16
1/30/2016,6,0,7,11,24
1/31/2016,8,0,2,7,17
2/1/2016,2,0,6,9,17
2/2/2016,6,0,8,6,20
2/3/2016,2,0,6,4,12
2/4/2016,6,0,6,0,12
2/5/2016,8,0,8,1,17
2/6/2016,5,0,3,0,8
2/7/2016,8,0,3,3,14
2/8/2016,4,0,4,6,14
2/9/2016,8,0,5,3,16
2/10/2016,8,0,7,13,28
2/11/2016,6,0,7,9,22
2/12/2016,2,0,6,4,12
2/13/2016,7,0,5,9,21
2/14/2016,7,0,4,3,14
2/15/2016,6,0,6,0,12
2/16/2016,3,0,3,0,6
2/17/2016,2,0,6,11,19
2/18/2016,5,0,2,13,20
2/19/2016,3,0,6,12,21
2/20/2016,8,0,6,6,20
2/21/2016,7,0,6,6,19
2/22/2016,8,0,3,10,21
2/23/2016,3,0,5,4,12
2/24/2016,2,0,7,13,22
2/25/2016,5,0,5,12,22
2/26/2016,7,0,2,5,14
2/27/2016,8,0,2,10,20
2/28/2016,4,0,6,3,13
2/29/2016,4,0,4,9,17
3/1/2016,2,0,5,8,15
3/2/2016,8,0,5,9,22
3/3/2016,3,0,7,3,13
3/4/2016,3,0,3,9,15
3/5/2016,7,0,5,8,20
3/6/2016,8,0,8,13,29
3/7/2016,7,0,2,7,16
3/8/2016,7,0,5,13,25
3/9/2016,7,0,4,2,13
3/10/2016,3,0,5,6,14
3/11/2016,7,0,3,6,16
3/12/2016,4,0,4,3,11
3/13/2016,2,0,3,5,10
3/14/2016,5,0,3,0,8
3/15/2016,3,0,2,4,9
3/16/2016,6,0,6,3,15
3/17/2016,2,0,8,6,16
3/18/2016,4,0,8,4,16
3/19/2016,7,0,3,10,20
3/20/2016,8,0,3,11,22
3/21/2016,4,0,6,10,20
3/22/2016,8,0,5,12,25
3/23/2016,6,0,3,13,22
3/24/2016,7,0,8,9,24
3/25/2016,2,0,2,11,15
3/26/2016,2,0,8,5,15
3/27/2016,6,0,3,11,20
3/28/2016,6,0,3,2,11
3/29/2016,7,0,6,9,22
3/30/2016,7,0,6,13,26
3/31/2016,5,0,5,11,21
4/1/2016,6,0,4,0,10
4/2/2016,7,0,4,11,22
4/3/2016,2,0,8,4,14
4/4/2016,8,0,2,12,22
4/5/2016,5,0,2,13,20
4/6/2016,4,0,3,5,12
4/7/2016,7,0,8,5,20
4/8/2016,5,0,7,12,24
4/9/2016,7,0,4,2,13
4/10/2016,5,0,7,1,13
4/11/2016,8,0,6,12,26
4/12/2016,3,0,5,4,12
4/13/2016,6,0,6,12,24
4/14/2016,5,0,8,4,17
4/15/2016,3,0,4,13,20
4/16/2016,4,0,6,12,22
4/17/2016,3,0,2,1,6
4/18/2016,5,0,8,6,19
4/19/2016,6,0,3,12,21
4/20/2016,5,0,8,9,22
4/21/2016,5,0,3,10,18
4/22/2016,7,0,3,8,18
4/23/2016,3,0,8,10,21
4/24/2016,7,0,3,11,21
4/25/2016,5,0,2,11,18
4/26/2016,7,0,8,11,26
4/27/2016,4,0,5,11,20
4/28/2016,8,0,3,3,14
4/29/2016,7,0,5,9,21
4/30/2016,4,0,7,1,12
5/1/2016,4,0,7,12,23
5/2/2016,4,0,2,11,17
5/3/2016,4,0,8,8,20
5/4/2016,8,0,8,9,25
5/5/2016,2,0,8,4,14
5/6/2016,2,0,2,13,17
5/7/2016,5,0,5,6,16
5/8/2016,4,0,8,12,24
5/9/2016,8,0,8,4,20
5/10/2016,2,0,5,10,17
5/11/2016,4,0,3,12,19
5/12/2016,2,0,8,11,21
5/13/2016,5,0,4,9,18
5/14/2016,3,0,6,5,14
5/15/2016,5,0,5,8,18
5/16/2016,3,0,6,6,15
5/17/2016,4,0,3,4,11
5/18/2016,2,0,4,3,9
5/19/2016,3,0,7,11,21
5/20/2016,4,0,7,3,14
5/21/2016,3,0,4,4,11
5/22/2016,2,0,4,7,13
5/23/2016,2,0,8,10,20
5/24/2016,6,0,5,11,22
5/25/2016,6,0,8,10,24
5/26/2016,2,0,5,6,13
5/27/2016,4,0,2,7,13
5/28/2016,4,0,6,11,21
5/29/2016,6,0,6,13,25
5/30/2016,5,0,8,2,15
5/31/2016,5,0,5,11,21
6/1/2016,7,0,8,11,26
6/2/2016,4,0,6,4,14
6/3/2016,2,0,7,11,20
6/4/2016,7,0,3,12,22
6/5/2016,8,0,3,5,16
6/6/2016,3,0,3,9,15
6/7/2016,4,0,3,12,19
6/8/2016,6,0,2,0,8
6/9/2016,2,0,3,13,18
6/10/2016,8,0,4,10,22
6/11/2016,4,0,8,6,18
6/12/2016,2,0,6,2,10
6/13/2016,4,0,8,8,20
6/14/2016,2,0,5,0,7
6/15/2016,4,0,2,1,7
6/16/2016,3,0,7,2,12
6/17/2016,4,0,5,1,10
6/18/2016,2,0,2,2,6
6/19/2016,2,0,7,11,20
6/20/2016,2,0,7,3,12
6/21/2016,5,0,8,7,20
6/22/2016,6,0,8,11,25
6/23/2016,2,0,6,12,20
6/24/2016,8,0,6,3,17
6/25/2016,6,0,5,8,19
6/26/2016,4,0,2,12,18
6/27/2016,4,0,2,5,11
6/28/2016,7,0,5,2,14
6/29/2016,5,0,6,4,15
6/30/2016,3,0,4,0,7
7/1/2016,7,0,7,10,24
7/2/2016,5,0,2,11,18
7/3/2016,8,0,8,10,26
7/4/2016,2,0,4,9,15
7/5/2016,6,0,2,1,9
7/6/2016,3,0,7,7,17
7/7/2016,3,0,8,12,23
7/8/2016,7,0,6,9,22
7/9/2016,6,0,5,7,18
7/10/2016,7,0,4,4,15
7/11/2016,3,0,8,0,11
7/12/2016,6,0,5,3,14
7/13/2016,7,0,7,10,24
7/14/2016,7,0,4,2,13
7/15/2016,4,0,5,3,12
7/16/2016,5,0,3,0,8
7/17/2016,5,0,6,5,16
7/18/2016,7,0,3,3,13
7/19/2016,8,0,8,9,25
7/20/2016,4,0,6,13,23
7/21/2016,8,0,2,4,14
7/22/2016,6,0,7,12,25
7/23/2016,8,0,8,7,23
7/24/2016,7,0,5,8,20
7/25/2016,2,0,4,4,10
7/26/2016,2,0,3,7,12
7/27/2016,7,0,4,5,16
7/28/2016,7,0,3,13,23
7/29/2016,5,0,7,10,22
7/30/2016,8,0,6,3,17
7/31/2016,5,0,3,11,19
8/1/2016,2,0,5,2,9
8/2/2016,2,0,7,13,22
8/3/2016,2,0,6,13,21
8/4/2016,8,0,2,13,23
8/5/2016,6,0,8,9,23
8/6/2016,7,0,6,12,25
8/7/2016,5,0,6,9,20
8/8/2016,3,0,4,4,11
8/9/2016,4,0,4,3,11
8/10/2016,7,0,4,7,18
8/11/2016,8,0,7,5,20
8/12/2016,7,0,7,3,17
8/13/2016,6,0,3,12,21
8/14/2016,2,0,2,9,13
8/15/2016,5,0,3,5,13
8/16/2016,2,0,5,13,20
8/17/2016,7,0,3,2,12
8/18/2016,2,0,5,8,15
8/19/2016,2,0,4,5,11
8/20/2016,3,0,4,0,7
8/21/2016,5,0,3,6,14
8/22/2016,4,0,2,5,11
8/23/2016,5,0,4,0,9
8/24/2016,6,0,2,2,10
8/25/2016,7,0,4,3,14
8/26/2016,5,0,2,4,11
8/27/2016,7,0,7,13,27
8/28/2016,6,0,7,12,25
8/29/2016,5,0,2,6,13
8/30/2016,5,0,2,4,11
8/31/2016,5,0,6,9,20
9/1/2016,2,0,8,11,21
9/2/2016,3,0,6,0,9
9/3/2016,3,0,6,3,12
9/4/2016,8,0,5,9,22
9/5/2016,7,0,7,6,20
9/6/2016,4,0,5,10,19
9/7/2016,2,0,4,6,12
9/8/2016,3,0,5,12,20
9/9/2016,4,0,6,7,17
9/10/2016,5,0,8,1,14
9/11/2016,8,0,7,12,27
9/12/2016,8,0,5,11,24
9/13/2016,8,0,3,2,13
9/14/2016,8,0,4,11,23
9/15/2016,8,0,8,10,26
9/16/2016,4,0,6,0,10
9/17/2016,8,0,2,7,17
9/18/2016,4,0,7,13,24
9/19/2016,6,0,5,0,11
9/20/2016,5,0,5,7,17
9/21/2016,8,0,6,7,21
9/22/2016,7,0,7,6,20
9/23/2016,7,0,7,6,20
9/24/2016,2,0,4,4,10
9/25/2016,5,0,6,9,20
9/26/2016,3,0,8,3,14
9/27/2016,5,0,7,11,23
9/28/2016,7,0,6,7,20
9/29/2016,5,0,2,3,10
9/30/2016,3,0,4,13,20
10/1/2016,5,0,3,8,16
10/2/2016,8,0,2,9,19
10/3/2016,3,0,7,1,11
10/4/2016,5,0,3,9,17
10/5/2016,8,0,6,5,19
10/6/2016,7,0,7,10,24
10/7/2016,6,0,3,4,13
10/8/2016,5,0,6,1,12
10/9/2016,3,0,3,8,14
10/10/2016,8,0,8,6,22
10/11/2016,6,0,4,13,23
10/12/2016,7,0,3,9,19
10/13/2016,2,0,7,0,9
10/14/2016,6,0,5,2,13
10/15/2016,8,0,2,10,20
10/16/2016,5,0,4,1,10
10/17/2016,8,0,5,8,21
10/18/2016,8,0,8,9,25
10/19/2016,8,0,7,1,16
10/20/2016,4,0,4,9,17
10/21/2016,4,0,7,0,11
10/22/2016,2,0,5,7,14
10/23/2016,4,0,7,13,24
10/24/2016,8,0,7,5,20
10/25/2016,2,0,4,12,18
10/26/2016,2,0,2,2,6
10/27/2016,3,0,3,8,14
10/28/2016,3,0,2,2,7
10/29/2016,6,0,6,12,24
10/30/2016,7,0,6,10,23
10/31/2016,6,0,7,3,16
11/1/2016,4,0,5,8,17
11/2/2016,8,0,2,7,17
11/3/2016,5,0,2,2,9
11/4/2016,2,0,8,2,12
11/5/2016,5,0,3,6,14
11/6/2016,8,0,7,6,21
11/7/2016,3,0,8,11,22
11/8/2016,3,0,7,3,13
11/9/2016,6,0,5,12,23
11/10/2016,7,0,7,1,15
11/11/2016,2,0,4,9,15
11/12/2016,7,0,5,10,22
11/13/2016,7,0,6,11,24
11/14/2016,2,0,6,8,16
11/15/2016,2,0,2,3,7
11/16/2016,8,0,2,12,22
11/17/2016,8,0,5,5,18
11/18/2016,8,0,6,1,15
11/19/2016,5,0,3,10,18
11/20/2016,7,0,6,9,22
11/21/2016,5,0,6,6,17
11/22/2016,4,0,4,7,15
11/23/2016,4,0,7,2,13
11/24/2016,8,0,7,12,27
11/25/2016,8,0,5,11,24
11/26/2016,8,0,3,3,14
11/27/2016,7,0,7,4,18
11/28/2016,8,0,8,5,21
11/29/2016,3,0,5,11,19
11/30/2016,4,0,3,4,11
12/1/2016,6,0,4,12,22
12/2/2016,4,0,2,4,10
12/3/2016,4,0,8,0,12
12/4/2016,6,0,3,12,21
12/5/2016,2,0,2,4,8
12/6/2016,8,0,5,7,20
12/7/2016,3,0,5,4,12
12/8/2016,7,0,8,1,16
12/9/2016,7,0,7,6,20
12/10/2016,4,0,8,1,13
12/11/2016,7,0,4,3,14
12/12/2016,8,0,2,3,13
12/13/2016,8,0,4,2,14
12/14/2016,4,0,6,9,19
12/15/2016,4,0,7,9,20
12/16/2016,7,0,3,6,16
12/17/2016,7,0,7,5,19
12/18/2016,8,0,7,12,27
12/19/2016,4,0,8,12,24
12/20/2016,8,0,7,6,21
12/21/2016,3,0,2,12,17
12/22/2016,2,0,6,0,8
12/23/2016,4,0,3,8,15
12/24/2016,6,0,6,0,12
12/25/2016,3,0,4,5,12
12/26/2016,8,0,6,8,22
12/27/2016,2,0,3,10,15
12/28/2016,5,0,4,13,22
12/29/2016,5,0,3,1,9
12/30/2016,5,0,3,8,16
12/31/2016,7,0,5,4,16
1/1/2017,5,0,2,5,12
1/2/2017,8,0,7,3,18
1/3/2017,2,0,6,5,13
1/4/2017,3,0,7,10,20
1/5/2017,6,0,6,0,12
1/6/2017,2,0,4,6,12
1/7/2017,3,0,6,5,14
1/8/2017,8,0,5,12,25
1/9/2017,4,0,4,2,10
1/10/2017,6,0,7,6,19
1/11/2017,8,0,8,3,19
1/12/2017,6,0,6,9,21
1/13/2017,6,0,2,13,21
1/14/2017,6,0,2,12,20
1/15/2017,4,0,8,13,25
1/16/2017,3,0,7,1,11
1/17/2017,3,0,4,4,11
1/18/2017,6,0,4,7,17
1/19/2017,8,0,2,11,21
1/20/2017,6,0,2,8,16
1/21/2017,4,0,3,0,7
1/22/2017,4,0,3,4,11
1/23/2017,5,0,2,11,18
1/24/2017,5,0,6,2,13
1/25/2017,2,0,6,3,11
1/26/2017,7,0,2,3,12
1/27/2017,5,0,6,12,23
1/28/2017,4,0,2,9,15
1/29/2017,8,0,2,7,17
1/30/2017,2,0,7,6,15
1/31/2017,8,0,3,5,16
2/1/2017,6,0,5,9,20
2/2/2017,5,0,6,1,12
2/3/2017,8,0,8,1,17
2/4/2017,2,0,3,8,13
2/5/2017,7,0,2,9,18
2/6/2017,8,0,5,8,21
2/7/2017,4,0,7,10,21
2/8/2017,3,0,5,2,10
2/9/2017,3,0,7,8,18
2/10/2017,3,0,5,8,16
2/11/2017,3,0,6,10,19
2/12/2017,6,0,3,1,10
2/13/2017,3,0,6,13,22
2/14/2017,8,0,6,7,21
2/15/2017,7,0,2,11,20
2/16/2017,4,0,8,2,14
2/17/2017,4,0,3,10,17
2/18/2017,2,0,8,2,12
2/19/2017,4,0,3,11,18
2/20/2017,6,0,5,12,23
2/21/2017,8,0,4,5,17
2/22/2017,8,0,4,4,16
2/23/2017,3,0,5,9,17
2/24/2017,6,0,4,11,21
2/25/2017,2,0,4,8,14
2/26/2017,7,0,3,0,10
2/27/2017,4,0,8,13,25
2/28/2017,7,0,4,12,23
3/1/2017,5,0,5,0,10
3/2/2017,2,0,7,6,15
3/3/2017,6,0,5,1,12
3/4/2017,4,0,5,13,22
3/5/2017,8,0,7,9,24
3/6/2017,7,0,7,8,22
3/7/2017,3,0,2,7,12
3/8/2017,2,0,8,11,21
3/9/2017,6,0,5,9,20
3/10/2017,2,0,7,11,20
3/11/2017,5,0,3,7,15
3/12/2017,2,0,2,8,12
3/13/2017,2,0,3,6,11
3/14/2017,7,0,5,5,17
3/15/2017,6,0,4,4,14
3/16/2017,7,0,8,5,20
3/17/2017,2,0,5,10,17
3/18/2017,2,0,3,13,18
3/19/2017,6,0,3,12,21
3/20/2017,5,0,2,11,18
3/21/2017,2,0,5,1,8
3/22/2017,3,0,6,9,18
3/23/2017,7,0,5,5,17
3/24/2017,4,0,6,5,15
3/25/2017,3,0,3,5,11
3/26/2017,2,0,3,3,8
3/27/2017,5,0,7,1,13
3/28/2017,4,0,8,8,20
3/29/2017,5,0,2,3,10
3/30/2017,8,0,5,7,20
3/31/2017,3,0,8,13,24
4/1/2017,8,0,6,6,20
4/2/2017,5,0,2,12,19
4/3/2017,3,0,6,8,17
4/4/2017,8,0,6,8,22
4/5/2017,6,0,3,3,12
4/6/2017,2,0,8,10,20
4/7/2017,3,0,3,6,12
4/8/2017,5,0,2,6,13
4/9/2017,5,0,3,13,21
4/10/2017,2,0,7,4,13
4/11/2017,6,0,2,9,17
4/12/2017,5,0,6,6,17
4/13/2017,8,0,8,6,22
4/14/2017,7,0,2,1,10
4/15/2017,5,0,8,12,25
4/16/2017,5,0,5,1,11
4/17/2017,2,0,5,4,11
4/18/2017,2,0,8,10,20
4/19/2017,6,0,3,10,19
4/20/2017,6,0,5,3,14
4/21/2017,5,0,2,3,10
4/22/2017,5,0,7,11,23
4/23/2017,7,0,7,13,27
4/24/2017,7,0,5,8,20
4/25/2017,6,0,5,0,11
4/26/2017,3,0,8,2,13
4/27/2017,2,0,2,12,16
4/28/2017,4,0,7,12,23
4/29/2017,5,0,7,12,24
4/30/2017,3,0,8,6,17
5/1/2017,5,0,4,10,19
5/2/2017,3,0,4,13,20
5/3/2017,8,0,8,4,20
5/4/2017,2,0,7,10,19
5/5/2017,7,0,3,3,13
5/6/2017,3,0,2,12,17
5/7/2017,6,0,7,2,15
5/8/2017,4,0,6,13,23
5/9/2017,8,0,8,10,26
5/10/2017,5,0,8,8,21
5/11/2017,5,0,6,7,18
5/12/2017,7,0,2,3,12
5/13/2017,5,0,7,11,23
5/14/2017,6,0,5,12,23
5/15/2017,5,0,3,11,19
5/16/2017,6,0,6,6,18
5/17/2017,8,0,7,1,16
5/18/2017,5,0,2,9,16
5/19/2017,5,0,7,10,22
5/20/2017,8,0,3,13,24
5/21/2017,5,0,6,11,22
5/22/2017,4,0,7,12,23
5/23/2017,6,0,4,6,16
5/24/2017,4,0,6,4,14
5/25/2017,6,0,6,10,22
5/26/2017,7,0,4,5,16
5/27/2017,2,0,2,11,15
5/28/2017,3,0,3,3,9
5/29/2017,5,0,8,1,14
5/30/2017,7,0,8,2,17
5/31/2017,2,0,4,12,18
6/1/2017,5,0,3,7,15
6/2/2017,7,0,4,12,23
6/3/2017,2,0,7,11,20
6/4/2017,3,0,7,9,19
6/5/2017,6,0,8,11,25
6/6/2017,5,0,4,13,22
6/7/2017,2,0,3,10,15
6/8/2017,7,0,3,9,19
6/9/2017,2,0,4,13,19
6/10/2017,7,0,5,6,18
6/11/2017,2,0,6,5,13
6/12/2017,7,0,4,0,11
6/13/2017,6,0,6,10,22
6/14/2017,4,0,7,6,17
6/15/2017,5,0,7,13,25
6/16/2017,3,0,8,3,14
6/17/2017,3,0,6,8,17
6/18/2017,3,0,6,12,21
6/19/2017,5,0,4,0,9
6/20/2017,5,0,8,12,25
6/21/2017,2,0,3,1,6
6/22/2017,2,0,4,10,16
6/23/2017,5,0,5,7,17
6/24/2017,6,0,6,13,25
6/25/2017,2,0,4,6,12
6/26/2017,6,0,7,5,18
6/27/2017,7,0,2,5,14
6/28/2017,2,0,6,11,19
6/29/2017,7,0,2,7,16
6/30/2017,4,0,2,2,8
7/1/2017,7,0,2,3,12
7/2/2017,7,0,2,1,10
7/3/2017,6,0,3,10,19
7/4/2017,7,0,3,4,14
7/5/2017,3,0,6,3,12
7/6/2017,2,0,8,2,12
7/7/2017,8,0,7,11,26
7/8/2017,5,0,5,4,14
7/9/2017,2,0,8,6,16
7/10/2017,4,0,7,12,23
7/11/2017,4,0,5,9,18
7/12/2017,4,0,8,0,12
7/13/2017,5,0,7,5,17
7/14/2017,7,0,6,13,26
7/15/2017,5,0,8,3,16
7/16/2017,5,0,4,0,9
7/17/2017,6,0,3,11,20
7/18/2017,4,0,6,5,15
7/19/2017,5,0,5,10,20
7/20/2017,6,0,5,4,15
7/21/2017,2,0,2,13,17
7/22/2017,6,0,8,11,25
7/23/2017,7,0,8,8,23
7/24/2017,4,0,7,10,21
7/25/2017,8,0,8,9,25
7/26/2017,4,0,3,4,11
7/27/2017,6,0,7,0,13
7/28/2017,7,0,7,11,25
7/29/2017,6,0,5,3,14
7/30/2017,7,0,3,4,14
7/31/2017,2,0,6,8,16
8/1/2017,2,0,4,12,18
8/2/2017,5,0,3,12,20
8/3/2017,2,0,7,2,11
8/4/2017,3,0,4,4,11
8/5/2017,5,0,5,11,21
8/6/2017,4,0,8,9,21
8/7/2017,5,0,3,1,9
8/8/2017,7,0,7,7,21
8/9/2017,2,0,2,2,6
8/10/2017,3,0,8,10,21
8/11/2017,4,0,2,0,6
8/12/2017,7,0,5,12,24
8/13/2017,3,0,7,8,18
8/14/2017,3,0,5,3,11
8/15/2017,6,0,2,7,15
8/16/2017,7,0,6,6,19
8/17/2017,7,0,6,9,22
8/18/2017,6,0,2,4,12
8/19/2017,8,0,3,2,13
8/20/2017,5,0,4,7,16
8/21/2017,2,0,8,1,11
8/22/2017,7,0,4,12,23
8/23/2017,7,0,6,1,14
8/24/2017,5,0,2,9,16
8/25/2017,6,0,8,12,26
8/26/2017,5,0,6,11,22
8/27/2017,2,0,8,0,10
8/28/2017,5,0,3,10,18
8/29/2017,2,0,2,9,13
8/30/2017,7,0,2,12,21
8/31/2017,6,0,6,7,19
9/1/2017,5,0,4,10,19
9/2/2017,7,0,6,1,14
9/3/2017,2,0,4,7,13
9/4/2017,8,0,7,10,25
9/5/2017,8,0,8,0,16
9/6/2017,5,0,2,6,13
9/7/2017,6,0,8,4,18
9/8/2017,5,0,8,4,17
9/9/2017,6,0,6,9,21
9/10/2017,4,0,3,7,14
9/11/2017,5,0,7,7,19
9/12/2017,7,0,7,7,21
9/13/2017,7,0,2,2,11
9/14/2017,4,0,5,5,14
9/15/2017,6,0,3,3,12
9/16/2017,4,0,8,3,15
9/17/2017,3,0,5,8,16
9/18/2017,5,0,5,2,12
9/19/2017,5,0,5,6,16
9/20/2017,5,0,7,2,14
9/21/2017,5,0,2,10,17
9/22/2017,4,0,3,12,19
9/23/2017,7,0,5,12,24
9/24/2017,4,0,4,8,16
9/25/2017,7,0,4,2,13
9/26/2017,8,0,2,7,17
9/27/2017,7,0,7,4,18
9/28/2017,4,0,6,3,13
9/29/2017,5,0,7,11,23
9/30/2017,3,0,6,8,17
10/1/2017,6,0,6,12,24
10/2/2017,7,0,4,0,11
10/3/2017,3,0,5,5,13
10/4/2017,4,0,3,5,12
10/5/2017,5,0,5,7,17
10/6/2017,7,0,6,7,20
10/7/2017,4,0,4,3,11
10/8/2017,8,0,4,12,24
10/9/2017,2,0,6,11,19
10/10/2017,8,0,2,6,16
10/11/2017,7,0,8,9,24
10/12/2017,5,0,8,3,16
10/13/2017,3,0,4,13,20
10/14/2017,7,0,6,6,19
10/15/2017,2,0,5,3,10
10/16/2017,2,0,6,9,17
10/17/2017,8,0,4,13,25
10/18/2017,2,0,3,9,14
10/19/2017,4,0,8,4,16
10/20/2017,5,0,8,8,21
10/21/2017,7,0,3,8,18
10/22/2017,8,0,4,11,23
10/23/2017,6,0,8,3,17
10/24/2017,4,0,7,1,12
10/25/2017,4,0,3,13,20
10/26/2017,3,0,2,3,8
10/27/2017,6,0,6,1,13
10/28/2017,6,0,7,12,25
10/29/2017,4,0,4,9,17
10/30/2017,8,0,7,7,22
10/31/2017,5,0,7,12,24
11/1/2017,7,0,3,1,11
11/2/2017,3,0,8,3,14
11/3/2017,6,0,5,9,20
11/4/2017,7,0,2,12,21
11/5/2017,4,0,4,13,21
11/6/2017,2,0,4,11,17
11/7/2017,6,0,8,0,14
11/8/2017,6,0,5,7,18
11/9/2017,2,0,4,6,12
11/10/2017,8,0,8,2,18
11/11/2017,6,0,6,12,24
11/12/2017,7,0,7,9,23
11/13/2017,5,0,5,11,21
11/14/2017,4,0,5,2,11
11/15/2017,8,0,8,9,25
11/16/2017,4,0,6,8,18
11/17/2017,7,0,5,9,21
11/18/2017,5,0,6,4,15
11/19/2017,2,0,6,11,19
11/20/2017,6,0,6,8,20
11/21/2017,6,0,8,9,23
11/22/2017,8,0,3,13,24
11/23/2017,3,0,3,6,12
11/24/2017,2,0,8,8,18
11/25/2017,5,0,8,0,13
11/26/2017,2,0,2,3,7
11/27/2017,2,0,5,9,16
11/28/2017,6,0,8,7,21
11/29/2017,2,0,2,12,16
11/30/2017,4,0,4,1,9
12/1/2017,2,0,6,6,14
12/2/2017,3,0,4,0,7
12/3/2017,8,0,3,0,11
12/4/2017,8,0,2,5,15
12/5/2017,4,0,4,0,8
12/6/2017,4,0,6,5,15
12/7/2017,4,0,6,0,10
12/8/2017,3,0,4,8,15
12/9/2017,4,0,7,9,20
12/10/2017,4,0,6,3,13
12/11/2017,2,0,5,1,8
12/12/2017,3,0,3,12,18
12/13/2017,3,0,4,12,19
12/14/2017,5,0,8,5,18
12/15/2017,7,0,6,10,23
12/16/2017,5,0,8,6,19
12/17/2017,2,0,4,1,7
12/18/2017,8,0,2,0,10
12/19/2017,6,0,2,6,14
12/20/2017,7,0,3,8,18
12/21/2017,7,0,2,9,18
12/22/2017,3,0,2,13,18
12/23/2017,5,0,8,11,24
12/24/2017,2,0,6,13,21
12/25/2017,5,0,6,0,11
12/26/2017,7,0,6,0,13
12/27/2017,5,0,4,10,19
12/28/2017,7,0,4,10,21
12/29/2017,4,0,6,6,16
12/30/2017,7,0,5,5,17
12/31/2017,8,0,3,7,18
1/1/2018,6,0,4,13,23
1/2/2018,3,0,5,5,13
1/3/2018,4,0,2,1,7
1/4/2018,6,0,2,3,11
1/5/2018,3,0,4,3,10
1/6/2018,2,0,2,10,14
1/7/2018,6,0,4,3,13
1/8/2018,6,0,5,6,17
1/9/2018,3,0,6,10,19
1/10/2018,8,0,5,8,21
1/11/2018,6,0,2,2,10
1/12/2018,3,0,5,1,9
1/13/2018,8,0,5,1,14
1/14/2018,5,0,2,0,7
1/15/2018,4,0,3,4,11
1/16/2018,6,0,8,1,15
1/17/2018,5,0,6,4,15
1/18/2018,8,0,4,1,13
1/19/2018,4,0,6,9,19
1/20/2018,7,0,4,7,18
1/21/2018,3,0,8,5,16
1/22/2018,2,0,6,2,10
1/23/2018,5,0,7,10,22
1/24/2018,8,0,7,1,16
1/25/2018,2,0,4,3,9
1/26/2018,8,0,5,1,14
1/27/2018,3,0,2,7,12
1/28/2018,7,0,2,9,18
1/29/2018,7,0,3,1,11
1/30/2018,3,0,7,12,22
1/31/2018,5,0,8,13,26
2/1/2018,2,0,6,13,21
2/2/2018,3,0,4,2,9
2/3/2018,4,0,2,12,18
2/4/2018,8,0,5,1,14
2/5/2018,4,0,3,1,8
2/6/2018,8,0,8,13,29
2/7/2018,4,0,5,0,9
2/8/2018,8,0,6,4,18
2/9/2018,4,0,3,10,17
2/10/2018,4,0,4,10,18
2/11/2018,3,0,6,1,10
2/12/2018,8,0,7,6,21
2/13/2018,6,0,4,1,11
2/14/2018,7,0,3,5,15
2/15/2018,6,0,5,2,13
2/16/2018,3,0,7,5,15
2/17/2018,8,0,5,4,17
2/18/2018,5,0,6,8,19
2/19/2018,6,0,6,2,14
2/20/2018,6,0,5,7,18
2/21/2018,7,0,3,7,17
2/22/2018,2,0,3,9,14
2/23/2018,7,0,6,10,23
2/24/2018,7,0,5,4,16
2/25/2018,7,0,2,6,15
2/26/2018,6,0,8,4,18
2/27/2018,2,0,4,2,8
2/28/2018,3,0,3,0,6
3/1/2018,4,0,2,9,15
3/2/2018,6,0,4,7,17
3/3/2018,2,0,8,5,15
3/4/2018,4,0,2,7,13
3/5/2018,5,0,7,0,12
3/6/2018,5,0,2,9,16
3/7/2018,7,0,6,2,15
3/8/2018,8,0,5,4,17
3/9/2018,3,0,7,4,14
3/10/2018,7,0,8,7,22
3/11/2018,4,0,4,12,20
3/12/2018,4,0,3,8,15
3/13/2018,8,0,7,10,25
3/14/2018,5,0,5,10,20
3/15/2018,6,0,6,10,22
3/16/2018,3,0,6,6,15
3/17/2018,3,0,3,5,11
3/18/2018,7,0,4,4,15
3/19/2018,7,0,8,10,25
3/20/2018,5,0,4,4,13
3/21/2018,7,0,4,4,15
3/22/2018,5,0,2,10,17
3/23/2018,3,0,3,12,18
3/24/2018,2,0,5,6,13
3/25/2018,6,0,6,6,18
3/26/2018,4,0,7,0,11
3/27/2018,3,0,8,8,19
3/28/2018,8,0,8,9,25
3/29/2018,7,0,3,0,10
3/30/2018,4,0,7,8,19
3/31/2018,7,0,6,2,15
4/1/2018,5,0,7,7,19
4/2/2018,3,0,3,12,18
4/3/2018,4,0,3,10,17
4/4/2018,8,0,5,11,24
4/5/2018,6,0,8,12,26
4/6/2018,2,0,5,6,13
4/7/2018,4,0,3,4,11
4/8/2018,3,0,4,11,18
4/9/2018,5,0,4,3,12
4/10/2018,7,0,6,3,16
4/11/2018,2,0,3,1,6
4/12/2018,2,0,4,13,19
4/13/2018,7,0,2,10,19
4/14/2018,4,0,7,2,13
4/15/2018,8,0,8,7,23
4/16/2018,4,0,3,0,7
4/17/2018,6,0,4,3,13
4/18/2018,7,0,7,12,26
4/19/2018,4,0,8,8,20
4/20/2018,7,0,4,11,22
4/21/2018,4,0,8,6,18
4/22/2018,4,0,5,0,9
4/23/2018,5,0,8,5,18
4/24/2018,6,0,6,3,15
4/25/2018,4,0,6,3,13
4/26/2018,4,0,8,7,19
4/27/2018,3,0,8,9,20
4/28/2018,5,0,4,7,16
4/29/2018,3,0,5,8,16
4/30/2018,2,0,3,5,10
5/1/2018,3,0,2,9,14
5/2/2018,3,0,8,12,23
5/3/2018,4,0,7,6,17
5/4/2018,6,0,2,7,15
5/5/2018,6,0,4,12,22
5/6/2018,4,0,5,3,12
5/7/2018,7,0,7,4,18
5/8/2018,4,0,5,13,22
5/9/2018,4,0,2,10,16
5/10/2018,5,0,6,7,18
5/11/2018,3,0,3,10,16
5/12/2018,2,0,3,2,7
5/13/2018,2,0,5,10,17
5/14/2018,8,0,8,12,28
5/15/2018,4,0,4,3,11
5/16/2018,3,0,7,13,23
5/17/2018,3,0,5,10,18
5/18/2018,8,0,2,3,13
5/19/2018,7,0,2,7,16
5/20/2018,6,0,7,13,26
5/21/2018,8,0,6,3,17
5/22/2018,2,0,7,4,13
5/23/2018,8,0,5,7,20
5/24/2018,2,0,5,2,9
5/25/2018,3,0,4,13,20
5/26/2018,6,0,5,9,20
5/27/2018,7,0,5,4,16
5/28/2018,8,0,7,4,19
5/29/2018,7,0,6,0,13
5/30/2018,8,0,7,3,18
5/31/2018,2,0,7,13,22
6/1/2018,2,0,7,9,18
6/2/2018,6,0,4,0,10
6/3/2018,8,0,8,6,22
6/4/2018,2,0,6,9,17
6/5/2018,7,0,2,1,10
6/6/2018,5,0,8,0,13
6/7/2018,8,0,6,5,19
6/8/2018,5,0,5,9,19
6/9/2018,6,0,3,13,22
6/10/2018,6,0,5,11,22
6/11/2018,8,0,2,10,20
6/12/2018,5,0,6,8,19
6/13/2018,4,0,8,10,22
6/14/2018,8,0,4,11,23
6/15/2018,7,0,3,13,23
6/16/2018,2,0,5,7,14
6/17/2018,3,0,4,13,20
6/18/2018,7,0,8,11,26
6/19/2018,3,0,5,11,19
6/20/2018,7,0,7,0,14
6/21/2018,5,0,8,3,16
6/22/2018,8,0,5,8,21
6/23/2018,2,0,8,11,21
6/24/2018,7,0,2,10,19
6/25/2018,5,0,7,8,20
6/26/2018,8,0,7,11,26
6/27/2018,7,0,8,12,27
6/28/2018,3,0,3,2,8
6/29/2018,8,0,7,13,28
6/30/2018,4,0,4,7,15
7/1/2018,4,0,8,6,18
7/2/2018,5,0,3,3,11
7/3/2018,6,0,7,9,22
7/4/2018,5,0,7,3,15
7/5/2018,6,0,7,13,26
7/6/2018,5,0,8,13,26
7/7/2018,2,0,8,4,14
7/8/2018,2,0,8,13,23
7/9/2018,6,0,8,3,17
7/10/2018,4,0,5,10,19
7/11/2018,4,0,2,8,14
7/12/2018,4,0,3,3,10
7/13/2018,4,0,8,5,17
7/14/2018,7,0,2,9,18
7/15/2018,3,0,7,10,20
7/16/2018,8,0,3,11,22
7/17/2018,6,0,2,8,16
7/18/2018,6,0,2,7,15
7/19/2018,2,0,8,1,11
7/20/2018,5,0,3,13,21
7/21/2018,5,0,3,6,14
7/22/2018,2,0,5,10,17
7/23/2018,2,0,2,11,15
7/24/2018,7,0,4,9,20
7/25/2018,7,0,3,7,17
7/26/2018,5,0,7,12,24
7/27/2018,7,0,4,10,21
7/28/2018,3,0,8,2,13
7/29/2018,3,0,6,0,9
7/30/2018,6,0,5,13,24
7/31/2018,2,0,3,0,5
8/1/2018,3,0,4,13,20
8/2/2018,2,0,3,10,15
8/3/2018,4,0,2,5,11
8/4/2018,4,0,2,2,8
8/5/2018,6,0,7,2,15
8/6/2018,4,0,3,0,7
8/7/2018,5,0,3,6,14
8/8/2018,2,0,8,10,20
8/9/2018,8,0,2,5,15
8/10/2018,8,0,6,1,15
8/11/2018,7,0,8,9,24
8/12/2018,7,0,4,6,17
8/13/2018,2,0,3,1,6
8/14/2018,5,0,2,13,20
8/15/2018,7,0,6,1,14
8/16/2018,8,0,8,10,26
8/17/2018,8,0,5,10,23
8/18/2018,7,0,8,7,22
8/19/2018,5,0,2,5,12
8/20/2018,5,0,3,11,19
8/21/2018,7,0,4,6,17
8/22/2018,2,0,3,3,8
8/23/2018,3,0,5,10,18
8/24/2018,8,0,5,1,14
8/25/2018,3,0,3,7,13
8/26/2018,8,0,4,8,20
8/27/2018,8,0,3,6,17
8/28/2018,4,0,4,11,19
8/29/2018,6,0,4,5,15
8/30/2018,4,0,3,7,14
8/31/2018,2,0,3,13,18
9/1/2018,5,0,4,11,20
9/2/2018,7,0,4,1,12
9/3/2018,6,0,2,5,13
9/4/2018,5,0,8,3,16
9/5/2018,4,0,2,7,13
9/6/2018,5,0,7,1,13
9/7/2018,6,0,6,7,19
9/8/2018,4,0,8,1,13
9/9/2018,8,0,6,11,25
9/10/2018,6,0,8,6,20
9/11/2018,7,0,2,13,22
9/12/2018,2,0,8,13,23
9/13/2018,6,0,8,1,15
9/14/2018,6,0,6,1,13
9/15/2018,2,0,6,11,19
9/16/2018,3,0,7,3,13
9/17/2018,3,0,6,11,20
9/18/2018,7,0,6,6,19
9/19/2018,8,0,6,2,16
9/20/2018,8,0,2,4,14
9/21/2018,8,0,7,5,20
9/22/2018,3,0,7,8,18
9/23/2018,5,0,5,11,21
9/24/2018,8,0,5,11,24
9/25/2018,2,0,6,3,11
9/26/2018,5,0,6,1,12
9/27/2018,6,0,7,10,23
9/28/2018,6,0,2,8,16
9/29/2018,6,0,7,8,21
9/30/2018,3,0,4,11,18
10/1/2018,3,0,8,0,11
10/2/2018,5,0,3,0,8
10/3/2018,8,0,8,4,20
10/4/2018,8,0,8,12,28
10/5/2018,2,0,8,7,17
10/6/2018,2,0,4,9,15
10/7/2018,2,0,6,8,16
10/8/2018,5,0,4,2,11
10/9/2018,4,0,5,3,12
10/10/2018,7,0,8,9,24
10/11/2018,7,0,3,3,13
10/12/2018,6,0,3,2,11
10/13/2018,5,0,6,2,13
10/14/2018,8,0,4,11,23
10/15/2018,6,0,6,6,18
10/16/2018,4,0,5,8,17
10/17/2018,3,0,7,12,22
10/18/2018,2,0,4,10,16
10/19/2018,5,0,6,4,15
10/20/2018,3,0,8,3,14
10/21/2018,2,0,4,0,6
10/22/2018,6,0,7,1,14
10/23/2018,2,0,7,9,18
10/24/2018,3,0,8,13,24
10/25/2018,6,0,5,7,18
10/26/2018,8,0,2,2,12
10/27/2018,7,0,4,4,15
10/28/2018,3,0,5,5,13
10/29/2018,5,0,8,8,21
10/30/2018,6,0,2,11,19
10/31/2018,6,0,8,5,19
11/1/2018,7,0,4,7,18
11/2/2018,2,0,2,3,7
11/3/2018,6,0,7,13,26
11/4/2018,3,0,8,1,12
11/5/2018,7,0,4,6,17
11/6/2018,8,0,6,11,25
11/7/2018,7,0,5,1,13
11/8/2018,2,0,5,3,10
11/9/2018,7,0,5,13,25
11/10/2018,3,0,3,5,11
11/11/2018,5,0,4,10,19
11/12/2018,8,0,5,6,19
11/13/2018,2,0,8,0,10
11/14/2018,6,0,7,6,19
11/15/2018,3,0,8,12,23
11/16/2018,8,0,2,11,21
11/17/2018,3,0,2,0,5
11/18/2018,2,0,4,6,12
11/19/2018,8,0,6,4,18
11/20/2018,4,0,4,9,17
11/21/2018,8,0,8,5,21
11/22/2018,8,0,5,10,23
11/23/2018,6,0,2,9,17
11/24/2018,2,0,6,7,15
11/25/2018,6,0,5,10,21
11/26/2018,7,0,6,1,14
11/27/2018,3,0,5,11,19
11/28/2018,6,0,4,13,23
11/29/2018,7,0,2,3,12
11/30/2018,2,0,5,2,9
12/1/2018,6,0,4,12,22
12/2/2018,3,0,5,6,14
12/3/2018,4,0,3,8,15
12/4/2018,3,0,7,5,15
12/5/2018,2,0,7,7,16
12/6/2018,5,0,5,10,20
12/7/2018,5,0,5,5,15
12/8/2018,3,0,2,3,8
12/9/2018,3,0,7,8,18
12/10/2018,5,0,5,11,21
12/11/2018,7,0,3,7,17
12/12/2018,5,0,7,10,22
12/13/2018,8,0,3,12,23
12/14/2018,5,0,6,13,24
12/15/2018,5,0,5,0,10
12/16/2018,6,0,3,10,19
12/17/2018,5,0,3,6,14
12/18/2018,7,0,4,11,22
12/19/2018,3,0,4,12,19
12/20/2018,2,0,3,0,5
12/21/2018,2,0,4,3,9
12/22/2018,5,0,7,3,15
12/23/2018,6,0,8,6,20
12/24/2018,4,0,7,6,17
12/25/2018,3,0,2,3,8
12/26/2018,8,0,8,5,21
12/27/2018,3,0,2,12,17
12/28/2018,2,0,3,13,18
12/29/2018,4,0,4,10,18
12/30/2018,6,0,3,1,10
12/31/2018,4,0,7,2,13
1/1/2019,2,0,4,7,13
1/2/2019,2,0,6,4,12
1/3/2019,8,0,4,4,16
1/4/2019,2,0,2,5,9
1/5/2019,7,0,6,5,18
1/6/2019,8,0,2,5,15
1/7/2019,2,0,7,2,11
1/8/2019,8,0,8,1,17
1/9/2019,3,0,7,2,12
1/10/2019,7,0,8,2,17
1/11/2019,5,0,2,1,8
1/12/2019,6,0,2,12,20
1/13/2019,4,0,7,4,15
1/14/2019,7,0,8,10,25
1/15/2019,6,0,5,4,15
1/16/2019,5,0,6,5,16
1/17/2019,3,0,5,4,12
1/18/2019,7,0,3,0,10
1/19/2019,8,0,6,7,21
1/20/2019,6,0,8,12,26
1/21/2019,3,0,8,9,20
1/22/2019,8,0,4,3,15
1/23/2019,7,0,4,3,14
1/24/2019,5,0,2,6,13
1/25/2019,5,0,8,5,18
1/26/2019,6,0,8,6,20
1/27/2019,5,0,5,3,13
1/28/2019,3,0,6,5,14
1/29/2019,8,0,7,8,23
1/30/2019,4,0,7,7,18
1/31/2019,3,0,5,5,13
2/1/2019,3,0,4,11,18
2/2/2019,2,0,8,1,11
2/3/2019,6,0,6,6,18
2/4/2019,5,0,7,8,20
2/5/2019,6,0,4,7,17
2/6/2019,6,0,5,2,13
2/7/2019,8,0,3,4,15
2/8/2019,3,0,7,13,23
2/9/2019,2,0,6,13,21
2/10/2019,8,0,4,7,19
2/11/2019,4,0,6,11,21
2/12/2019,6,0,2,5,13
2/13/2019,5,0,4,9,18
2/14/2019,6,0,4,8,18
2/15/2019,6,0,4,2,12
2/16/2019,8,0,4,12,24
2/17/2019,3,0,6,0,9
2/18/2019,6,0,4,3,13
2/19/2019,8,0,8,7,23
2/20/2019,7,0,2,0,9
2/21/2019,7,0,8,4,19
2/22/2019,4,0,2,6,12
2/23/2019,3,0,2,11,16
2/24/2019,6,0,6,5,17
2/25/2019,6,0,7,6,19
2/26/2019,4,0,8,5,17
2/27/2019,7,0,8,4,19
2/28/2019,6,0,7,5,18
3/1/2019,6,0,4,6,16
3/2/2019,2,0,2,12,16
3/3/2019,6,0,8,1,15
3/4/2019,2,0,6,10,18
3/5/2019,7,0,8,13,28
3/6/2019,2,0,6,4,12
3/7/2019,4,0,2,11,17
3/8/2019,8,0,3,4,15
3/9/2019,4,0,8,0,12
3/10/2019,2,0,4,0,6
3/11/2019,4,0,4,12,20
3/12/2019,2,0,4,7,13
3/13/2019,5,0,8,7,20
3/14/2019,3,0,6,10,19
3/15/2019,5,0,2,11,18
3/16/2019,3,0,8,1,12
3/17/2019,2,0,6,1,9
3/18/2019,4,0,6,8,18
3/19/2019,4,0,3,6,13
3/20/2019,2,0,6,4,12
3/21/2019,2,0,3,9,14
3/22/2019,8,0,6,4,18
3/23/2019,2,0,6,2,10
3/24/2019,8,0,7,7,22
3/25/2019,6,0,2,7,15
3/26/2019,7,0,2,9,18
3/27/2019,3,0,3,7,13
3/28/2019,4,0,7,13,24
3/29/2019,2,0,4,0,6
3/30/2019,7,0,5,12,24
3/31/2019,5,0,5,13,23
4/1/2019,3,0,8,3,14
4/2/2019,7,0,8,1,16
4/3/2019,7,0,3,6,16
4/4/2019,7,0,3,13,23
4/5/2019,6,0,4,12,22
4/6/2019,2,0,3,7,12
4/7/2019,5,0,6,1,12
4/8/2019,4,0,7,6,17
4/9/2019,8,0,4,1,13
4/10/2019,7,0,2,9,18
4/11/2019,3,0,8,11,22
4/12/2019,4,0,6,11,21
4/13/2019,3,0,4,12,19
4/14/2019,5,0,7,3,15
4/15/2019,4,0,5,11,20
4/16/2019,2,0,4,2,8
4/17/2019,7,0,6,11,24
4/18/2019,4,0,7,6,17
4/19/2019,6,0,7,8,21
4/20/2019,6,0,6,12,24
4/21/2019,5,0,4,11,20
4/22/2019,8,0,2,10,20
4/23/2019,5,0,7,2,14
4/24/2019,3,0,7,8,18
4/25/2019,7,0,8,1,16
4/26/2019,5,0,7,8,20
4/27/2019,4,0,6,2,12
4/28/2019,4,0,5,7,16
4/29/2019,2,0,6,11,19
4/30/2019,2,0,2,12,16
5/1/2019,8,0,4,7,19
5/2/2019,2,0,7,11,20
5/3/2019,5,0,2,1,8
5/4/2019,6,0,6,4,16
5/5/2019,3,0,6,6,15
5/6/2019,5,0,8,6,19
5/7/2019,5,0,5,1,11
5/8/2019,4,0,2,10,16
5/9/2019,6,0,3,8,17
5/10/2019,5,0,4,6,15
5/11/2019,8,0,7,3,18
5/12/2019,2,0,8,11,21
5/13/2019,2,0,7,8,17
5/14/2019,6,0,4,1,11
5/15/2019,5,0,7,13,25
5/16/2019,5,0,3,12,20
5/17/2019,3,0,2,2,7
5/18/2019,8,0,4,12,24
5/19/2019,7,0,2,7,16
5/20/2019,3,0,2,3,8
5/21/2019,7,0,2,1,10
5/22/2019,7,0,6,8,21
5/23/2019,6,0,7,1,14
5/24/2019,7,0,8,1,16
5/25/2019,2,0,8,1,11
5/26/2019,8,0,5,3,16
5/27/2019,3,0,4,4,11
5/28/2019,6,0,3,1,10
5/29/2019,8,0,5,11,24
5/30/2019,7,0,4,7,18
5/31/2019,3,0,7,2,12
6/1/2019,6,0,7,12,25
6/2/2019,5,0,5,11,21
6/3/2019,7,0,8,5,20
6/4/2019,4,0,7,11,22
6/5/2019,4,0,6,1,11
6/6/2019,3,0,3,2,8
6/7/2019,5,0,5,2,12
6/8/2019,8,0,5,8,21
6/9/2019,3,0,5,7,15
6/10/2019,6,0,5,11,22
6/11/2019,7,0,8,6,21
6/12/2019,6,0,6,7,19
6/13/2019,3,0,5,5,13
6/14/2019,5,0,6,1,12
6/15/2019,6,0,2,6,14
6/16/2019,4,0,3,10,17
6/17/2019,7,0,6,3,16
6/18/2019,7,0,8,2,17
6/19/2019,8,0,6,6,20
6/20/2019,2,0,6,7,15
6/21/2019,4,0,8,0,12
6/22/2019,6,0,8,12,26
6/23/2019,7,0,8,3,18
6/24/2019,4,0,3,0,7
6/25/2019,6,0,4,2,12
6/26/2019,7,0,5,3,15
6/27/2019,2,0,3,8,13
6/28/2019,4,0,7,11,22
6/29/2019,4,0,8,2,14
6/30/2019,6,0,2,2,10
7/1/2019,8,0,7,4,19
7/2/2019,2,0,3,13,18
7/3/2019,4,0,8,7,19
7/4/2019,6,0,4,12,22
7/5/2019,5,0,3,11,19
7/6/2019,4,0,2,5,11
7/7/2019,5,0,4,2,11
7/8/2019,3,0,2,12,17
7/9/2019,6,0,4,12,22
7/10/2019,6,0,7,11,24
7/11/2019,7,0,4,9,20
7/12/2019,4,0,5,11,20
7/13/2019,4,0,7,2,13
7/14/2019,2,0,7,11,20
7/15/2019,7,0,4,9,20
7/16/2019,8,0,2,1,11
7/17/2019,4,0,7,7,18
7/18/2019,7,0,3,9,19
7/19/2019,2,0,4,0,6
7/20/2019,5,0,8,10,23
7/21/2019,3,0,5,2,10
7/22/2019,6,0,4,9,19
7/23/2019,3,0,2,11,16
7/24/2019,3,0,8,8,19
7/25/2019,4,0,8,2,14
7/26/2019,2,0,2,3,7
7/27/2019,7,0,5,1,13
7/28/2019,8,0,5,7,20
7/29/2019,7,0,4,2,13
7/30/2019,2,0,3,10,15
7/31/2019,4,0,8,0,12
8/1/2019,5,0,6,3,14
8/2/2019,7,0,8,8,23
8/3/2019,5,0,5,1,11
8/4/2019,8,0,5,11,24
8/5/2019,2,0,2,0,4
8/6/2019,4,0,2,2,8
8/7/2019,7,0,5,8,20
8/8/2019,5,0,8,12,25
8/9/2019,4,0,7,11,22
8/10/2019,4,0,4,4,12
8/11/2019,6,0,2,7,15
8/12/2019,8,0,3,5,16
8/13/2019,2,0,4,7,13
8/14/2019,3,0,3,13,19
8/15/2019,7,0,8,3,18
8/16/2019,2,0,6,1,9
8/17/2019,4,0,7,3,14
8/18/2019,4,0,8,10,22
8/19/2019,7,0,6,1,14
8/20/2019,7,0,3,0,10
8/21/2019,3,0,4,0,7
8/22/2019,4,0,5,4,13
8/23/2019,8,0,2,0,10
8/24/2019,4,0,8,9,21
8/25/2019,8,0,7,11,26
8/26/2019,3,0,5,8,16
8/27/2019,7,0,3,8,18
8/28/2019,4,0,6,6,16
8/29/2019,5,0,8,4,17
8/30/2019,6,0,2,7,15
8/31/2019,4,0,7,9,20
9/1/2019,6,0,5,12,23
9/2/2019,4,0,4,9,17
9/3/2019,5,0,2,13,20
9/4/2019,4,0,3,0,7
9/5/2019,7,0,2,0,9
9/6/2019,2,0,6,3,11
9/7/2019,6,0,6,5,17
9/8/2019,6,0,2,11,19
9/9/2019,5,0,6,6,17
9/10/2019,4,0,5,11,20
9/11/2019,2,0,7,5,14
9/12/2019,6,0,4,8,18
9/13/2019,6,0,3,11,20
9/14/2019,7,0,8,8,23
9/15/2019,7,0,4,11,22
9/16/2019,7,0,8,13,28
9/17/2019,2,0,8,12,22
9/18/2019,2,0,4,5,11
9/19/2019,3,0,3,1,7
9/20/2019,4,0,8,9,21
9/21/2019,3,0,5,4,12
9/22/2019,2,0,4,0,6
9/23/2019,6,0,8,2,16
9/24/2019,8,0,3,12,23
9/25/2019,3,0,5,3,11
9/26/2019,3,0,3,3,9
9/27/2019,4,0,5,0,9
9/28/2019,6,0,3,12,21
9/29/2019,5,0,4,2,11
9/30/2019,3,0,3,9,15
10/1/2019,8,0,8,9,25
10/2/2019,4,0,7,4,15
10/3/2019,8,0,5,5,18
10/4/2019,7,0,8,7,22
10/5/2019,2,0,8,5,15
10/6/2019,8,0,6,1,15
10/7/2019,5,0,5,4,14
10/8/2019,4,0,4,8,16
10/9/2019,5,0,5,6,16
10/10/2019,3,0,6,8,17
10/11/2019,2,0,8,11,21
10/12/2019,3,0,6,0,9
10/13/2019,3,0,6,6,15
10/14/2019,7,0,6,7,20
10/15/2019,8,0,3,13,24
10/16/2019,6,0,3,13,22
10/17/2019,8,0,8,10,26
10/18/2019,6,0,3,4,13
10/19/2019,7,0,7,13,27
10/20/2019,7,0,7,2,16
10/21/2019,4,0,4,8,16
10/22/2019,5,0,3,11,19
10/23/2019,6,0,7,6,19
10/24/2019,3,0,3,5,11
10/25/2019,8,0,4,4,16
10/26/2019,7,0,4,5,16
10/27/2019,6,0,4,12,22
10/28/2019,3,0,2,11,16
10/29/2019,6,0,3,12,21
10/30/2019,6,0,2,13,21
10/31/2019,7,0,8,13,28
11/1/2019,4,0,7,1,12
11/2/2019,2,0,6,11,19
11/3/2019,6,0,8,10,24
11/4/2019,8,0,5,4,17
11/5/2019,3,0,7,9,19
11/6/2019,3,0,3,13,19
11/7/2019,3,0,7,13,23
11/8/2019,5,0,8,10,23
11/9/2019,3,0,7,3,13
11/10/2019,8,0,7,11,26
11/11/2019,8,0,4,11,23
11/12/2019,6,0,4,4,14
11/13/2019,2,0,8,8,18
11/14/2019,8,0,6,1,15
11/15/2019,5,0,2,2,9
11/16/2019,5,0,4,1,10
11/17/2019,8,0,8,12,28
11/18/2019,7,0,3,11,21
11/19/2019,6,0,5,6,17
11/20/2019,2,0,4,7,13
11/21/2019,8,0,3,5,16
11/22/2019,6,0,2,5,13
11/23/2019,2,0,8,1,11
11/24/2019,3,0,3,1,7
11/25/2019,5,0,8,1,14
11/26/2019,8,0,7,0,15
11/27/2019,5,0,8,0,13
11/28/2019,7,0,2,5,14
11/29/2019,8,0,8,11,27
11/30/2019,2,0,6,9,17
12/1/2019,5,0,5,7,17
12/2/2019,4,0,4,12,20
12/3/2019,5,0,3,3,11
12/4/2019,3,0,6,10,19
12/5/2019,6,0,5,8,19
12/6/2019,2,0,3,0,5
12/7/2019,3,0,3,5,11
12/8/2019,7,0,7,3,17
12/9/2019,4,0,2,0,6
12/10/2019,3,0,2,5,10
12/11/2019,8,0,6,5,19
12/12/2019,4,0,7,12,23
12/13/2019,4,0,4,5,13
12/14/2019,4,0,4,3,11
12/15/2019,6,0,4,5,15
12/16/2019,8,0,6,9,23
12/17/2019,2,0,6,4,12
12/18/2019,8,0,8,6,22
12/19/2019,2,0,6,3,11
12/20/2019,5,0,8,3,16
12/21/2019,3,0,4,6,13
12/22/2019,7,0,2,0,9
12/23/2019,8,0,6,7,21
12/24/2019,2,0,3,7,12
12/25/2019,7,0,4,12,23
12/26/2019,7,0,7,4,18
12/27/2019,4,0,5,13,22
12/28/2019,4,0,7,3,14
12/29/2019,3,0,7,6,16
12/30/2019,4,0,3,7,14
12/31/2019,6,0,5,11,22
1/1/2020,2,0,3,1,6
1/2/2020,4,0,4,10,18
1/3/2020,4,0,5,3,12
1/4/2020,2,0,8,13,23
1/5/2020,2,0,3,3,8
1/6/2020,4,0,7,9,20
1/7/2020,8,0,5,12,25
1/8/2020,5,0,6,3,14
1/9/2020,5,0,6,11,22
1/10/2020,6,0,7,11,24
1/11/2020,4,0,3,7,14
1/12/2020,2,0,6,0,8
1/13/2020,4,0,2,13,19
1/14/2020,7,0,7,8,22
1/15/2020,2,0,8,3,13
1/16/2020,5,0,3,5,13
1/17/2020,8,0,6,3,17
1/18/2020,2,0,8,6,16
1/19/2020,6,0,4,3,13
1/20/2020,5,0,5,9,19
1/21/2020,6,0,4,2,12
1/22/2020,3,0,6,8,17
1/23/2020,5,0,6,0,11
1/24/2020,6,0,2,4,12
1/25/2020,3,0,4,13,20
1/26/2020,8,0,2,8,18
1/27/2020,2,0,3,4,9
1/28/2020,6,0,6,10,22
1/29/2020,4,0,2,2,8
1/30/2020,5,0,7,2,14
1/31/2020,4,0,8,1,13
2/1/2020,6,0,4,2,12
2/2/2020,6,0,7,9,22
2/3/2020,4,0,5,4,13
2/4/2020,6,0,3,3,12
2/5/2020,7,0,5,13,25
2/6/2020,3,0,4,1,8
2/7/2020,6,0,6,9,21
2/8/2020,3,0,8,11,22
2/9/2020,5,0,6,10,21
2/10/2020,3,0,3,7,13
2/11/2020,7,0,4,1,12
2/12/2020,7,0,8,4,19
2/13/2020,3,0,7,10,20
2/14/2020,8,0,3,0,11
2/15/2020,6,0,3,13,22
2/16/2020,7,0,6,10,23
2/17/2020,5,0,8,11,24
2/18/2020,3,0,8,8,19
2/19/2020,3,0,2,11,16
2/20/2020,8,0,7,9,24
2/21/2020,3,0,6,9,18
2/22/2020,4,0,5,3,12
2/23/2020,2,0,7,4,13
2/24/2020,4,0,2,13,19
2/25/2020,4,0,5,3,12
2/26/2020,4,0,7,12,23
2/27/2020,8,0,4,4,16
2/28/2020,2,0,3,12,17
2/29/2020,8,0,4,12,24
3/1/2020,5,10,6,5,26
3/2/2020,5,8,4,2,19
3/3/2020,6,8,3,11,28
3/4/2020,7,7,8,11,33
3/5/2020,6,6,3,1,16
3/6/2020,3,3,8,12,26
3/7/2020,2,3,2,0,7
3/8/2020,5,9,8,6,28
3/9/2020,6,9,8,10,33
3/10/2020,8,0,4,0,12
3/11/2020,2,9,3,8,22
3/12/2020,3,5,6,11,25
3/13/2020,6,5,3,0,14
3/14/2020,2,9,8,12,31
3/15/2020,2,6,6,1,15
3/16/2020,2,5,4,13,24
3/17/2020,2,10,7,3,22
3/18/2020,3,4,6,10,23
3/19/2020,5,8,4,5,22
3/20/2020,7,8,3,11,29
3/21/2020,4,7,2,4,17
3/22/2020,3,2,7,13,25
3/23/2020,4,3,5,9,21
3/24/2020,5,0,3,9,17
3/25/2020,6,6,8,5,25
3/26/2020,7,1,6,9,23
3/27/2020,5,5,8,13,31
3/28/2020,2,4,7,3,16
3/29/2020,5,1,5,5,16
3/30/2020,3,1,4,5,13
3/31/2020,4,1,4,5,14
4/1/2020,2,14,5,12,33
4/2/2020,7,13,2,0,22
4/3/2020,4,13,2,11,30
4/4/2020,7,15,8,4,34
4/5/2020,6,13,5,11,35
4/6/2020,8,25,8,11,52
4/7/2020,2,15,2,4,23
4/8/2020,2,22,7,3,34
4/9/2020,4,15,5,7,31
4/10/2020,5,10,4,5,24
4/11/2020,2,19,3,4,28
4/12/2020,2,20,8,1,31
4/13/2020,6,22,8,5,41
4/14/2020,5,23,4,6,38
4/15/2020,6,16,6,8,36
4/16/2020,4,21,8,6,39
4/17/2020,5,14,2,9,30
4/18/2020,7,15,7,4,33
4/19/2020,4,18,8,8,38
4/20/2020,5,23,2,6,36
4/21/2020,4,13,4,11,32
4/22/2020,7,24,8,3,42
4/23/2020,7,13,2,7,29
4/24/2020,6,18,3,13,40
4/25/2020,7,25,6,9,47
4/26/2020,4,16,5,6,31
4/27/2020,8,15,7,7,37
4/28/2020,6,24,3,5,38
4/29/2020,2,23,2,5,32
4/30/2020,4,19,7,9,39
5/1/2020,7,22,3,1,33
5/2/2020,8,25,5,12,50
5/3/2020,4,17,4,13,38
5/4/2020,8,25,8,2,43
5/5/2020,4,11,7,3,25
5/6/2020,4,12,7,7,30
5/7/2020,2,21,7,8,38
5/8/2020,6,16,3,4,29
5/9/2020,5,22,6,13,46
5/10/2020,8,21,3,11,43
5/11/2020,3,12,7,2,24
5/12/2020,6,16,6,12,40
5/13/2020,6,24,5,7,42
5/14/2020,6,13,3,11,33
5/15/2020,8,10,2,5,25
5/16/2020,3,21,7,9,40
5/17/2020,6,22,3,8,39
5/18/2020,4,12,5,7,28
5/19/2020,4,10,8,13,35
5/20/2020,6,11,7,0,24
5/21/2020,6,19,2,1,28
5/22/2020,3,22,5,11,41
5/23/2020,7,14,3,13,37
5/24/2020,5,22,7,0,34
5/25/2020,8,13,2,0,23
5/26/2020,5,19,4,10,38
5/27/2020,2,21,8,10,41
5/28/2020,5,12,6,12,35
5/29/2020,3,24,6,10,43
5/30/2020,3,23,7,12,45
5/31/2020,4,21,2,1,28
6/1/2020,7,32,4,9,52
6/2/2020,8,25,3,11,47
6/3/2020,6,46,7,13,72
6/4/2020,5,27,2,7,41
6/5/2020,5,25,2,13,45
6/6/2020,4,43,4,6,57
6/7/2020,7,34,3,0,44
6/8/2020,2,46,6,10,64
6/9/2020,2,33,7,6,48
6/10/2020,2,31,7,8,48
6/11/2020,3,50,4,0,57
6/12/2020,4,47,8,6,65
6/13/2020,4,53,5,13,75
6/14/2020,8,42,4,1,55
6/15/2020,6,53,7,3,69
6/16/2020,4,27,2,4,37
6/17/2020,5,53,3,6,67
6/18/2020,6,49,5,11,71
6/19/2020,8,25,8,5,46
6/20/2020,7,27,8,8,50
6/21/2020,5,43,6,10,64
6/22/2020,2,34,3,12,51
6/23/2020,5,31,2,12,50
6/24/2020,5,44,3,1,53
6/25/2020,2,49,8,9,68
6/26/2020,6,33,3,12,54
6/27/2020,7,34,6,7,54
6/28/2020,5,42,2,0,49
6/29/2020,4,47,4,12,67
6/30/2020,5,48,4,3,60
7/1/2020,3,58,3,4,68
7/2/2020,5,54,8,3,70
7/3/2020,6,65,2,1,74
7/4/2020,4,62,4,4,74
7/5/2020,4,69,3,0,76
7/6/2020,3,57,4,11,75
7/7/2020,2,66,6,10,84
7/8/2020,2,57,4,9,72
7/9/2020,7,61,6,8,82
7/10/2020,7,49,8,2,66
7/11/2020,6,57,6,10,79
7/12/2020,4,59,2,3,68
7/13/2020,3,70,3,8,84
7/14/2020,4,52,6,7,69
7/15/2020,7,68,4,11,90
7/16/2020,3,60,5,3,71
7/17/2020,8,64,2,1,75
7/18/2020,8,60,7,8,83
7/19/2020,7,72,6,5,90
7/20/2020,4,49,3,1,57
7/21/2020,4,49,4,12,69
7/22/2020,5,50,3,5,63
7/23/2020,2,53,2,9,66
7/24/2020,8,54,8,8,78
7/25/2020,6,62,5,1,74
7/26/2020,7,66,8,12,93
7/27/2020,2,70,7,10,89
7/28/2020,4,74,6,8,92
7/29/2020,4,61,7,13,85
7/30/2020,2,66,2,10,80
7/31/2020,6,69,8,1,84
8/1/2020,5,74,3,9,91
8/2/2020,7,74,3,9,93
8/3/2020,3,69,7,10,89
8/4/2020,2,67,7,8,84
8/5/2020,4,63,3,5,75
8/6/2020,2,68,7,6,83
8/7/2020,6,63,2,13,84
8/8/2020,2,46,4,0,52
8/9/2020,4,67,5,8,84
8/10/2020,5,65,3,10,83
8/11/2020,7,52,3,11,73
8/12/2020,7,62,5,9,83
8/13/2020,8,71,5,5,89
8/14/2020,8,66,7,9,90
8/15/2020,8,52,3,1,64
8/16/2020,5,68,4,10,87
8/17/2020,4,73,3,1,81
8/18/2020,4,45,6,7,62
8/19/2020,4,58,6,12,80
8/20/2020,8,75,2,2,87
8/21/2020,6,73,4,2,85
8/22/2020,3,51,6,4,64
8/23/2020,8,54,6,2,70
8/24/2020,8,58,5,12,83
8/25/2020,6,50,5,8,69
8/26/2020,2,63,5,0,70
8/27/2020,4,72,4,4,84
8/28/2020,5,50,4,1,60
8/29/2020,5,75,3,4,87
8/30/2020,7,49,8,1,65
8/31/2020,6,69,7,6,88
9/1/2020,7,140,3,2,152
9/2/2020,7,147,7,3,164
9/3/2020,2,110,7,5,124
9/4/2020,3,130,5,2,140
9/5/2020,4,108,6,0,118
9/6/2020,2,172,8,13,195
9/7/2020,6,95,8,3,112
9/8/2020,5,160,3,8,176
9/9/2020,4,148,2,8,162
9/10/2020,6,137,7,2,152
9/11/2020,7,104,8,11,130
9/12/2020,2,175,6,12,195
9/13/2020,2,98,7,9,116
9/14/2020,4,142,3,6,155
9/15/2020,4,143,7,1,155
9/16/2020,5,105,6,6,122
9/17/2020,6,141,2,7,156
9/18/2020,2,116,4,3,125
9/19/2020,2,147,3,3,155
9/20/2020,3,165,8,6,182
9/21/2020,7,97,3,9,116
9/22/2020,4,148,4,1,157
9/23/2020,7,128,5,12,152
9/24/2020,3,112,4,2,121
9/25/2020,5,147,7,9,168
9/26/2020,2,134,5,6,147
9/27/2020,8,166,4,7,185
9/28/2020,8,118,8,3,137
9/29/2020,7,157,5,11,180
9/30/2020,2,150,2,7,161
10/1/2020,4,134,7,3,148
10/2/2020,3,97,8,0,108
10/3/2020,7,103,5,13,128
10/4/2020,3,147,7,11,168
10/5/2020,2,151,2,10,165
10/6/2020,2,96,3,2,103
10/7/2020,6,151,7,9,173
10/8/2020,8,146,7,2,163
10/9/2020,6,106,5,6,123
10/10/2020,5,120,8,4,137
10/11/2020,2,101,2,0,105
10/12/2020,7,171,7,13,198
10/13/2020,7,168,6,12,193
10/14/2020,6,132,8,6,152
10/15/2020,8,129,6,13,156
10/16/2020,5,159,2,3,169
10/17/2020,8,149,2,0,159
10/18/2020,2,109,2,4,117
10/19/2020,3,110,2,2,117
10/20/2020,7,102,8,12,129
10/21/2020,4,102,5,2,113
10/22/2020,6,105,7,10,128
10/23/2020,8,117,7,4,136
10/24/2020,4,131,8,12,155
10/25/2020,5,141,2,13,161
10/26/2020,6,154,4,5,169
10/27/2020,5,146,2,5,158
10/28/2020,6,148,2,6,162
10/29/2020,5,165,8,13,191
10/30/2020,6,113,5,6,130
10/31/2020,3,163,4,9,179
11/1/2020,2,106,4,8,120
11/2/2020,4,142,6,9,161
11/3/2020,6,111,6,2,125
11/4/2020,8,164,6,12,190
11/5/2020,5,150,8,6,169
11/6/2020,8,95,2,2,107
11/7/2020,2,139,3,5,149
11/8/2020,8,118,8,8,142
11/9/2020,3,137,7,9,156
11/10/2020,6,164,5,1,176
11/11/2020,2,118,6,9,135
11/12/2020,2,144,4,13,163
11/13/2020,3,175,4,11,193
11/14/2020,8,97,8,1,114
11/15/2020,4,123,7,1,135
11/16/2020,5,153,8,6,172
11/17/2020,6,171,3,12,192
11/18/2020,6,129,8,3,146
11/19/2020,5,157,6,13,181
11/20/2020,7,112,3,8,130
11/21/2020,4,152,2,0,158
11/22/2020,6,170,4,8,188
11/23/2020,6,116,6,1,129
11/24/2020,4,114,6,9,133
11/25/2020,7,143,7,8,165
11/26/2020,5,105,4,2,116
11/27/2020,5,165,4,8,182
11/28/2020,5,151,5,10,171
11/29/2020,5,122,6,8,141
11/30/2020,8,162,5,13,188
12/1/2020,2,147,6,7,162
12/2/2020,5,159,7,5,176
12/3/2020,2,155,8,4,169
12/4/2020,3,148,8,8,167
12/5/2020,8,114,3,12,137
12/6/2020,4,147,6,8,165
12/7/2020,3,154,2,13,172
12/8/2020,5,130,6,1,142
12/9/2020,5,111,7,2,125
12/10/2020,4,165,4,6,179
12/11/2020,3,104,2,6,115
12/12/2020,2,146,7,13,168
12/13/2020,8,122,3,3,136
12/14/2020,3,103,7,1,114
12/15/2020,2,104,5,3,114
12/16/2020,8,138,3,3,152
12/17/2020,7,146,6,8,167
12/18/2020,4,165,6,4,179
12/19/2020,4,128,3,13,148
12/20/2020,8,123,6,10,147
12/21/2020,3,107,6,9,125
12/22/2020,4,147,4,2,157
12/23/2020,6,148,8,10,172
12/24/2020,3,172,4,5,184
12/25/2020,6,102,3,9,120
12/26/2020,4,118,8,5,135
12/27/2020,8,101,6,0,115
12/28/2020,6,99,6,12,123
12/29/2020,2,170,5,12,189
12/30/2020,8,161,2,0,171
12/31/2020,4,169,7,4,184
1/1/2021,8,142,4,6,160
1/2/2021,7,119,3,2,131
1/3/2021,3,117,4,5,129
1/4/2021,3,125,7,1,136
1/5/2021,7,127,4,12,150
1/6/2021,4,97,3,12,116
1/7/2021,3,163,3,4,173
1/8/2021,3,126,5,4,138
1/9/2021,4,140,3,9,156
1/10/2021,6,131,6,1,144
1/11/2021,5,112,7,6,130
1/12/2021,7,140,5,10,162
1/13/2021,6,101,6,11,124
1/14/2021,7,157,7,8,179
1/15/2021,3,145,6,2,156
1/16/2021,2,112,5,5,124
1/17/2021,3,113,4,6,126
1/18/2021,5,105,7,2,119
1/19/2021,7,98,8,6,119
1/20/2021,8,110,3,8,129
1/21/2021,5,105,3,3,116
1/22/2021,6,166,7,11,190
1/23/2021,7,100,7,1,115
1/24/2021,4,150,7,2,163
1/25/2021,3,97,5,13,118
1/26/2021,2,145,7,13,167
1/27/2021,3,129,2,5,139
1/28/2021,6,108,2,9,125
1/29/2021,2,136,4,10,152
1/30/2021,7,148,2,12,169
1/31/2021,3,154,8,2,167
2/1/2021,4,137,5,11,157
2/2/2021,7,145,6,7,165
2/3/2021,2,158,5,3,168
2/4/2021,7,132,8,2,149
2/5/2021,2,151,4,9,166
2/6/2021,7,115,2,4,128
2/7/2021,3,173,4,6,186
2/8/2021,2,116,7,8,133
2/9/2021,7,138,6,5,156
2/10/2021,6,95,3,2,106
2/11/2021,5,116,7,5,133
2/12/2021,8,97,5,12,122
2/13/2021,4,130,6,3,143
2/14/2021,5,173,7,4,189
2/15/2021,6,175,8,4,193
2/16/2021,5,139,8,13,165
2/17/2021,4,109,6,6,125
2/18/2021,7,174,5,1,187
2/19/2021,5,174,4,4,187
2/20/2021,3,97,2,8,110
2/21/2021,8,167,8,0,183
2/22/2021,7,150,5,3,165
2/23/2021,3,126,4,3,136
2/24/2021,6,150,7,1,164
2/25/2021,2,115,8,11,136
2/26/2021,8,114,2,12,136
2/27/2021,6,151,3,10,170
2/28/2021,5,96,3,7,111
3/1/2021,8,127,3,10,148
3/2/2021,5,161,8,12,186
3/3/2021,6,164,6,6,182
3/4/2021,8,152,4,3,167
3/5/2021,6,133,6,5,150
3/6/2021,6,159,6,0,171
3/7/2021,3,106,7,4,120
3/8/2021,7,106,2,3,118
3/9/2021,6,130,2,1,139
3/10/2021,6,169,6,7,188
3/11/2021,7,114,8,1,130
3/12/2021,4,147,8,9,168
3/13/2021,5,170,4,10,189
3/14/2021,8,107,5,11,131
3/15/2021,8,114,4,6,132
3/16/2021,6,161,5,2,174
3/17/2021,8,108,7,7,130
3/18/2021,5,162,2,11,180
3/19/2021,2,169,7,9,187
3/20/2021,3,138,3,1,145
3/21/2021,4,173,8,11,196
3/22/2021,4,125,8,2,139
3/23/2021,6,139,2,7,154
3/24/2021,7,160,2,1,170
3/25/2021,2,143,7,10,162
3/26/2021,3,132,7,10,152
3/27/2021,2,97,7,0,106
3/28/2021,5,136,6,11,158
3/29/2021,6,141,8,6,161
3/30/2021,7,155,8,8,178
3/31/2021,8,101,8,1,118
4/1/2021,2,139,5,6,152
4/2/2021,8,112,3,1,124
4/3/2021,5,104,4,6,119
4/4/2021,8,96,4,3,111
4/5/2021,2,99,6,0,107
4/6/2021,2,132,6,2,142
4/7/2021,3,123,6,12,144
4/8/2021,4,127,3,6,140
4/9/2021,6,141,8,0,155
4/10/2021,2,97,3,3,105
4/11/2021,2,170,4,4,180
4/12/2021,2,136,6,7,151
4/13/2021,2,127,2,4,135
4/14/2021,8,158,7,1,174
4/15/2021,6,154,4,7,171
4/16/2021,2,133,6,3,144
4/17/2021,5,168,7,11,191
4/18/2021,8,168,4,7,187
4/19/2021,2,170,3,8,183
4/20/2021,4,142,4,2,152
4/21/2021,3,168,3,2,176
4/22/2021,3,167,6,1,177
4/23/2021,6,99,8,7,120
4/24/2021,3,142,5,11,161
4/25/2021,7,169,3,5,184
4/26/2021,6,131,5,12,154
4/27/2021,4,154,7,5,170
4/28/2021,8,153,6,4,171
4/29/2021,2,133,5,3,143
4/30/2021,8,157,5,13,183
5/1/2021,2,171,8,6,187
5/2/2021,7,136,8,12,163
5/3/2021,6,133,4,8,151
5/4/2021,6,173,6,5,190
5/5/2021,2,151,6,4,163
5/6/2021,2,99,6,8,115
5/7/2021,2,115,6,13,136
5/8/2021,6,115,4,13,138
5/9/2021,3,98,5,13,119
5/10/2021,5,168,4,10,187
5/11/2021,7,167,4,3,181
5/12/2021,8,113,6,11,138
5/13/2021,2,140,4,10,156
5/14/2021,5,169,7,5,186
5/15/2021,6,144,2,1,153
5/16/2021,5,138,4,9,156
5/17/2021,8,121,4,1,134
5/18/2021,4,162,8,11,185
5/19/2021,3,115,2,5,125
5/20/2021,6,112,6,1,125
5/21/2021,4,159,4,11,178
5/22/2021,7,169,7,5,188
5/23/2021,6,132,2,6,146
5/24/2021,3,104,2,5,114
5/25/2021,2,149,8,1,160
5/26/2021,5,167,3,11,186
5/27/2021,4,140,3,7,154
5/28/2021,6,163,6,4,179
5/29/2021,2,132,3,12,149
5/30/2021,3,147,3,4,157
5/31/2021,8,113,5,0,126
6/1/2021,3,153,8,4,168
6/2/2021,3,139,7,9,158
6/3/2021,4,155,6,2,167
6/4/2021,4,117,2,8,131
6/5/2021,6,124,2,10,142
6/6/2021,6,160,7,9,182
6/7/2021,5,159,7,5,176
6/8/2021,3,111,4,11,129
6/9/2021,7,111,4,12,134
6/10/2021,3,168,6,0,177
6/11/2021,2,121,2,8,133
6/12/2021,7,157,3,9,176
6/13/2021,7,107,2,0,116
6/14/2021,2,97,4,8,111
6/15/2021,8,137,7,9,161
6/16/2021,5,124,5,6,140
6/17/2021,4,157,3,0,164
6/18/2021,5,112,5,0,122
6/19/2021,2,105,5,9,121
6/20/2021,4,137,8,9,158
6/21/2021,5,99,7,1,112
6/22/2021,3,110,6,3,122
6/23/2021,7,95,2,8,112
6/24/2021,2,123,7,6,138
6/25/2021,7,160,2,0,169
6/26/2021,4,170,8,9,191
6/27/2021,5,124,4,6,139
6/28/2021,8,102,6,7,123
6/29/2021,3,131,6,6,146
6/30/2021,7,126,4,4,141
7/1/2021,4,124,4,8,140
7/2/2021,7,102,4,2,115
7/3/2021,2,115,2,11,130
7/4/2021,6,155,8,3,172
7/5/2021,6,171,5,10,192
7/6/2021,8,123,8,11,150
7/7/2021,6,152,2,8,168
7/8/2021,3,123,3,13,142
7/9/2021,7,107,8,12,134
7/10/2021,8,102,6,1,117
7/11/2021,2,145,5,7,159
7/12/2021,4,147,4,9,164
7/13/2021,4,131,2,3,140
7/14/2021,4,167,7,11,189
7/15/2021,3,107,7,7,124
7/16/2021,3,173,6,5,187
7/17/2021,4,146,8,0,158
7/18/2021,4,108,7,11,130
7/19/2021,6,113,6,10,135
7/20/2021,4,143,7,12,166
7/21/2021,2,125,8,7,142
7/22/2021,6,147,7,11,171
7/23/2021,2,112,3,5,122
7/24/2021,5,109,4,5,123
7/25/2021,8,99,3,10,120
7/26/2021,3,175,5,10,193
7/27/2021,7,127,2,5,141
7/28/2021,3,149,6,4,162
7/29/2021,6,117,7,13,143
7/30/2021,3,108,2,4,117
7/31/2021,6,129,6,1,142
8/1/2021,7,125,2,8,142
8/2/2021,2,143,3,11,159
8/3/2021,6,146,6,1,159
8/4/2021,3,175,5,10,193
8/5/2021,2,142,3,11,158
8/6/2021,8,159,4,13,184
8/7/2021,7,163,4,11,185
8/8/2021,5,168,6,7,186
8/9/2021,4,138,8,8,158
8/10/2021,5,141,7,5,158
8/11/2021,8,128,7,9,152
8/12/2021,4,108,8,0,120
8/13/2021,4,106,6,6,122
8/14/2021,8,109,8,1,126
8/15/2021,4,146,2,9,161
8/16/2021,6,171,8,3,188
8/17/2021,4,97,2,3,106
8/18/2021,3,133,2,7,145
8/19/2021,2,164,2,1,169
8/20/2021,6,172,2,9,189
8/21/2021,3,164,3,7,177
8/22/2021,6,166,6,11,189
8/23/2021,2,158,2,13,175
8/24/2021,8,167,4,11,190
8/25/2021,3,130,4,11,148
8/26/2021,4,140,7,7,158
8/27/2021,3,136,5,3,147
8/28/2021,5,138,5,1,149
8/29/2021,8,143,2,5,158
8/30/2021,4,139,4,6,153
8/31/2021,6,119,7,2,134
9/1/2021,6,111,4,11,132
9/2/2021,8,154,6,1,169
9/3/2021,4,153,2,6,165
9/4/2021,7,154,6,11,178
9/5/2021,5,116,5,3,129
9/6/2021,2,131,5,3,141
9/7/2021,2,107,7,3,119
9/8/2021,6,116,8,10,140
9/9/2021,6,154,7,7,174
9/10/2021,5,119,3,5,132
9/11/2021,4,161,3,3,171
9/12/2021,2,116,8,4,130
9/13/2021,4,121,7,10,142
9/14/2021,2,117,7,12,138
9/15/2021,2,124,8,8,142
9/16/2021,2,102,2,6,112
9/17/2021,3,120,4,5,132
9/18/2021,6,162,6,10,184
9/19/2021,2,140,4,5,151
9/20/2021,8,169,4,11,192
9/21/2021,7,146,2,7,162
9/22/2021,3,113,5,3,124
9/23/2021,5,165,8,1,179
9/24/2021,8,131,8,2,149
9/25/2021,4,98,3,0,105
9/26/2021,3,162,8,2,175
9/27/2021,7,115,4,10,136
9/28/2021,3,143,4,9,159
9/29/2021,8,149,8,9,174
9/30/2021,3,160,8,9,180
10/1/2021,4,118,2,8,132
10/2/2021,5,126,8,6,145
10/3/2021,5,137,3,9,154
10/4/2021,5,168,7,6,186
10/5/2021,5,141,6,2,154
10/6/2021,4,164,2,7,177
10/7/2021,5,163,4,2,174
10/8/2021,5,162,3,5,175
10/9/2021,7,166,4,13,190
10/10/2021,5,139,6,0,150
10/11/2021,8,137,4,12,161
10/12/2021,8,174,4,12,198
10/13/2021,3,168,4,4,179
10/14/2021,5,111,3,2,121
10/15/2021,5,163,8,8,184
10/16/2021,3,118,4,12,137
10/17/2021,2,95,7,10,114
10/18/2021,3,128,8,3,142
10/19/2021,6,167,2,4,179
10/20/2021,8,145,6,7,166
10/21/2021,2,121,6,13,142
10/22/2021,7,116,3,9,135
10/23/2021,2,143,5,5,155
10/24/2021,5,128,2,2,137
10/25/2021,5,98,2,1,106
10/26/2021,4,174,8,8,194
10/27/2021,8,147,8,0,163
10/28/2021,3,152,6,3,164
10/29/2021,6,136,8,7,157
10/30/2021,8,110,2,7,127
10/31/2021,7,172,8,10,197
11/1/2021,7,144,2,0,153
11/2/2021,7,146,7,9,169
11/3/2021,3,101,8,1,113
11/4/2021,6,159,6,12,183
11/5/2021,2,126,4,13,145
11/6/2021,3,103,4,4,114
11/7/2021,3,132,3,1,139
11/8/2021,5,133,6,3,147
11/9/2021,7,114,6,13,140
11/10/2021,8,132,7,9,156
11/11/2021,8,174,6,10,198
11/12/2021,7,129,8,7,151
11/13/2021,8,133,3,0,144
11/14/2021,2,173,3,12,190
11/15/2021,3,150,8,0,161
11/16/2021,2,143,6,6,157
11/17/2021,4,103,4,9,120
11/18/2021,6,152,3,10,171
11/19/2021,2,113,5,13,133
11/20/2021,4,175,7,8,194
11/21/2021,2,163,2,7,174
11/22/2021,3,127,2,11,143
11/23/2021,2,137,5,0,144
11/24/2021,7,138,5,4,154
11/25/2021,4,125,4,5,138
11/26/2021,3,113,5,2,123
11/27/2021,6,144,4,5,159
11/28/2021,2,149,3,3,157
11/29/2021,3,147,3,10,163
11/30/2021,5,141,4,8,158
12/1/2021,5,126,2,7,140
12/2/2021,2,104,4,6,116
12/3/2021,8,165,2,9,184
12/4/2021,3,122,6,1,132
12/5/2021,4,107,3,0,114
12/6/2021,2,117,6,11,136
12/7/2021,6,175,5,12,198
12/8/2021,6,174,8,10,198
12/9/2021,4,105,8,13,130
12/10/2021,4,150,4,1,159
12/11/2021,2,145,2,13,162
12/12/2021,4,119,7,11,141
12/13/2021,2,149,3,10,164
12/14/2021,3,136,5,8,152
12/15/2021,2,147,5,4,158
12/16/2021,3,168,4,3,178
12/17/2021,5,167,6,8,186
12/18/2021,7,169,6,13,195
12/19/2021,7,121,4,1,133
12/20/2021,8,113,3,2,126
12/21/2021,7,101,2,0,110
12/22/2021,7,99,3,4,113
12/23/2021,8,98,3,4,113
12/24/2021,5,118,5,12,140
12/25/2021,3,163,8,5,179
12/26/2021,4,157,7,13,181
12/27/2021,3,110,8,10,131
12/28/2021,7,132,7,1,147
12/29/2021,7,95,3,13,118
12/30/2021,4,113,2,1,120
12/31/2021,2,164,4,10,180
1/1/2022,3,114,3,12,132
1/2/2022,7,139,3,13,162
1/3/2022,6,151,4,10,171
1/4/2022,5,152,2,10,169
1/5/2022,5,116,2,0,123
1/6/2022,5,95,8,4,112
1/7/2022,4,164,3,10,181
1/8/2022,3,174,8,13,198
1/9/2022,6,132,2,9,149
1/10/2022,2,157,8,12,179
1/11/2022,8,130,3,11,152
1/12/2022,4,174,4,11,193
1/13/2022,7,119,4,5,135
1/14/2022,7,164,6,9,186
1/15/2022,4,118,6,5,133
1/16/2022,4,163,2,4,173
1/17/2022,4,103,4,2,113
1/18/2022,6,106,5,3,120
1/19/2022,5,121,4,8,138
1/20/2022,2,168,5,9,184
1/21/2022,7,157,6,7,177
1/22/2022,3,140,7,8,158
1/23/2022,6,132,5,13,156
1/24/2022,7,156,4,4,171
1/25/2022,5,158,7,1,171
1/26/2022,3,151,2,10,166
1/27/2022,7,172,3,6,188
1/28/2022,6,116,3,9,134
1/29/2022,8,105,2,2,117
1/30/2022,4,102,3,12,121
1/31/2022,2,157,7,11,177
2/1/2022,7,140,7,6,160
2/2/2022,5,131,2,5,143
2/3/2022,5,157,6,8,176
2/4/2022,6,131,8,10,155
2/5/2022,4,97,7,0,108
2/6/2022,8,97,5,11,121
2/7/2022,6,163,3,4,176
2/8/2022,5,129,2,13,149
2/9/2022,8,129,4,2,143
2/10/2022,8,172,8,6,194
2/11/2022,3,100,4,1,108
2/12/2022,8,107,7,5,127
2/13/2022,7,119,7,3,136
2/14/2022,4,104,5,13,126
2/15/2022,4,124,5,0,133
2/16/2022,2,163,2,6,173
2/17/2022,4,128,8,11,151
2/18/2022,2,120,7,0,129
2/19/2022,7,135,7,5,154
2/20/2022,4,165,6,2,177
2/21/2022,2,157,2,8,169
2/22/2022,3,107,4,4,118
2/23/2022,6,157,6,9,178
2/24/2022,5,164,7,1,177
2/25/2022,6,107,4,5,122
2/26/2022,2,141,4,4,151
2/27/2022,8,118,3,13,142
2/28/2022,8,162,6,13,189
3/1/2022,8,102,8,5,123
3/2/2022,3,164,2,5,174
3/3/2022,5,132,3,9,149
3/4/2022,8,101,5,10,124
3/5/2022,6,172,4,2,184
3/6/2022,3,100,2,1,106
3/7/2022,6,175,6,0,187
3/8/2022,3,141,6,1,151
3/9/2022,8,146,3,0,157
3/10/2022,7,167,8,9,191
3/11/2022,5,131,2,6,144
3/12/2022,8,169,2,0,179
3/13/2022,4,95,7,13,119
3/14/2022,7,161,8,4,180
3/15/2022,2,163,6,4,175
3/16/2022,6,153,8,11,178
3/17/2022,2,108,8,12,130
3/18/2022,2,135,8,10,155
3/19/2022,6,129,8,7,150
3/20/2022,4,155,6,4,169
3/21/2022,3,103,4,2,112
3/22/2022,3,96,5,10,114
3/23/2022,2,133,4,11,150
3/24/2022,5,122,6,3,136
3/25/2022,2,129,4,1,136
3/26/2022,3,115,7,9,134
3/27/2022,4,154,2,1,161
3/28/2022,7,122,7,0,136
3/29/2022,8,142,2,9,161
3/30/2022,3,139,3,10,155
3/31/2022,6,95,3,3,107
4/1/2022,7,133,5,4,149
4/2/2022,6,172,7,5,190
4/3/2022,7,113,6,4,130
4/4/2022,3,149,4,4,160
4/5/2022,6,138,6,10,160
4/6/2022,7,112,3,6,128
4/7/2022,8,165,6,6,185
4/8/2022,4,116,7,3,130
4/9/2022,8,107,7,7,129
4/10/2022,5,130,8,13,156
4/11/2022,4,135,3,5,147
4/12/2022,2,118,2,3,125
4/13/2022,3,166,5,7,181
4/14/2022,8,170,7,7,192
4/15/2022,3,158,5,2,168
4/16/2022,4,117,7,10,138
4/17/2022,4,171,6,10,191
4/18/2022,5,124,5,1,135
4/19/2022,4,149,5,2,160
4/20/2022,6,145,8,13,172
4/21/2022,4,131,3,7,145
4/22/2022,6,161,3,7,177
4/23/2022,3,114,4,4,125
4/24/2022,6,109,4,10,129
4/25/2022,8,108,4,10,130
4/26/2022,6,127,5,1,139
4/27/2022,8,137,2,10,157
4/28/2022,4,174,7,5,190
4/29/2022,7,161,7,1,176
4/30/2022,3,115,6,12,136
5/1/2022,8,101,3,0,112
5/2/2022,5,154,8,13,180
5/3/2022,3,119,3,3,128
5/4/2022,6,108,4,1,119
5/5/2022,6,126,8,10,150
5/6/2022,2,100,2,8,112
5/7/2022,6,99,8,3,116
5/8/2022,8,158,5,10,181
5/9/2022,4,161,6,8,179
5/10/2022,2,96,7,8,113
5/11/2022,6,108,7,2,123
5/12/2022,7,160,2,11,180
5/13/2022,3,103,7,13,126
5/14/2022,6,160,5,10,181
5/15/2022,4,156,3,9,172
5/16/2022,3,162,4,8,177
5/17/2022,4,130,2,8,144
5/18/2022,3,132,7,12,154
5/19/2022,5,118,2,11,136
5/20/2022,3,166,5,10,184
5/21/2022,6,119,5,9,139
5/22/2022,2,101,7,11,121
5/23/2022,5,143,5,7,160
5/24/2022,7,165,5,2,179
5/25/2022,4,145,5,2,156
5/26/2022,4,142,8,5,159
5/27/2022,3,126,4,0,133
5/28/2022,5,153,5,3,166
5/29/2022,7,157,3,1,168
5/30/2022,7,160,4,11,182
5/31/2022,6,129,3,12,150
6/1/2022,5,159,6,3,173
6/2/2022,7,164,8,6,185
6/3/2022,3,95,4,13,115
6/4/2022,4,173,5,12,194
6/5/2022,3,114,8,11,136
6/6/2022,2,173,3,7,185
6/7/2022,3,162,8,12,185
6/8/2022,7,116,3,2,128
6/9/2022,2,143,5,4,154
6/10/2022,3,132,6,12,153
6/11/2022,8,171,3,4,186
6/12/2022,5,165,4,7,181
6/13/2022,5,98,7,12,122
6/14/2022,7,107,3,11,128
6/15/2022,8,161,2,2,173
6/16/2022,6,99,4,11,120
6/17/2022,8,169,7,11,195
6/18/2022,8,114,5,10,137
6/19/2022,6,150,7,10,173
6/20/2022,5,159,3,3,170
6/21/2022,8,132,2,1,143
6/22/2022,7,172,5,8,192
6/23/2022,8,160,8,5,181
6/24/2022,5,159,5,7,176
6/25/2022,2,97,4,4,107
6/26/2022,5,140,7,8,160
6/27/2022,3,163,3,2,171
6/28/2022,7,104,5,11,127
6/29/2022,3,134,8,6,151
6/30/2022,3,111,5,3,122
7/1/2022,2,146,4,2,154
7/2/2022,7,159,5,11,182
7/3/2022,7,121,7,10,145
7/4/2022,3,164,3,12,182
7/5/2022,4,115,4,11,134
7/6/2022,8,117,5,11,141
7/7/2022,5,99,7,1,112
7/8/2022,2,117,5,7,131
7/9/2022,2,149,4,10,165
7/10/2022,8,173,7,10,198
7/11/2022,4,161,8,6,179
7/12/2022,6,165,6,3,180
7/13/2022,6,106,7,0,119
7/14/2022,8,100,5,7,120
7/15/2022,6,161,6,2,175
7/16/2022,6,163,7,9,185
7/17/2022,2,131,4,7,144
7/18/2022,5,163,8,10,186
7/19/2022,3,129,6,8,146
7/20/2022,7,100,8,3,118
7/21/2022,2,162,2,6,172
7/22/2022,3,95,3,8,109
7/23/2022,6,133,5,13,157
7/24/2022,4,117,6,13,140
7/25/2022,2,163,4,5,174
7/26/2022,5,107,8,1,121
7/27/2022,2,175,3,12,192
7/28/2022,4,112,7,10,133
7/29/2022,4,100,7,13,124
7/30/2022,4,116,7,8,135
7/31/2022,7,127,7,9,150
8/1/2022,2,109,7,3,121
8/2/2022,8,151,5,3,167
8/3/2022,3,99,3,3,108
8/4/2022,2,133,8,10,153
8/5/2022,5,134,4,2,145
8/6/2022,6,151,8,10,175
8/7/2022,6,152,2,7,167
8/8/2022,8,170,2,1,181
8/9/2022,4,109,4,3,120
8/10/2022,4,169,5,3,181
8/11/2022,4,106,6,3,119
8/12/2022,8,175,2,2,187
8/13/2022,3,149,7,4,163
8/14/2022,5,143,7,9,164
8/15/2022,5,102,2,7,116
8/16/2022,2,170,4,10,186
8/17/2022,4,136,3,8,151
8/18/2022,5,123,4,1,133
8/19/2022,5,156,5,6,172
8/20/2022,8,145,7,3,163
8/21/2022,8,104,7,7,126
8/22/2022,5,133,3,13,154
8/23/2022,6,175,7,13,201
8/24/2022,2,144,7,0,153
8/25/2022,7,124,3,8,142
8/26/2022,4,111,5,4,124
8/27/2022,5,155,7,4,171
8/28/2022,6,150,7,2,165
8/29/2022,7,129,3,1,140
8/30/2022,2,174,4,12,192
8/31/2022,2,132,3,4,141
9/1/2022,5,171,4,11,191
9/2/2022,4,149,3,12,168
9/3/2022,2,115,5,2,124
9/4/2022,5,168,8,2,183
9/5/2022,8,138,8,6,160
9/6/2022,6,121,2,9,138
9/7/2022,7,122,7,0,136
9/8/2022,2,150,6,1,159
9/9/2022,3,121,8,3,135
9/10/2022,5,160,4,8,177
9/11/2022,4,125,8,5,142
9/12/2022,2,155,2,7,166
9/13/2022,4,96,3,13,116
9/14/2022,3,138,8,10,159
9/15/2022,8,124,6,11,149
9/16/2022,4,133,7,9,153
9/17/2022,4,151,2,4,161
9/18/2022,4,154,6,1,165
9/19/2022,7,95,2,10,114
9/20/2022,8,121,5,1,135
9/21/2022,7,165,7,12,191
9/22/2022,4,137,4,9,154
9/23/2022,6,122,4,4,136
9/24/2022,6,117,5,2,130
9/25/2022,5,106,4,1,116
9/26/2022,6,123,4,1,134
9/27/2022,3,157,4,2,166
9/28/2022,4,175,6,5,190
9/29/2022,2,121,3,8,134
9/30/2022,4,117,3,11,135
10/1/2022,3,117,2,11,133
10/2/2022,3,143,7,2,155
10/3/2022,6,170,8,12,196
10/4/2022,4,157,5,5,171
10/5/2022,2,144,4,2,152
10/6/2022,4,143,8,6,161
10/7/2022,4,146,2,5,157
10/8/2022,4,114,2,1,121
10/9/2022,6,132,5,3,146
10/10/2022,4,139,6,9,158
10/11/2022,2,116,5,5,128
10/12/2022,3,166,2,12,183
10/13/2022,7,146,7,3,163
10/14/2022,8,174,4,13,199
10/15/2022,5,116,5,4,130
10/16/2022,4,104,4,2,114
10/17/2022,5,135,2,10,152
10/18/2022,2,142,4,10,158
10/19/2022,2,99,8,2,111
10/20/2022,6,122,3,4,135
10/21/2022,4,148,8,1,161
10/22/2022,4,150,8,6,168
10/23/2022,3,106,6,13,128
10/24/2022,4,145,3,1,153
10/25/2022,5,131,2,5,143
10/26/2022,4,132,7,4,147
10/27/2022,3,109,8,7,127
10/28/2022,8,99,2,3,112
10/29/2022,5,109,7,1,122
10/30/2022,6,157,8,2,173
10/31/2022,2,100,3,3,108
11/1/2022,2,153,8,8,171
11/2/2022,6,126,5,11,148
11/3/2022,7,120,2,6,135
11/4/2022,5,157,4,4,170
11/5/2022,6,122,3,9,140
11/6/2022,5,173,8,5,191
11/7/2022,2,106,6,4,118
11/8/2022,2,140,7,10,159
11/9/2022,3,167,5,13,188
11/10/2022,3,125,6,4,138
11/11/2022,6,123,3,8,140
11/12/2022,4,115,3,7,129
11/13/2022,5,112,5,1,123
11/14/2022,8,125,8,6,147
11/15/2022,5,116,4,5,130
11/16/2022,5,147,5,0,157
11/17/2022,6,143,4,10,163
11/18/2022,4,137,3,2,146
11/19/2022,6,97,7,3,113
11/20/2022,6,145,3,13,167
11/21/2022,5,104,7,5,121
11/22/2022,8,120,5,10,143
11/23/2022,3,165,2,3,173
11/24/2022,8,148,3,10,169
11/25/2022,6,142,3,9,160
11/26/2022,4,142,8,12,166
11/27/2022,6,137,2,11,156
11/28/2022,6,127,6,5,144
11/29/2022,6,95,6,7,114
11/30/2022,2,107,6,4,119
12/1/2022,8,169,7,6,190
12/2/2022,4,106,5,10,125
12/3/2022,7,121,7,7,142
12/4/2022,3,157,7,2,169
12/5/2022,5,127,4,5,141
12/6/2022,7,98,3,13,121
12/7/2022,2,149,8,10,169
12/8/2022,5,130,5,1,141
12/9/2022,7,131,2,6,146
12/10/2022,6,126,3,1,136
12/11/2022,6,173,3,11,193
12/12/2022,8,148,4,8,168
12/13/2022,6,174,3,5,188
12/14/2022,4,162,8,13,187
12/15/2022,2,159,8,11,180
12/16/2022,8,103,8,11,130
12/17/2022,5,123,5,8,141
12/18/2022,7,104,6,3,120
12/19/2022,4,141,8,6,159
12/20/2022,3,141,5,10,159
12/21/2022,8,119,4,9,140
12/22/2022,4,143,6,13,166
12/23/2022,8,107,4,6,125
12/24/2022,2,96,2,9,109
12/25/2022,7,107,4,13,131
12/26/2022,7,118,3,2,130
12/27/2022,3,163,5,5,176
12/28/2022,8,115,3,8,134
12/29/2022,7,114,8,10,139
12/30/2022,5,137,5,6,153
12/31/2022,4,168,5,5,182
