admit_date,flu,covid,malaria,others,total_total_count
1/1/1970,25,0,17,30,72
1/2/1970,32,0,18,25,75
1/3/1970,26,0,26,19,71
1/4/1970,25,0,26,6,57
1/5/1970,22,0,15,19,56
1/6/1970,17,0,19,25,61
1/7/1970,32,0,24,25,81
1/8/1970,26,0,14,15,55
1/9/1970,25,0,28,21,74
1/10/1970,20,0,20,13,53
1/11/1970,22,0,21,7,50
1/12/1970,25,0,23,24,72
1/13/1970,22,0,15,17,54
1/14/1970,31,0,15,14,60
1/15/1970,27,0,17,25,69
1/16/1970,36,0,26,21,83
1/17/1970,19,0,25,28,72
1/18/1970,20,0,14,19,53
1/19/1970,19,0,11,30,60
1/20/1970,20,0,18,34,72
1/21/1970,21,0,15,25,61
1/22/1970,22,0,16,10,48
1/23/1970,26,0,15,29,70
1/24/1970,22,0,18,22,62
1/25/1970,17,0,19,12,48
1/26/1970,30,0,24,15,69
1/27/1970,28,0,24,10,62
1/28/1970,12,0,29,35,76
1/29/1970,32,0,15,29,76
1/30/1970,29,0,18,24,71
1/31/1970,19,0,13,12,44
2/1/1970,24,0,17,25,66
2/2/1970,22,0,7,8,37
2/3/1970,14,0,18,15,47
2/4/1970,27,0,24,17,68
2/5/1970,23,0,10,17,50
2/6/1970,16,0,23,23,62
2/7/1970,24,0,19,12,55
2/8/1970,31,0,19,19,69
2/9/1970,27,0,15,27,69
2/10/1970,18,0,15,27,60
2/11/1970,24,0,20,15,59
2/12/1970,29,0,16,31,76
2/13/1970,23,0,22,19,64
2/14/1970,25,0,23,21,69
2/15/1970,23,0,28,17,68
2/16/1970,15,0,20,16,51
2/17/1970,31,0,22,18,71
2/18/1970,22,0,23,17,62
2/19/1970,25,0,24,26,75
2/20/1970,18,0,13,26,57
2/21/1970,22,0,26,22,70
2/22/1970,25,0,16,16,57
2/23/1970,30,0,22,15,67
2/24/1970,33,0,10,14,57
2/25/1970,26,0,21,24,71
2/26/1970,22,0,12,21,55
2/27/1970,24,0,24,14,62
2/28/1970,32,0,23,21,76
3/1/1970,21,0,12,27,60
3/2/1970,28,0,21,14,63
3/3/1970,16,0,25,13,54
3/4/1970,24,0,21,31,76
3/5/1970,24,0,18,19,61
3/6/1970,35,0,22,19,76
3/7/1970,20,0,23,22,65
3/8/1970,19,0,21,17,57
3/9/1970,25,0,17,22,64
3/10/1970,23,0,25,6,54
3/11/1970,18,0,8,27,53
3/12/1970,24,0,12,27,63
3/13/1970,19,0,27,20,66
3/14/1970,24,0,23,16,63
3/15/1970,21,0,30,19,70
3/16/1970,33,0,26,24,83
3/17/1970,14,0,15,12,41
3/18/1970,22,0,24,28,74
3/19/1970,22,0,20,25,67
3/20/1970,23,0,11,6,40
3/21/1970,13,0,29,24,66
3/22/1970,35,0,19,29,83
3/23/1970,28,0,28,32,88
3/24/1970,27,0,14,34,75
3/25/1970,27,0,26,23,76
3/26/1970,19,0,18,22,59
3/27/1970,24,0,23,30,77
3/28/1970,24,0,22,14,60
3/29/1970,16,0,23,12,51
3/30/1970,27,0,18,17,62
3/31/1970,29,0,24,21,74
4/1/1970,22,0,18,14,54
4/2/1970,28,0,12,20,60
4/3/1970,25,0,21,27,73
4/4/1970,26,0,15,13,54
4/5/1970,28,0,23,28,79
4/6/1970,27,0,15,9,51
4/7/1970,22,0,16,19,57
4/8/1970,30,0,14,22,66
4/9/1970,29,0,14,2,45
4/10/1970,28,0,22,18,68
4/11/1970,29,0,15,12,56
4/12/1970,27,0,18,18,63
4/13/1970,26,0,13,23,62
4/14/1970,29,0,22,17,68
4/15/1970,24,0,26,18,68
4/16/1970,24,0,20,14,58
4/17/1970,26,0,10,25,61
4/18/1970,18,0,21,25,64
4/19/1970,26,0,11,30,67
4/20/1970,19,0,16,19,54
4/21/1970,18,0,14,25,57
4/22/1970,30,0,21,31,82
4/23/1970,30,0,17,4,51
4/24/1970,17,0,13,17,47
4/25/1970,21,0,21,12,54
4/26/1970,18,0,27,38,83
4/27/1970,28,0,27,25,80
4/28/1970,19,0,29,30,78
4/29/1970,28,0,10,31,69
4/30/1970,27,0,21,15,63
5/1/1970,23,0,29,29,81
5/2/1970,26,0,23,18,67
5/3/1970,29,0,21,15,65
5/4/1970,15,0,16,26,57
5/5/1970,22,0,21,33,76
5/6/1970,13,0,27,27,67
5/7/1970,28,0,10,20,58
5/8/1970,21,0,27,17,65
5/9/1970,28,0,15,18,61
5/10/1970,22,0,27,18,67
5/11/1970,17,0,25,36,78
5/12/1970,24,0,27,26,77
5/13/1970,22,0,27,23,72
5/14/1970,29,0,14,18,61
5/15/1970,24,0,18,20,62
5/16/1970,23,0,12,18,53
5/17/1970,27,0,25,26,78
5/18/1970,30,0,17,12,59
5/19/1970,23,0,22,18,63
5/20/1970,27,0,12,21,60
5/21/1970,34,0,20,21,75
5/22/1970,22,0,17,24,63
5/23/1970,28,0,19,13,60
5/24/1970,17,0,11,28,56
5/25/1970,24,0,16,10,50
5/26/1970,32,0,26,17,75
5/27/1970,26,0,21,21,68
5/28/1970,27,0,17,13,57
5/29/1970,26,0,19,33,78
5/30/1970,28,0,24,14,66
5/31/1970,25,0,12,19,56
6/1/1970,19,0,23,13,55
6/2/1970,27,0,21,19,67
6/3/1970,25,0,17,24,66
6/4/1970,28,0,19,30,77
6/5/1970,30,0,30,15,75
6/6/1970,23,0,21,19,63
6/7/1970,27,0,14,4,45
6/8/1970,23,0,18,32,73
6/9/1970,22,0,21,22,65
6/10/1970,26,0,14,37,77
6/11/1970,27,0,24,35,86
6/12/1970,18,0,20,9,47
6/13/1970,19,0,22,23,64
6/14/1970,25,0,7,7,39
6/15/1970,23,0,21,15,59
6/16/1970,31,0,23,25,79
6/17/1970,29,0,21,25,75
6/18/1970,18,0,12,33,63
6/19/1970,17,0,16,27,60
6/20/1970,16,0,30,11,57
6/21/1970,27,0,10,29,66
6/22/1970,23,0,27,15,65
6/23/1970,23,0,18,18,59
6/24/1970,24,0,23,6,53
6/25/1970,24,0,19,28,71
6/26/1970,15,0,16,30,61
6/27/1970,18,0,20,23,61
6/28/1970,24,0,14,12,50
6/29/1970,23,0,23,4,50
6/30/1970,19,0,29,20,68
7/1/1970,26,0,11,22,59
7/2/1970,23,0,25,19,67
7/3/1970,25,0,21,23,69
7/4/1970,28,0,17,10,55
7/5/1970,28,0,12,20,60
7/6/1970,22,0,24,24,70
7/7/1970,30,0,19,22,71
7/8/1970,26,0,15,18,59
7/9/1970,20,0,22,25,67
7/10/1970,21,0,16,20,57
7/11/1970,34,0,23,17,74
7/12/1970,27,0,18,22,67
7/13/1970,23,0,16,19,58
7/14/1970,16,0,22,33,71
7/15/1970,25,0,26,27,78
7/16/1970,23,0,17,18,58
7/17/1970,21,0,17,28,66
7/18/1970,17,0,22,24,63
7/19/1970,13,0,25,9,47
7/20/1970,15,0,14,26,55
7/21/1970,25,0,15,24,64
7/22/1970,26,0,9,5,40
7/23/1970,16,0,17,16,49
7/24/1970,24,0,19,12,55
7/25/1970,29,0,27,6,62
7/26/1970,19,0,20,25,64
7/27/1970,21,0,33,11,65
7/28/1970,27,0,25,23,75
7/29/1970,29,0,18,12,59
7/30/1970,17,0,22,16,55
7/31/1970,18,0,24,15,57
8/1/1970,15,0,16,29,60
8/2/1970,28,0,19,12,59
8/3/1970,23,0,27,29,79
8/4/1970,19,0,9,21,49
8/5/1970,24,0,17,9,50
8/6/1970,26,0,13,20,59
8/7/1970,28,0,26,28,82
8/8/1970,23,0,19,11,53
8/9/1970,29,0,17,23,69
8/10/1970,30,0,9,25,64
8/11/1970,19,0,24,13,56
8/12/1970,32,0,17,32,81
8/13/1970,19,0,25,13,57
8/14/1970,27,0,22,18,67
8/15/1970,22,0,22,21,65
8/16/1970,13,0,8,17,38
8/17/1970,17,0,19,19,55
8/18/1970,15,0,15,21,51
8/19/1970,32,0,17,18,67
8/20/1970,21,0,20,12,53
8/21/1970,33,0,9,19,61
8/22/1970,27,0,23,22,72
8/23/1970,26,0,20,13,59
8/24/1970,20,0,25,22,67
8/25/1970,27,0,13,25,65
8/26/1970,23,0,22,23,68
8/27/1970,19,0,25,18,62
8/28/1970,20,0,25,20,65
8/29/1970,30,0,16,17,63
8/30/1970,23,0,28,20,71
8/31/1970,18,0,9,11,38
9/1/1970,15,0,9,15,39
9/2/1970,27,0,14,28,69
9/3/1970,23,0,16,11,50
9/4/1970,27,0,26,2,55
9/5/1970,23,0,26,25,74
9/6/1970,23,0,31,10,64
9/7/1970,22,0,21,23,66
9/8/1970,25,0,24,21,70
9/9/1970,20,0,13,17,50
9/10/1970,29,0,9,21,59
9/11/1970,16,0,26,33,75
9/12/1970,25,0,18,13,56
9/13/1970,27,0,23,19,69
9/14/1970,26,0,16,20,62
9/15/1970,34,0,23,30,87
9/16/1970,23,0,24,21,68
9/17/1970,19,0,23,28,70
9/18/1970,20,0,23,22,65
9/19/1970,25,0,12,22,59
9/20/1970,17,0,20,28,65
9/21/1970,18,0,17,26,61
9/22/1970,22,0,11,24,57
9/23/1970,23,0,13,21,57
9/24/1970,26,0,16,23,65
9/25/1970,16,0,20,29,65
9/26/1970,28,0,12,15,55
9/27/1970,22,0,27,15,64
9/28/1970,24,0,22,23,69
9/29/1970,16,0,27,15,58
9/30/1970,12,0,17,18,47
10/1/1970,27,0,15,8,50
10/2/1970,24,0,12,30,66
10/3/1970,24,0,25,16,65
10/4/1970,30,0,14,19,63
10/5/1970,25,0,25,29,79
10/6/1970,26,0,19,18,63
10/7/1970,23,0,16,25,64
10/8/1970,28,0,16,14,58
10/9/1970,29,0,22,31,82
10/10/1970,21,0,26,10,57
10/11/1970,24,0,23,19,66
10/12/1970,22,0,23,33,78
10/13/1970,27,0,17,26,70
10/14/1970,29,0,19,33,81
10/15/1970,26,0,20,19,65
10/16/1970,28,0,22,12,62
10/17/1970,19,0,26,14,59
10/18/1970,17,0,20,36,73
10/19/1970,29,0,32,15,76
10/20/1970,25,0,19,15,59
10/21/1970,23,0,26,16,65
10/22/1970,26,0,14,19,59
10/23/1970,26,0,20,18,64
10/24/1970,26,0,24,18,68
10/25/1970,22,0,20,25,67
10/26/1970,12,0,17,30,59
10/27/1970,27,0,12,25,64
10/28/1970,24,0,20,16,60
10/29/1970,19,0,12,18,49
10/30/1970,25,0,14,23,62
10/31/1970,16,0,16,16,48
11/1/1970,23,0,30,32,85
11/2/1970,21,0,18,11,50
11/3/1970,30,0,21,10,61
11/4/1970,26,0,19,20,65
11/5/1970,31,0,20,19,70
11/6/1970,28,0,19,27,74
11/7/1970,17,0,18,21,56
11/8/1970,18,0,17,31,66
11/9/1970,23,0,33,16,72
11/10/1970,21,0,31,32,84
11/11/1970,19,0,21,27,67
11/12/1970,25,0,28,8,61
11/13/1970,13,0,19,12,44
11/14/1970,23,0,25,30,78
11/15/1970,22,0,22,21,65
11/16/1970,26,0,16,27,69
11/17/1970,25,0,18,18,61
11/18/1970,34,0,12,26,72
11/19/1970,24,0,25,27,76
11/20/1970,13,0,15,25,53
11/21/1970,28,0,14,12,54
11/22/1970,19,0,15,25,59
11/23/1970,28,0,21,24,73
11/24/1970,28,0,26,23,77
11/25/1970,17,0,21,15,53
11/26/1970,21,0,26,30,77
11/27/1970,27,0,26,14,67
11/28/1970,29,0,22,22,73
11/29/1970,30,0,23,10,63
11/30/1970,17,0,23,23,63
12/1/1970,21,0,23,5,49
12/2/1970,19,0,30,24,73
12/3/1970,22,0,21,22,65
12/4/1970,26,0,17,25,68
12/5/1970,15,0,18,30,63
12/6/1970,30,0,17,19,66
12/7/1970,23,0,26,4,53
12/8/1970,14,0,27,11,52
12/9/1970,30,0,15,13,58
12/10/1970,25,0,17,19,61
12/11/1970,18,0,22,26,66
12/12/1970,18,0,14,21,53
12/13/1970,15,0,13,23,51
12/14/1970,27,0,10,25,62
12/15/1970,31,0,16,21,68
12/16/1970,14,0,20,15,49
12/17/1970,23,0,15,21,59
12/18/1970,22,0,21,33,76
12/19/1970,29,0,29,17,75
12/20/1970,26,0,16,29,71
12/21/1970,23,0,28,24,75
12/22/1970,23,0,28,16,67
12/23/1970,15,0,17,29,61
12/24/1970,27,0,20,20,67
12/25/1970,24,0,7,19,50
12/26/1970,26,0,17,23,66
12/27/1970,22,0,17,22,61
12/28/1970,20,0,22,5,47
12/29/1970,26,0,15,20,61
12/30/1970,22,0,13,33,68
12/31/1970,21,0,28,23,72
1/1/1971,23,0,11,12,46
1/2/1971,21,0,25,12,58
1/3/1971,25,0,26,15,66
1/4/1971,26,0,13,18,57
1/5/1971,23,0,14,26,63
1/6/1971,30,0,19,16,65
1/7/1971,21,0,12,16,49
1/8/1971,13,0,12,25,50
1/9/1971,24,0,17,23,64
1/10/1971,19,0,17,7,43
1/11/1971,30,0,13,30,73
1/12/1971,21,0,22,13,56
1/13/1971,31,0,16,19,66
1/14/1971,28,0,15,31,74
1/15/1971,24,0,19,13,56
1/16/1971,24,0,32,19,75
1/17/1971,25,0,12,12,49
1/18/1971,22,0,27,23,72
1/19/1971,13,0,12,3,28
1/20/1971,18,0,10,26,54
1/21/1971,14,0,23,21,58
1/22/1971,26,0,23,28,77
1/23/1971,21,0,28,21,70
1/24/1971,27,0,17,20,64
1/25/1971,23,0,12,22,57
1/26/1971,24,0,21,18,63
1/27/1971,19,0,14,25,58
1/28/1971,25,0,27,20,72
1/29/1971,27,0,11,16,54
1/30/1971,17,0,9,25,51
1/31/1971,25,0,24,21,70
2/1/1971,25,0,19,19,63
2/2/1971,33,0,14,15,62
2/3/1971,19,0,19,6,44
2/4/1971,27,0,21,17,65
2/5/1971,22,0,17,18,57
2/6/1971,32,0,27,9,68
2/7/1971,28,0,16,18,62
2/8/1971,26,0,24,14,64
2/9/1971,20,0,24,29,73
2/10/1971,25,0,26,22,73
2/11/1971,24,0,18,20,62
2/12/1971,23,0,24,15,62
2/13/1971,30,0,18,13,61
2/14/1971,25,0,21,36,82
2/15/1971,18,0,16,13,47
2/16/1971,23,0,13,31,67
2/17/1971,21,0,25,23,69
2/18/1971,23,0,19,13,55
2/19/1971,28,0,11,18,57
2/20/1971,32,0,23,24,79
2/21/1971,28,0,15,24,67
2/22/1971,13,0,29,28,70
2/23/1971,22,0,13,22,57
2/24/1971,23,0,23,20,66
2/25/1971,15,0,22,20,57
2/26/1971,16,0,25,16,57
2/27/1971,26,0,15,30,71
2/28/1971,14,0,14,33,61
3/1/1971,27,0,25,21,73
3/2/1971,22,0,21,28,71
3/3/1971,22,0,13,17,52
3/4/1971,34,0,9,15,58
3/5/1971,21,0,22,10,53
3/6/1971,27,0,21,21,69
3/7/1971,17,0,16,22,55
3/8/1971,28,0,25,15,68
3/9/1971,15,0,16,25,56
3/10/1971,19,0,19,19,57
3/11/1971,15,0,21,24,60
3/12/1971,20,0,20,32,72
3/13/1971,27,0,21,11,59
3/14/1971,19,0,14,16,49
3/15/1971,18,0,9,11,38
3/16/1971,20,0,15,33,68
3/17/1971,19,0,8,27,54
3/18/1971,16,0,26,1,43
3/19/1971,16,0,13,18,47
3/20/1971,19,0,25,27,71
3/21/1971,29,0,30,11,70
3/22/1971,19,0,18,15,52
3/23/1971,24,0,17,23,64
3/24/1971,23,0,18,19,60
3/25/1971,12,0,13,29,54
3/26/1971,23,0,17,9,49
3/27/1971,27,0,19,22,68
3/28/1971,20,0,12,30,62
3/29/1971,21,0,19,26,66
3/30/1971,23,0,16,19,58
3/31/1971,18,0,22,24,64
4/1/1971,24,0,18,25,67
4/2/1971,29,0,23,26,78
4/3/1971,29,0,16,9,54
4/4/1971,31,0,17,18,66
4/5/1971,26,0,23,19,68
4/6/1971,25,0,11,21,57
4/7/1971,20,0,11,12,43
4/8/1971,24,0,14,25,63
4/9/1971,21,0,19,31,71
4/10/1971,22,0,18,17,57
4/11/1971,30,0,24,18,72
4/12/1971,24,0,24,18,66
4/13/1971,25,0,17,18,60
4/14/1971,26,0,22,23,71
4/15/1971,25,0,26,30,81
4/16/1971,27,0,12,32,71
4/17/1971,25,0,15,34,74
4/18/1971,22,0,22,14,58
4/19/1971,24,0,21,27,72
4/20/1971,24,0,21,32,77
4/21/1971,30,0,15,4,49
4/22/1971,27,0,19,21,67
4/23/1971,27,0,9,24,60
4/24/1971,30,0,22,17,69
4/25/1971,22,0,14,20,56
4/26/1971,23,0,23,27,73
4/27/1971,21,0,14,18,53
4/28/1971,12,0,22,25,59
4/29/1971,29,0,20,13,62
4/30/1971,18,0,17,14,49
5/1/1971,26,0,26,24,76
5/2/1971,16,0,16,17,49
5/3/1971,20,0,19,33,72
5/4/1971,15,0,19,18,52
5/5/1971,27,0,13,24,64
5/6/1971,24,0,15,29,68
5/7/1971,20,0,12,17,49
5/8/1971,30,0,26,30,86
5/9/1971,19,0,25,30,74
5/10/1971,29,0,29,14,72
5/11/1971,21,0,29,17,67
5/12/1971,22,0,26,17,65
5/13/1971,19,0,29,18,66
5/14/1971,18,0,22,21,61
5/15/1971,27,0,31,21,79
5/16/1971,30,0,18,13,61
5/17/1971,30,0,17,24,71
5/18/1971,27,0,24,18,69
5/19/1971,27,0,27,23,77
5/20/1971,19,0,23,14,56
5/21/1971,26,0,13,29,68
5/22/1971,22,0,25,19,66
5/23/1971,25,0,27,27,79
5/24/1971,13,0,20,21,54
5/25/1971,19,0,14,15,48
5/26/1971,22,0,21,11,54
5/27/1971,19,0,21,15,55
5/28/1971,18,0,23,23,64
5/29/1971,27,0,16,32,75
5/30/1971,30,0,10,20,60
5/31/1971,26,0,22,11,59
6/1/1971,23,0,14,24,61
6/2/1971,23,0,15,18,56
6/3/1971,32,0,14,11,57
6/4/1971,22,0,13,23,58
6/5/1971,27,0,33,17,77
6/6/1971,25,0,27,17,69
6/7/1971,16,0,23,25,64
6/8/1971,24,0,24,23,71
6/9/1971,23,0,21,5,49
6/10/1971,14,0,15,13,42
6/11/1971,11,0,13,21,45
6/12/1971,23,0,21,11,55
6/13/1971,27,0,20,11,58
6/14/1971,21,0,24,12,57
6/15/1971,24,0,30,9,63
6/16/1971,31,0,19,15,65
6/17/1971,21,0,17,31,69
6/18/1971,29,0,15,11,55
6/19/1971,34,0,27,3,64
6/20/1971,20,0,12,16,48
6/21/1971,24,0,18,17,59
6/22/1971,16,0,23,17,56
6/23/1971,27,0,23,24,74
6/24/1971,16,0,13,22,51
6/25/1971,23,0,31,24,78
6/26/1971,28,0,20,12,60
6/27/1971,21,0,18,19,58
6/28/1971,16,0,12,21,49
6/29/1971,30,0,27,18,75
6/30/1971,15,0,25,25,65
7/1/1971,15,0,29,29,73
7/2/1971,26,0,21,23,70
7/3/1971,25,0,20,17,62
7/4/1971,18,0,28,25,71
7/5/1971,20,0,17,31,68
7/6/1971,13,0,24,24,61
7/7/1971,32,0,25,16,73
7/8/1971,22,0,22,28,72
7/9/1971,21,0,29,18,68
7/10/1971,23,0,15,2,40
7/11/1971,27,0,26,24,77
7/12/1971,18,0,25,29,72
7/13/1971,18,0,12,32,62
7/14/1971,20,0,26,14,60
7/15/1971,26,0,25,28,79
7/16/1971,28,0,14,11,53
7/17/1971,28,0,26,17,71
7/18/1971,21,0,20,24,65
7/19/1971,18,0,26,13,57
7/20/1971,18,0,12,19,49
7/21/1971,16,0,19,16,51
7/22/1971,24,0,20,27,71
7/23/1971,27,0,29,18,74
7/24/1971,24,0,19,13,56
7/25/1971,18,0,18,37,73
7/26/1971,27,0,12,19,58
7/27/1971,20,0,18,11,49
7/28/1971,32,0,17,20,69
7/29/1971,27,0,20,23,70
7/30/1971,17,0,19,16,52
7/31/1971,25,0,16,29,70
8/1/1971,26,0,25,9,60
8/2/1971,20,0,23,3,46
8/3/1971,20,0,23,32,75
8/4/1971,21,0,24,14,59
8/5/1971,22,0,19,32,73
8/6/1971,23,0,14,32,69
8/7/1971,30,0,11,27,68
8/8/1971,22,0,14,26,62
8/9/1971,28,0,18,25,71
8/10/1971,22,0,13,25,60
8/11/1971,18,0,27,14,59
8/12/1971,32,0,17,35,84
8/13/1971,28,0,17,28,73
8/14/1971,21,0,18,33,72
8/15/1971,29,0,25,18,72
8/16/1971,19,0,23,17,59
8/17/1971,18,0,22,16,56
8/18/1971,20,0,12,25,57
8/19/1971,24,0,26,19,69
8/20/1971,26,0,18,24,68
8/21/1971,15,0,23,15,53
8/22/1971,30,0,17,31,78
8/23/1971,24,0,21,12,57
8/24/1971,27,0,26,21,74
8/25/1971,28,0,19,18,65
8/26/1971,29,0,19,26,74
8/27/1971,27,0,23,12,62
8/28/1971,28,0,27,18,73
8/29/1971,20,0,24,18,62
8/30/1971,20,0,17,17,54
8/31/1971,22,0,23,31,76
9/1/1971,19,0,15,22,56
9/2/1971,21,0,20,4,45
9/3/1971,26,0,26,10,62
9/4/1971,19,0,27,24,70
9/5/1971,31,0,25,3,59
9/6/1971,16,0,12,12,40
9/7/1971,15,0,15,9,39
9/8/1971,23,0,15,28,66
9/9/1971,26,0,16,17,59
9/10/1971,27,0,8,26,61
9/11/1971,22,0,13,16,51
9/12/1971,21,0,22,13,56
9/13/1971,21,0,12,25,58
9/14/1971,17,0,23,24,64
9/15/1971,22,0,23,28,73
9/16/1971,21,0,18,10,49
9/17/1971,27,0,24,9,60
9/18/1971,27,0,15,27,69
9/19/1971,25,0,21,19,65
9/20/1971,29,0,24,28,81
9/21/1971,20,0,23,30,73
9/22/1971,24,0,17,18,59
9/23/1971,22,0,18,16,56
9/24/1971,28,0,32,27,87
9/25/1971,27,0,23,21,71
9/26/1971,19,0,13,32,64
9/27/1971,19,0,19,26,64
9/28/1971,27,0,30,11,68
9/29/1971,21,0,26,10,57
9/30/1971,25,0,19,25,69
10/1/1971,15,0,28,27,70
10/2/1971,20,0,23,17,60
10/3/1971,26,0,19,19,64
10/4/1971,23,0,27,30,80
10/5/1971,16,0,20,27,63
10/6/1971,24,0,20,18,62
10/7/1971,28,0,21,22,71
10/8/1971,23,0,20,20,63
10/9/1971,31,0,18,18,67
10/10/1971,28,0,17,21,66
10/11/1971,21,0,12,25,58
10/12/1971,19,0,21,32,72
10/13/1971,17,0,29,24,70
10/14/1971,25,0,17,32,74
10/15/1971,25,0,19,26,70
10/16/1971,21,0,21,8,50
10/17/1971,27,0,17,32,76
10/18/1971,24,0,18,23,65
10/19/1971,19,0,24,32,75
10/20/1971,23,0,21,21,65
10/21/1971,18,0,9,17,44
10/22/1971,29,0,20,24,73
10/23/1971,18,0,19,16,53
10/24/1971,21,0,16,17,54
10/25/1971,29,0,17,15,61
10/26/1971,20,0,28,21,69
10/27/1971,18,0,27,29,74
10/28/1971,18,0,15,22,55
10/29/1971,20,0,20,14,54
10/30/1971,24,0,17,26,67
10/31/1971,25,0,25,18,68
11/1/1971,18,0,14,17,49
11/2/1971,27,0,15,13,55
11/3/1971,16,0,21,8,45
11/4/1971,25,0,26,16,67
11/5/1971,21,0,13,21,55
11/6/1971,15,0,21,24,60
11/7/1971,23,0,14,13,50
11/8/1971,18,0,22,14,54
11/9/1971,22,0,24,25,71
11/10/1971,35,0,23,18,76
11/11/1971,24,0,20,9,53
11/12/1971,12,0,13,18,43
11/13/1971,26,0,17,26,69
11/14/1971,22,0,25,29,76
11/15/1971,20,0,17,8,45
11/16/1971,25,0,18,24,67
11/17/1971,19,0,23,19,61
11/18/1971,19,0,24,25,68
11/19/1971,26,0,15,10,51
11/20/1971,23,0,27,19,69
11/21/1971,21,0,11,14,46
11/22/1971,18,0,24,22,64
11/23/1971,25,0,30,18,73
11/24/1971,30,0,21,16,67
11/25/1971,24,0,31,26,81
11/26/1971,18,0,24,0,42
11/27/1971,26,0,19,20,65
11/28/1971,29,0,21,30,80
11/29/1971,15,0,25,25,65
11/30/1971,19,0,23,26,68
12/1/1971,19,0,30,17,66
12/2/1971,23,0,12,21,56
12/3/1971,26,0,20,32,78
12/4/1971,22,0,25,13,60
12/5/1971,28,0,19,23,70
12/6/1971,23,0,17,27,67
12/7/1971,16,0,21,22,59
12/8/1971,27,0,14,23,64
12/9/1971,26,0,24,16,66
12/10/1971,25,0,28,19,72
12/11/1971,25,0,22,16,63
12/12/1971,21,0,8,12,41
12/13/1971,28,0,21,20,69
12/14/1971,19,0,30,16,65
12/15/1971,27,0,19,24,70
12/16/1971,23,0,17,19,59
12/17/1971,17,0,29,8,54
12/18/1971,22,0,18,20,60
12/19/1971,19,0,12,9,40
12/20/1971,25,0,17,12,54
12/21/1971,27,0,19,28,74
12/22/1971,16,0,26,14,56
12/23/1971,17,0,19,19,55
12/24/1971,25,0,16,29,70
12/25/1971,30,0,23,30,83
12/26/1971,26,0,18,9,53
12/27/1971,20,0,22,23,65
12/28/1971,24,0,15,19,58
12/29/1971,25,0,23,30,78
12/30/1971,17,0,26,18,61
12/31/1971,24,0,22,17,63
1/1/1972,19,0,25,16,60
1/2/1972,29,0,15,21,65
1/3/1972,23,0,19,21,63
1/4/1972,27,0,19,19,65
1/5/1972,24,0,20,25,69
1/6/1972,19,0,22,7,48
1/7/1972,28,0,30,15,73
1/8/1972,15,0,23,22,60
1/9/1972,31,0,14,26,71
1/10/1972,11,0,21,21,53
1/11/1972,29,0,25,16,70
1/12/1972,21,0,21,31,73
1/13/1972,23,0,18,33,74
1/14/1972,24,0,29,22,75
1/15/1972,12,0,27,36,75
1/16/1972,21,0,29,14,64
1/17/1972,12,0,29,15,56
1/18/1972,25,0,25,14,64
1/19/1972,28,0,9,12,49
1/20/1972,21,0,23,19,63
1/21/1972,21,0,19,25,65
1/22/1972,26,0,18,21,65
1/23/1972,32,0,22,20,74
1/24/1972,24,0,20,18,62
1/25/1972,26,0,17,10,53
1/26/1972,15,0,17,31,63
1/27/1972,22,0,19,15,56
1/28/1972,22,0,24,26,72
1/29/1972,20,0,27,20,67
1/30/1972,23,0,14,22,59
1/31/1972,30,0,18,23,71
2/1/1972,22,0,18,16,56
2/2/1972,23,0,23,18,64
2/3/1972,18,0,22,19,59
2/4/1972,32,0,24,31,87
2/5/1972,18,0,16,11,45
2/6/1972,33,0,19,33,85
2/7/1972,21,0,19,11,51
2/8/1972,16,0,25,20,61
2/9/1972,20,0,28,24,72
2/10/1972,26,0,16,16,58
2/11/1972,18,0,28,30,76
2/12/1972,21,0,17,20,58
2/13/1972,18,0,20,26,64
2/14/1972,26,0,25,19,70
2/15/1972,30,0,28,20,78
2/16/1972,26,0,23,26,75
2/17/1972,21,0,28,14,63
2/18/1972,34,0,21,18,73
2/19/1972,30,0,25,26,81
2/20/1972,27,0,26,16,69
2/21/1972,23,0,21,14,58
2/22/1972,23,0,26,23,72
2/23/1972,33,0,18,10,61
2/24/1972,19,0,17,31,67
2/25/1972,14,0,17,24,55
2/26/1972,20,0,12,20,52
2/27/1972,25,0,14,22,61
2/28/1972,26,0,29,21,76
2/29/1972,22,0,28,19,69
3/1/1972,19,0,17,28,64
3/2/1972,15,0,27,30,72
3/3/1972,29,0,11,6,46
3/4/1972,32,0,26,15,73
3/5/1972,19,0,22,11,52
3/6/1972,19,0,15,15,49
3/7/1972,21,0,22,14,57
3/8/1972,30,0,20,22,72
3/9/1972,22,0,25,18,65
3/10/1972,15,0,19,31,65
3/11/1972,30,0,15,20,65
3/12/1972,29,0,21,22,72
3/13/1972,17,0,20,12,49
3/14/1972,26,0,25,10,61
3/15/1972,28,0,14,24,66
3/16/1972,28,0,10,23,61
3/17/1972,18,0,31,18,67
3/18/1972,30,0,16,23,69
3/19/1972,22,0,16,19,57
3/20/1972,25,0,20,26,71
3/21/1972,22,0,16,35,73
3/22/1972,28,0,19,4,51
3/23/1972,31,0,22,19,72
3/24/1972,17,0,18,30,65
3/25/1972,22,0,17,14,53
3/26/1972,19,0,17,25,61
3/27/1972,19,0,14,21,54
3/28/1972,34,0,33,3,70
3/29/1972,16,0,19,40,75
3/30/1972,22,0,28,22,72
3/31/1972,14,0,14,18,46
4/1/1972,22,0,14,16,52
4/2/1972,19,0,28,20,67
4/3/1972,22,0,18,26,66
4/4/1972,15,0,14,26,55
4/5/1972,17,0,14,26,57
4/6/1972,32,0,12,18,62
4/7/1972,25,0,17,7,49
4/8/1972,24,0,29,9,62
4/9/1972,21,0,24,24,69
4/10/1972,16,0,20,15,51
4/11/1972,25,0,18,15,58
4/12/1972,24,0,29,34,87
4/13/1972,17,0,19,6,42
4/14/1972,26,0,19,11,56
4/15/1972,29,0,18,29,76
4/16/1972,31,0,21,26,78
4/17/1972,20,0,22,21,63
4/18/1972,26,0,31,27,84
4/19/1972,22,0,23,31,76
4/20/1972,20,0,20,26,66
4/21/1972,29,0,19,20,68
4/22/1972,21,0,27,12,60
4/23/1972,19,0,27,7,53
4/24/1972,18,0,26,27,71
4/25/1972,19,0,24,15,58
4/26/1972,30,0,19,26,75
4/27/1972,21,0,28,21,70
4/28/1972,15,0,26,14,55
4/29/1972,26,0,15,30,71
4/30/1972,21,0,22,29,72
5/1/1972,20,0,24,29,73
5/2/1972,31,0,16,24,71
5/3/1972,22,0,14,14,50
5/4/1972,17,0,18,17,52
5/5/1972,24,0,16,11,51
5/6/1972,21,0,11,20,52
5/7/1972,28,0,19,21,68
5/8/1972,29,0,23,23,75
5/9/1972,22,0,25,24,71
5/10/1972,29,0,23,15,67
5/11/1972,20,0,19,9,48
5/12/1972,29,0,26,27,82
5/13/1972,21,0,23,17,61
5/14/1972,26,0,23,13,62
5/15/1972,31,0,17,8,56
5/16/1972,16,0,23,22,61
5/17/1972,29,0,29,13,71
5/18/1972,21,0,23,22,66
5/19/1972,21,0,11,19,51
5/20/1972,26,0,26,18,70
5/21/1972,32,0,12,24,68
5/22/1972,21,0,28,23,72
5/23/1972,21,0,16,18,55
5/24/1972,22,0,11,13,46
5/25/1972,19,0,21,17,57
5/26/1972,26,0,24,13,63
5/27/1972,27,0,30,16,73
5/28/1972,22,0,18,22,62
5/29/1972,13,0,21,9,43
5/30/1972,23,0,15,19,57
5/31/1972,25,0,16,12,53
6/1/1972,26,0,15,27,68
6/2/1972,18,0,20,21,59
6/3/1972,16,0,14,19,49
6/4/1972,28,0,21,5,54
6/5/1972,14,0,21,18,53
6/6/1972,28,0,26,23,77
6/7/1972,17,0,11,24,52
6/8/1972,31,0,19,22,72
6/9/1972,29,0,21,27,77
6/10/1972,20,0,16,15,51
6/11/1972,25,0,19,8,52
6/12/1972,24,0,24,18,66
6/13/1972,30,0,28,26,84
6/14/1972,25,0,32,22,79
6/15/1972,19,0,27,25,71
6/16/1972,20,0,10,18,48
6/17/1972,20,0,18,13,51
6/18/1972,30,0,23,19,72
6/19/1972,17,0,22,29,68
6/20/1972,21,0,17,18,56
6/21/1972,22,0,21,30,73
6/22/1972,21,0,21,22,64
6/23/1972,20,0,17,16,53
6/24/1972,24,0,15,15,54
6/25/1972,24,0,25,15,64
6/26/1972,15,0,12,19,46
6/27/1972,23,0,22,18,63
6/28/1972,20,0,20,13,53
6/29/1972,25,0,9,7,41
6/30/1972,26,0,26,23,75
7/1/1972,28,0,17,27,72
7/2/1972,22,0,20,7,49
7/3/1972,29,0,27,27,83
7/4/1972,27,0,15,26,68
7/5/1972,12,0,22,17,51
7/6/1972,24,0,15,25,64
7/7/1972,23,0,16,13,52
7/8/1972,22,0,22,17,61
7/9/1972,26,0,22,23,71
7/10/1972,18,0,14,29,61
7/11/1972,14,0,21,13,48
7/12/1972,33,0,21,22,76
7/13/1972,16,0,18,0,34
7/14/1972,18,0,14,27,59
7/15/1972,24,0,13,14,51
7/16/1972,30,0,20,22,72
7/17/1972,15,0,16,25,56
7/18/1972,28,0,29,9,66
7/19/1972,22,0,15,20,57
7/20/1972,12,0,15,14,41
7/21/1972,14,0,22,10,46
7/22/1972,25,0,17,9,51
7/23/1972,19,0,10,13,42
7/24/1972,19,0,24,15,58
7/25/1972,13,0,12,22,47
7/26/1972,28,0,20,18,66
7/27/1972,17,0,21,19,57
7/28/1972,16,0,17,21,54
7/29/1972,18,0,17,26,61
7/30/1972,29,0,16,18,63
7/31/1972,24,0,27,27,78
8/1/1972,19,0,18,29,66
8/2/1972,24,0,21,28,73
8/3/1972,15,0,12,27,54
8/4/1972,24,0,16,32,72
8/5/1972,23,0,19,15,57
8/6/1972,19,0,28,20,67
8/7/1972,28,0,16,28,72
8/8/1972,21,0,26,16,63
8/9/1972,28,0,29,19,76
8/10/1972,21,0,23,15,59
8/11/1972,26,0,19,11,56
8/12/1972,24,0,23,10,57
8/13/1972,21,0,16,25,62
8/14/1972,19,0,23,20,62
8/15/1972,17,0,25,22,64
8/16/1972,17,0,23,15,55
8/17/1972,30,0,23,24,77
8/18/1972,23,0,18,25,66
8/19/1972,26,0,18,25,69
8/20/1972,25,0,12,21,58
8/21/1972,23,0,25,15,63
8/22/1972,30,0,18,19,67
8/23/1972,18,0,26,35,79
8/24/1972,26,0,16,30,72
8/25/1972,21,0,21,16,58
8/26/1972,27,0,18,26,71
8/27/1972,19,0,19,5,43
8/28/1972,29,0,21,25,75
8/29/1972,27,0,24,14,65
8/30/1972,29,0,16,9,54
8/31/1972,21,0,20,10,51
9/1/1972,31,0,20,23,74
9/2/1972,12,0,19,8,39
9/3/1972,30,0,18,9,57
9/4/1972,27,0,21,15,63
9/5/1972,32,0,9,19,60
9/6/1972,18,0,26,40,84
9/7/1972,29,0,24,29,82
9/8/1972,30,0,23,12,65
9/9/1972,26,0,22,25,73
9/10/1972,23,0,21,16,60
9/11/1972,15,0,24,16,55
9/12/1972,26,0,23,22,71
9/13/1972,22,0,18,24,64
9/14/1972,29,0,23,30,82
9/15/1972,29,0,15,17,61
9/16/1972,28,0,23,32,83
9/17/1972,24,0,19,29,72
9/18/1972,22,0,13,26,61
9/19/1972,25,0,11,22,58
9/20/1972,26,0,16,39,81
9/21/1972,24,0,18,17,59
9/22/1972,20,0,16,21,57
9/23/1972,23,0,13,17,53
9/24/1972,16,0,29,29,74
9/25/1972,34,0,16,23,73
9/26/1972,25,0,34,11,70
9/27/1972,22,0,20,20,62
9/28/1972,23,0,20,20,63
9/29/1972,18,0,21,15,54
9/30/1972,22,0,26,17,65
10/1/1972,20,0,25,9,54
10/2/1972,17,0,14,27,58
10/3/1972,16,0,21,12,49
10/4/1972,17,0,13,16,46
10/5/1972,25,0,16,26,67
10/6/1972,18,0,13,14,45
10/7/1972,33,0,22,35,90
10/8/1972,22,0,23,33,78
10/9/1972,22,0,15,23,60
10/10/1972,33,0,16,12,61
10/11/1972,19,0,29,22,70
10/12/1972,21,0,20,24,65
10/13/1972,35,0,18,31,84
10/14/1972,25,0,16,32,73
10/15/1972,25,0,17,24,66
10/16/1972,17,0,17,27,61
10/17/1972,23,0,14,22,59
10/18/1972,32,0,22,23,77
10/19/1972,11,0,13,24,48
10/20/1972,23,0,19,13,55
10/21/1972,25,0,20,35,80
10/22/1972,13,0,13,26,52
10/23/1972,23,0,10,13,46
10/24/1972,20,0,28,24,72
10/25/1972,29,0,16,27,72
10/26/1972,23,0,14,37,74
10/27/1972,20,0,24,28,72
10/28/1972,20,0,22,12,54
10/29/1972,15,0,10,8,33
10/30/1972,25,0,13,17,55
10/31/1972,29,0,19,28,76
11/1/1972,16,0,21,7,44
11/2/1972,19,0,25,20,64
11/3/1972,21,0,14,22,57
11/4/1972,24,0,25,27,76
11/5/1972,21,0,12,24,57
11/6/1972,19,0,18,32,69
11/7/1972,15,0,24,25,64
11/8/1972,27,0,10,26,63
11/9/1972,22,0,12,5,39
11/10/1972,20,0,16,17,53
11/11/1972,32,0,23,8,63
11/12/1972,17,0,20,15,52
11/13/1972,19,0,23,10,52
11/14/1972,24,0,12,22,58
11/15/1972,15,0,24,22,61
11/16/1972,27,0,13,3,43
11/17/1972,31,0,18,10,59
11/18/1972,22,0,15,14,51
11/19/1972,32,0,23,37,92
11/20/1972,24,0,11,13,48
11/21/1972,25,0,27,2,54
11/22/1972,26,0,21,4,51
11/23/1972,25,0,20,24,69
11/24/1972,27,0,25,17,69
11/25/1972,28,0,13,29,70
11/26/1972,24,0,17,18,59
11/27/1972,20,0,10,19,49
11/28/1972,23,0,19,15,57
11/29/1972,25,0,23,31,79
11/30/1972,14,0,19,12,45
12/1/1972,23,0,24,18,65
12/2/1972,18,0,22,13,53
12/3/1972,26,0,14,22,62
12/4/1972,26,0,18,25,69
12/5/1972,31,0,12,22,65
12/6/1972,29,0,8,11,48
12/7/1972,19,0,18,32,69
12/8/1972,29,0,8,24,61
12/9/1972,14,0,23,13,50
12/10/1972,16,0,19,4,39
12/11/1972,31,0,17,14,62
12/12/1972,28,0,26,26,80
12/13/1972,21,0,19,26,66
12/14/1972,29,0,27,26,82
12/15/1972,30,0,25,15,70
12/16/1972,24,0,19,22,65
12/17/1972,25,0,21,0,46
12/18/1972,29,0,19,23,71
12/19/1972,29,0,10,23,62
12/20/1972,20,0,29,30,79
12/21/1972,28,0,19,14,61
12/22/1972,24,0,15,10,49
12/23/1972,29,0,19,23,71
12/24/1972,33,0,23,9,65
12/25/1972,26,0,23,13,62
12/26/1972,17,0,13,11,41
12/27/1972,25,0,27,9,61
12/28/1972,27,0,13,19,59
12/29/1972,19,0,29,20,68
12/30/1972,29,0,24,26,79
12/31/1972,18,0,13,12,43
1/1/1973,33,0,14,17,64
1/2/1973,34,0,26,19,79
1/3/1973,20,0,27,14,61
1/4/1973,28,0,26,15,69
1/5/1973,23,0,21,30,74
1/6/1973,20,0,11,16,47
1/7/1973,28,0,14,16,58
1/8/1973,17,0,16,21,54
1/9/1973,24,0,13,18,55
1/10/1973,16,0,22,14,52
1/11/1973,18,0,14,26,58
1/12/1973,29,0,23,18,70
1/13/1973,15,0,17,13,45
1/14/1973,29,0,21,6,56
1/15/1973,23,0,11,11,45
1/16/1973,27,0,27,7,61
1/17/1973,26,0,32,20,78
1/18/1973,30,0,14,22,66
1/19/1973,32,0,19,22,73
1/20/1973,11,0,21,18,50
1/21/1973,24,0,24,26,74
1/22/1973,24,0,21,27,72
1/23/1973,23,0,20,15,58
1/24/1973,20,0,21,21,62
1/25/1973,20,0,21,17,58
1/26/1973,17,0,19,31,67
1/27/1973,27,0,10,27,64
1/28/1973,32,0,26,27,85
1/29/1973,24,0,18,17,59
1/30/1973,24,0,18,7,49
1/31/1973,18,0,25,16,59
2/1/1973,23,0,16,12,51
2/2/1973,19,0,16,28,63
2/3/1973,27,0,19,21,67
2/4/1973,24,0,22,22,68
2/5/1973,21,0,32,24,77
2/6/1973,23,0,18,24,65
2/7/1973,25,0,29,15,69
2/8/1973,24,0,24,31,79
2/9/1973,17,0,26,23,66
2/10/1973,25,0,21,18,64
2/11/1973,24,0,26,20,70
2/12/1973,21,0,24,22,67
2/13/1973,23,0,32,20,75
2/14/1973,30,0,15,7,52
2/15/1973,28,0,9,24,61
2/16/1973,17,0,20,13,50
2/17/1973,12,0,20,3,35
2/18/1973,17,0,22,24,63
2/19/1973,24,0,17,36,77
2/20/1973,23,0,21,23,67
2/21/1973,25,0,17,10,52
2/22/1973,23,0,18,24,65
2/23/1973,30,0,15,7,52
2/24/1973,25,0,30,23,78
2/25/1973,19,0,22,19,60
2/26/1973,26,0,13,22,61
2/27/1973,25,0,19,17,61
2/28/1973,22,0,19,14,55
3/1/1973,25,0,21,13,59
3/2/1973,31,0,21,31,83
3/3/1973,32,0,23,37,92
3/4/1973,23,0,31,17,71
3/5/1973,17,0,22,12,51
3/6/1973,17,0,24,31,72
3/7/1973,28,0,22,10,60
3/8/1973,27,0,17,13,57
3/9/1973,29,0,12,31,72
3/10/1973,17,0,14,7,38
3/11/1973,21,0,25,13,59
3/12/1973,29,0,15,22,66
3/13/1973,31,0,20,9,60
3/14/1973,21,0,22,13,56
3/15/1973,17,0,17,35,69
3/16/1973,21,0,12,26,59
3/17/1973,25,0,26,21,72
3/18/1973,29,0,29,15,73
3/19/1973,17,0,23,13,53
3/20/1973,23,0,12,9,44
3/21/1973,24,0,19,13,56
3/22/1973,20,0,25,17,62
3/23/1973,23,0,21,17,61
3/24/1973,24,0,26,10,60
3/25/1973,31,0,24,14,69
3/26/1973,26,0,19,24,69
3/27/1973,20,0,17,17,54
3/28/1973,25,0,20,25,70
3/29/1973,18,0,20,22,60
3/30/1973,26,0,14,8,48
3/31/1973,30,0,28,14,72
4/1/1973,33,0,24,16,73
4/2/1973,23,0,20,15,58
4/3/1973,26,0,33,19,78
4/4/1973,23,0,25,20,68
4/5/1973,27,0,21,29,77
4/6/1973,21,0,28,7,56
4/7/1973,27,0,13,20,60
4/8/1973,18,0,22,10,50
4/9/1973,26,0,18,22,66
4/10/1973,20,0,27,24,71
4/11/1973,28,0,17,15,60
4/12/1973,33,0,18,28,79
4/13/1973,20,0,24,29,73
4/14/1973,27,0,25,16,68
4/15/1973,21,0,18,24,63
4/16/1973,28,0,18,19,65
4/17/1973,27,0,26,14,67
4/18/1973,32,0,16,18,66
4/19/1973,25,0,25,12,62
4/20/1973,17,0,18,14,49
4/21/1973,35,0,10,15,60
4/22/1973,28,0,25,17,70
4/23/1973,14,0,24,11,49
4/24/1973,30,0,24,11,65
4/25/1973,30,0,13,20,63
4/26/1973,22,0,16,23,61
4/27/1973,24,0,24,16,64
4/28/1973,27,0,28,20,75
4/29/1973,20,0,18,27,65
4/30/1973,25,0,11,21,57
5/1/1973,26,0,22,11,59
5/2/1973,14,0,21,12,47
5/3/1973,12,0,19,3,34
5/4/1973,21,0,19,24,64
5/5/1973,24,0,7,14,45
5/6/1973,28,0,22,26,76
5/7/1973,21,0,21,11,53
5/8/1973,31,0,25,22,78
5/9/1973,14,0,24,14,52
5/10/1973,30,0,12,27,69
5/11/1973,27,0,20,29,76
5/12/1973,29,0,21,25,75
5/13/1973,19,0,19,11,49
5/14/1973,28,0,18,25,71
5/15/1973,36,0,19,24,79
5/16/1973,19,0,22,22,63
5/17/1973,31,0,23,17,71
5/18/1973,25,0,10,27,62
5/19/1973,20,0,21,22,63
5/20/1973,28,0,24,14,66
5/21/1973,20,0,14,23,57
5/22/1973,19,0,19,16,54
5/23/1973,30,0,17,18,65
5/24/1973,30,0,17,11,58
5/25/1973,20,0,15,31,66
5/26/1973,17,0,15,21,53
5/27/1973,26,0,18,9,53
5/28/1973,22,0,12,19,53
5/29/1973,24,0,14,31,69
5/30/1973,24,0,21,20,65
5/31/1973,19,0,18,26,63
6/1/1973,21,0,19,2,42
6/2/1973,19,0,18,23,60
6/3/1973,18,0,16,12,46
6/4/1973,15,0,25,24,64
6/5/1973,20,0,23,12,55
6/6/1973,28,0,26,26,80
6/7/1973,14,0,14,27,55
6/8/1973,18,0,19,25,62
6/9/1973,30,0,16,21,67
6/10/1973,28,0,26,7,61
6/11/1973,22,0,23,18,63
6/12/1973,12,0,18,26,56
6/13/1973,28,0,30,16,74
6/14/1973,26,0,18,13,57
6/15/1973,19,0,14,24,57
6/16/1973,15,0,11,28,54
6/17/1973,22,0,20,28,70
6/18/1973,31,0,19,17,67
6/19/1973,21,0,10,29,60
6/20/1973,19,0,31,28,78
6/21/1973,15,0,20,15,50
6/22/1973,33,0,31,11,75
6/23/1973,31,0,20,6,57
6/24/1973,23,0,15,18,56
6/25/1973,24,0,23,25,72
6/26/1973,16,0,22,23,61
6/27/1973,22,0,19,22,63
6/28/1973,28,0,24,30,82
6/29/1973,23,0,24,13,60
6/30/1973,21,0,26,15,62
7/1/1973,15,0,14,6,35
7/2/1973,16,0,22,21,59
7/3/1973,15,0,25,10,50
7/4/1973,18,0,32,12,62
7/5/1973,18,0,14,27,59
7/6/1973,23,0,28,22,73
7/7/1973,17,0,7,10,34
7/8/1973,21,0,21,17,59
7/9/1973,21,0,17,16,54
7/10/1973,30,0,22,23,75
7/11/1973,23,0,30,13,66
7/12/1973,19,0,16,25,60
7/13/1973,23,0,28,28,79
7/14/1973,23,0,13,9,45
7/15/1973,20,0,28,17,65
7/16/1973,26,0,25,31,82
7/17/1973,22,0,9,30,61
7/18/1973,24,0,17,11,52
7/19/1973,13,0,11,20,44
7/20/1973,21,0,11,17,49
7/21/1973,20,0,22,18,60
7/22/1973,21,0,26,23,70
7/23/1973,19,0,10,19,48
7/24/1973,18,0,20,12,50
7/25/1973,18,0,15,16,49
7/26/1973,25,0,20,23,68
7/27/1973,13,0,14,16,43
7/28/1973,22,0,20,17,59
7/29/1973,17,0,17,22,56
7/30/1973,24,0,30,7,61
7/31/1973,26,0,17,23,66
8/1/1973,17,0,13,28,58
8/2/1973,16,0,19,29,64
8/3/1973,32,0,25,10,67
8/4/1973,22,0,18,24,64
8/5/1973,22,0,21,19,62
8/6/1973,25,0,14,24,63
8/7/1973,17,0,14,15,46
8/8/1973,27,0,16,25,68
8/9/1973,24,0,23,15,62
8/10/1973,18,0,18,22,58
8/11/1973,15,0,18,1,34
8/12/1973,20,0,16,33,69
8/13/1973,26,0,20,27,73
8/14/1973,22,0,18,17,57
8/15/1973,18,0,23,19,60
8/16/1973,15,0,17,15,47
8/17/1973,22,0,19,27,68
8/18/1973,14,0,14,9,37
8/19/1973,33,0,11,28,72
8/20/1973,23,0,28,16,67
8/21/1973,22,0,23,27,72
8/22/1973,21,0,24,21,66
8/23/1973,24,0,23,13,60
8/24/1973,20,0,23,23,66
8/25/1973,23,0,21,25,69
8/26/1973,18,0,18,23,59
8/27/1973,19,0,24,20,63
8/28/1973,14,0,17,20,51
8/29/1973,28,0,17,11,56
8/30/1973,19,0,20,27,66
8/31/1973,25,0,23,18,66
9/1/1973,25,0,20,23,68
9/2/1973,26,0,29,24,79
9/3/1973,29,0,26,27,82
9/4/1973,26,0,10,21,57
9/5/1973,21,0,28,20,69
9/6/1973,16,0,21,31,68
9/7/1973,12,0,26,26,64
9/8/1973,22,0,12,1,35
9/9/1973,25,0,11,25,61
9/10/1973,24,0,10,15,49
9/11/1973,21,0,23,20,64
9/12/1973,23,0,14,15,52
9/13/1973,27,0,21,33,81
9/14/1973,22,0,23,18,63
9/15/1973,24,0,28,29,81
9/16/1973,17,0,28,20,65
9/17/1973,25,0,19,9,53
9/18/1973,25,0,16,17,58
9/19/1973,22,0,16,8,46
9/20/1973,17,0,23,6,46
9/21/1973,22,0,24,11,57
9/22/1973,28,0,29,16,73
9/23/1973,26,0,25,16,67
9/24/1973,27,0,16,22,65
9/25/1973,23,0,23,25,71
9/26/1973,16,0,20,25,61
9/27/1973,24,0,19,16,59
9/28/1973,17,0,20,9,46
9/29/1973,23,0,19,11,53
9/30/1973,34,0,26,32,92
10/1/1973,29,0,23,15,67
10/2/1973,13,0,25,13,51
10/3/1973,19,0,13,19,51
10/4/1973,17,0,15,32,64
10/5/1973,28,0,21,16,65
10/6/1973,28,0,26,20,74
10/7/1973,14,0,16,12,42
10/8/1973,23,0,14,12,49
10/9/1973,25,0,17,14,56
10/10/1973,22,0,14,25,61
10/11/1973,18,0,21,18,57
10/12/1973,26,0,26,22,74
10/13/1973,25,0,27,15,67
10/14/1973,28,0,23,34,85
10/15/1973,23,0,16,1,40
10/16/1973,20,0,27,18,65
10/17/1973,16,0,17,19,52
10/18/1973,19,0,23,15,57
10/19/1973,24,0,18,19,61
10/20/1973,17,0,29,20,66
10/21/1973,22,0,29,21,72
10/22/1973,32,0,24,22,78
10/23/1973,29,0,25,25,79
10/24/1973,23,0,19,15,57
10/25/1973,22,0,28,28,78
10/26/1973,23,0,29,25,77
10/27/1973,20,0,12,22,54
10/28/1973,24,0,29,15,68
10/29/1973,24,0,16,21,61
10/30/1973,21,0,22,18,61
10/31/1973,20,0,15,32,67
11/1/1973,29,0,26,12,67
11/2/1973,28,0,10,21,59
11/3/1973,23,0,25,23,71
11/4/1973,20,0,16,21,57
11/5/1973,18,0,18,34,70
11/6/1973,21,0,28,21,70
11/7/1973,29,0,13,28,70
11/8/1973,20,0,23,24,67
11/9/1973,21,0,26,13,60
11/10/1973,15,0,25,28,68
11/11/1973,16,0,15,3,34
11/12/1973,26,0,22,37,85
11/13/1973,20,0,26,19,65
11/14/1973,20,0,10,19,49
11/15/1973,18,0,22,9,49
11/16/1973,16,0,17,27,60
11/17/1973,17,0,22,22,61
11/18/1973,23,0,23,28,74
11/19/1973,26,0,11,24,61
11/20/1973,21,0,17,19,57
11/21/1973,21,0,14,20,55
11/22/1973,26,0,15,23,64
11/23/1973,27,0,20,39,86
11/24/1973,18,0,14,7,39
11/25/1973,24,0,27,18,69
11/26/1973,19,0,23,21,63
11/27/1973,20,0,11,13,44
11/28/1973,23,0,25,20,68
11/29/1973,29,0,16,9,54
11/30/1973,25,0,25,7,57
12/1/1973,26,0,23,26,75
12/2/1973,32,0,28,26,86
12/3/1973,19,0,25,18,62
12/4/1973,29,0,22,28,79
12/5/1973,25,0,20,19,64
12/6/1973,26,0,14,22,62
12/7/1973,27,0,17,25,69
12/8/1973,24,0,16,10,50
12/9/1973,34,0,25,26,85
12/10/1973,15,0,29,23,67
12/11/1973,24,0,16,23,63
12/12/1973,30,0,25,18,73
12/13/1973,23,0,27,17,67
12/14/1973,33,0,22,30,85
12/15/1973,21,0,23,26,70
12/16/1973,19,0,14,16,49
12/17/1973,17,0,29,12,58
12/18/1973,20,0,19,9,48
12/19/1973,29,0,8,22,59
12/20/1973,21,0,29,21,71
12/21/1973,30,0,12,21,63
12/22/1973,28,0,12,17,57
12/23/1973,24,0,18,16,58
12/24/1973,32,0,24,22,78
12/25/1973,16,0,23,23,62
12/26/1973,23,0,20,33,76
12/27/1973,16,0,27,26,69
12/28/1973,20,0,27,9,56
12/29/1973,27,0,20,25,72
12/30/1973,25,0,15,25,65
12/31/1973,22,0,10,8,40
1/1/1974,23,0,15,7,45
1/2/1974,28,0,8,16,52
1/3/1974,23,0,19,29,71
1/4/1974,26,0,13,22,61
1/5/1974,25,0,22,18,65
1/6/1974,16,0,29,21,66
1/7/1974,23,0,21,14,58
1/8/1974,23,0,26,27,76
1/9/1974,18,0,25,19,62
1/10/1974,21,0,16,26,63
1/11/1974,18,0,17,25,60
1/12/1974,22,0,22,22,66
1/13/1974,19,0,27,31,77
1/14/1974,23,0,15,37,75
1/15/1974,23,0,22,19,64
1/16/1974,18,0,19,13,50
1/17/1974,20,0,27,10,57
1/18/1974,21,0,15,20,56
1/19/1974,11,0,19,31,61
1/20/1974,19,0,27,28,74
1/21/1974,26,0,26,14,66
1/22/1974,19,0,14,18,51
1/23/1974,23,0,29,38,90
1/24/1974,17,0,22,26,65
1/25/1974,20,0,14,25,59
1/26/1974,26,0,18,23,67
1/27/1974,16,0,11,11,38
1/28/1974,30,0,19,15,64
1/29/1974,23,0,28,34,85
1/30/1974,33,0,11,17,61
1/31/1974,23,0,21,28,72
2/1/1974,27,0,20,15,62
2/2/1974,20,0,26,25,71
2/3/1974,19,0,26,7,52
2/4/1974,22,0,13,14,49
2/5/1974,24,0,18,11,53
2/6/1974,22,0,15,30,67
2/7/1974,19,0,22,27,68
2/8/1974,22,0,30,10,62
2/9/1974,27,0,24,13,64
2/10/1974,21,0,11,18,50
2/11/1974,25,0,30,13,68
2/12/1974,22,0,24,17,63
2/13/1974,15,0,18,20,53
2/14/1974,18,0,26,11,55
2/15/1974,24,0,25,5,54
2/16/1974,22,0,19,24,65
2/17/1974,23,0,22,30,75
2/18/1974,22,0,16,26,64
2/19/1974,26,0,20,22,68
2/20/1974,17,0,19,8,44
2/21/1974,17,0,21,17,55
2/22/1974,17,0,24,25,66
2/23/1974,21,0,24,26,71
2/24/1974,30,0,22,16,68
2/25/1974,28,0,18,5,51
2/26/1974,26,0,9,17,52
2/27/1974,19,0,19,10,48
2/28/1974,11,0,28,37,76
3/1/1974,25,0,12,14,51
3/2/1974,18,0,15,26,59
3/3/1974,23,0,26,34,83
3/4/1974,28,0,23,15,66
3/5/1974,25,0,32,29,86
3/6/1974,25,0,22,22,69
3/7/1974,29,0,13,23,65
3/8/1974,25,0,28,27,80
3/9/1974,30,0,24,23,77
3/10/1974,28,0,13,16,57
3/11/1974,24,0,21,21,66
3/12/1974,20,0,22,28,70
3/13/1974,20,0,21,30,71
3/14/1974,17,0,22,7,46
3/15/1974,26,0,14,5,45
3/16/1974,26,0,25,24,75
3/17/1974,22,0,14,19,55
3/18/1974,20,0,24,11,55
3/19/1974,26,0,25,20,71
3/20/1974,27,0,13,25,65
3/21/1974,26,0,19,25,70
3/22/1974,15,0,22,23,60
3/23/1974,32,0,12,9,53
3/24/1974,23,0,22,28,73
3/25/1974,29,0,16,24,69
3/26/1974,20,0,10,30,60
3/27/1974,23,0,21,35,79
3/28/1974,21,0,25,16,62
3/29/1974,21,0,27,21,69
3/30/1974,15,0,18,20,53
3/31/1974,22,0,20,27,69
4/1/1974,25,0,12,17,54
4/2/1974,27,0,17,29,73
4/3/1974,22,0,21,25,68
4/4/1974,24,0,16,25,65
4/5/1974,23,0,26,25,74
4/6/1974,20,0,29,21,70
4/7/1974,30,0,10,28,68
4/8/1974,24,0,17,11,52
4/9/1974,19,0,19,9,47
4/10/1974,19,0,23,14,56
4/11/1974,18,0,20,16,54
4/12/1974,23,0,20,16,59
4/13/1974,19,0,8,25,52
4/14/1974,27,0,20,14,61
4/15/1974,29,0,25,16,70
4/16/1974,20,0,21,24,65
4/17/1974,23,0,27,26,76
4/18/1974,18,0,14,11,43
4/19/1974,22,0,11,16,49
4/20/1974,18,0,25,27,70
4/21/1974,21,0,25,24,70
4/22/1974,13,0,27,28,68
4/23/1974,22,0,8,15,45
4/24/1974,16,0,19,26,61
4/25/1974,22,0,21,16,59
4/26/1974,16,0,28,24,68
4/27/1974,21,0,21,15,57
4/28/1974,25,0,13,34,72
4/29/1974,19,0,11,27,57
4/30/1974,19,0,30,25,74
5/1/1974,30,0,17,35,82
5/2/1974,25,0,19,7,51
5/3/1974,30,0,26,27,83
5/4/1974,25,0,25,25,75
5/5/1974,12,0,26,14,52
5/6/1974,21,0,21,16,58
5/7/1974,32,0,20,29,81
5/8/1974,22,0,20,17,59
5/9/1974,27,0,26,13,66
5/10/1974,24,0,22,33,79
5/11/1974,25,0,21,18,64
5/12/1974,25,0,16,27,68
5/13/1974,22,0,24,27,73
5/14/1974,22,0,20,15,57
5/15/1974,15,0,18,23,56
5/16/1974,17,0,20,16,53
5/17/1974,22,0,33,15,70
5/18/1974,31,0,27,19,77
5/19/1974,26,0,14,15,55
5/20/1974,19,0,23,19,61
5/21/1974,16,0,18,26,60
5/22/1974,29,0,16,23,68
5/23/1974,24,0,20,21,65
5/24/1974,22,0,14,29,65
5/25/1974,22,0,20,20,62
5/26/1974,24,0,31,17,72
5/27/1974,20,0,15,24,59
5/28/1974,28,0,14,8,50
5/29/1974,19,0,17,17,53
5/30/1974,14,0,22,14,50
5/31/1974,20,0,18,17,55
6/1/1974,20,0,10,15,45
6/2/1974,18,0,28,33,79
6/3/1974,23,0,19,25,67
6/4/1974,18,0,27,11,56
6/5/1974,28,0,13,13,54
6/6/1974,20,0,25,19,64
6/7/1974,29,0,19,33,81
6/8/1974,23,0,14,21,58
6/9/1974,23,0,23,32,78
6/10/1974,24,0,20,12,56
6/11/1974,22,0,9,20,51
6/12/1974,18,0,20,24,62
6/13/1974,21,0,18,16,55
6/14/1974,24,0,29,28,81
6/15/1974,19,0,18,25,62
6/16/1974,20,0,16,18,54
6/17/1974,20,0,23,28,71
6/18/1974,19,0,28,18,65
6/19/1974,26,0,23,15,64
6/20/1974,20,0,13,17,50
6/21/1974,18,0,26,16,60
6/22/1974,22,0,23,17,62
6/23/1974,26,0,20,8,54
6/24/1974,25,0,24,11,60
6/25/1974,25,0,15,31,71
6/26/1974,20,0,13,31,64
6/27/1974,24,0,18,29,71
6/28/1974,12,0,14,33,59
6/29/1974,19,0,9,6,34
6/30/1974,23,0,16,28,67
7/1/1974,14,0,16,14,44
7/2/1974,30,0,19,21,70
7/3/1974,20,0,18,14,52
7/4/1974,19,0,15,25,59
7/5/1974,21,0,17,9,47
7/6/1974,23,0,18,37,78
7/7/1974,23,0,23,22,68
7/8/1974,17,0,26,12,55
7/9/1974,20,0,18,15,53
7/10/1974,20,0,27,13,60
7/11/1974,33,0,22,15,70
7/12/1974,29,0,16,17,62
7/13/1974,18,0,19,22,59
7/14/1974,15,0,27,31,73
7/15/1974,23,0,21,27,71
7/16/1974,29,0,25,30,84
7/17/1974,24,0,12,14,50
7/18/1974,25,0,12,15,52
7/19/1974,27,0,28,21,76
7/20/1974,29,0,26,24,79
7/21/1974,21,0,26,30,77
7/22/1974,28,0,27,32,87
7/23/1974,21,0,24,20,65
7/24/1974,23,0,20,27,70
7/25/1974,19,0,11,24,54
7/26/1974,19,0,19,20,58
7/27/1974,23,0,21,18,62
7/28/1974,27,0,10,18,55
7/29/1974,22,0,11,24,57
7/30/1974,26,0,16,11,53
7/31/1974,20,0,25,24,69
8/1/1974,22,0,13,26,61
8/2/1974,12,0,19,32,63
8/3/1974,21,0,15,9,45
8/4/1974,15,0,14,17,46
8/5/1974,33,0,24,23,80
8/6/1974,30,0,22,31,83
8/7/1974,24,0,25,18,67
8/8/1974,26,0,24,25,75
8/9/1974,23,0,12,19,54
8/10/1974,23,0,17,13,53
8/11/1974,17,0,24,13,54
8/12/1974,20,0,15,10,45
8/13/1974,17,0,26,20,63
8/14/1974,29,0,16,27,72
8/15/1974,23,0,13,13,49
8/16/1974,29,0,26,23,78
8/17/1974,21,0,13,9,43
8/18/1974,25,0,18,18,61
8/19/1974,23,0,12,14,49
8/20/1974,24,0,27,20,71
8/21/1974,20,0,21,6,47
8/22/1974,21,0,17,10,48
8/23/1974,23,0,16,30,69
8/24/1974,28,0,19,13,60
8/25/1974,20,0,15,20,55
8/26/1974,12,0,22,17,51
8/27/1974,34,0,19,19,72
8/28/1974,28,0,23,15,66
8/29/1974,28,0,17,14,59
8/30/1974,29,0,11,20,60
8/31/1974,26,0,28,20,74
9/1/1974,25,0,16,20,61
9/2/1974,32,0,26,15,73
9/3/1974,27,0,20,19,66
9/4/1974,27,0,15,23,65
9/5/1974,25,0,25,22,72
9/6/1974,27,0,13,34,74
9/7/1974,16,0,19,19,54
9/8/1974,18,0,20,23,61
9/9/1974,25,0,28,13,66
9/10/1974,22,0,17,20,59
9/11/1974,19,0,11,15,45
9/12/1974,17,0,20,25,62
9/13/1974,18,0,13,12,43
9/14/1974,24,0,29,24,77
9/15/1974,24,0,22,7,53
9/16/1974,28,0,27,11,66
9/17/1974,19,0,9,18,46
9/18/1974,26,0,20,19,65
9/19/1974,19,0,22,16,57
9/20/1974,19,0,13,15,47
9/21/1974,18,0,11,16,45
9/22/1974,24,0,17,36,77
9/23/1974,23,0,21,7,51
9/24/1974,23,0,12,31,66
9/25/1974,20,0,6,29,55
9/26/1974,31,0,14,12,57
9/27/1974,21,0,26,34,81
9/28/1974,24,0,22,11,57
9/29/1974,14,0,23,10,47
9/30/1974,22,0,17,30,69
10/1/1974,22,0,17,20,59
10/2/1974,33,0,21,25,79
10/3/1974,10,0,22,23,55
10/4/1974,29,0,18,18,65
10/5/1974,29,0,23,20,72
10/6/1974,31,0,18,23,72
10/7/1974,26,0,25,13,64
10/8/1974,28,0,24,25,77
10/9/1974,20,0,18,5,43
10/10/1974,29,0,28,17,74
10/11/1974,17,0,14,20,51
10/12/1974,19,0,19,19,57
10/13/1974,21,0,16,21,58
10/14/1974,34,0,29,30,93
10/15/1974,29,0,26,2,57
10/16/1974,22,0,12,23,57
10/17/1974,17,0,26,16,59
10/18/1974,24,0,21,23,68
10/19/1974,19,0,23,10,52
10/20/1974,21,0,20,14,55
10/21/1974,14,0,26,26,66
10/22/1974,21,0,13,27,61
10/23/1974,15,0,29,24,68
10/24/1974,25,0,15,27,67
10/25/1974,19,0,14,13,46
10/26/1974,22,0,25,25,72
10/27/1974,27,0,26,23,76
10/28/1974,18,0,20,9,47
10/29/1974,21,0,22,14,57
10/30/1974,26,0,20,22,68
10/31/1974,22,0,31,14,67
11/1/1974,24,0,15,9,48
11/2/1974,21,0,9,10,40
11/3/1974,27,0,25,26,78
11/4/1974,20,0,20,13,53
11/5/1974,27,0,7,28,62
11/6/1974,18,0,27,14,59
11/7/1974,17,0,20,24,61
11/8/1974,20,0,21,10,51
11/9/1974,21,0,14,22,57
11/10/1974,20,0,17,34,71
11/11/1974,24,0,31,11,66
11/12/1974,25,0,20,5,50
11/13/1974,16,0,21,25,62
11/14/1974,25,0,17,7,49
11/15/1974,30,0,20,14,64
11/16/1974,16,0,12,28,56
11/17/1974,21,0,24,11,56
11/18/1974,19,0,23,27,69
11/19/1974,17,0,18,31,66
11/20/1974,25,0,22,9,56
11/21/1974,22,0,18,31,71
11/22/1974,29,0,24,20,73
11/23/1974,26,0,19,8,53
11/24/1974,24,0,9,13,46
11/25/1974,26,0,25,18,69
11/26/1974,20,0,22,17,59
11/27/1974,28,0,19,15,62
11/28/1974,15,0,18,12,45
11/29/1974,27,0,27,21,75
11/30/1974,32,0,24,23,79
12/1/1974,25,0,19,33,77
12/2/1974,19,0,19,18,56
12/3/1974,24,0,18,17,59
12/4/1974,20,0,16,29,65
12/5/1974,15,0,12,20,47
12/6/1974,16,0,27,27,70
12/7/1974,18,0,22,23,63
12/8/1974,33,0,7,23,63
12/9/1974,23,0,17,15,55
12/10/1974,26,0,13,26,65
12/11/1974,24,0,21,17,62
12/12/1974,21,0,12,31,64
12/13/1974,20,0,30,28,78
12/14/1974,23,0,13,26,62
12/15/1974,29,0,28,17,74
12/16/1974,26,0,8,22,56
12/17/1974,20,0,15,16,51
12/18/1974,28,0,17,21,66
12/19/1974,28,0,16,32,76
12/20/1974,30,0,27,16,73
12/21/1974,30,0,16,25,71
12/22/1974,27,0,23,14,64
12/23/1974,29,0,26,24,79
12/24/1974,18,0,17,29,64
12/25/1974,23,0,25,31,79
12/26/1974,25,0,18,21,64
12/27/1974,23,0,19,15,57
12/28/1974,28,0,15,12,55
12/29/1974,26,0,7,21,54
12/30/1974,24,0,17,26,67
12/31/1974,14,0,8,17,39
1/1/1975,32,0,16,9,57
1/2/1975,20,0,19,20,59
1/3/1975,12,0,8,12,32
1/4/1975,24,0,19,29,72
1/5/1975,28,0,19,33,80
1/6/1975,20,0,25,16,61
1/7/1975,22,0,21,34,77
1/8/1975,29,0,18,23,70
1/9/1975,23,0,24,28,75
1/10/1975,22,0,20,17,59
1/11/1975,23,0,15,28,66
1/12/1975,24,0,18,28,70
1/13/1975,18,0,31,27,76
1/14/1975,23,0,12,25,60
1/15/1975,22,0,21,31,74
1/16/1975,25,0,20,21,66
1/17/1975,16,0,18,29,63
1/18/1975,20,0,23,25,68
1/19/1975,26,0,16,15,57
1/20/1975,26,0,12,13,51
1/21/1975,23,0,29,24,76
1/22/1975,16,0,30,21,67
1/23/1975,13,0,29,28,70
1/24/1975,12,0,25,14,51
1/25/1975,13,0,24,30,67
1/26/1975,21,0,14,29,64
1/27/1975,27,0,19,23,69
1/28/1975,25,0,27,25,77
1/29/1975,27,0,18,18,63
1/30/1975,23,0,23,21,67
1/31/1975,23,0,19,20,62
2/1/1975,29,0,26,21,76
2/2/1975,25,0,17,19,61
2/3/1975,27,0,21,22,70
2/4/1975,18,0,24,21,63
2/5/1975,20,0,30,10,60
2/6/1975,17,0,14,18,49
2/7/1975,25,0,22,22,69
2/8/1975,23,0,12,24,59
2/9/1975,19,0,21,24,64
2/10/1975,21,0,12,23,56
2/11/1975,21,0,23,12,56
2/12/1975,22,0,23,29,74
2/13/1975,22,0,14,16,52
2/14/1975,30,0,14,5,49
2/15/1975,14,0,18,22,54
2/16/1975,23,0,14,27,64
2/17/1975,26,0,22,19,67
2/18/1975,17,0,15,15,47
2/19/1975,25,0,15,21,61
2/20/1975,21,0,20,22,63
2/21/1975,30,0,22,12,64
2/22/1975,13,0,7,15,35
2/23/1975,17,0,16,19,52
2/24/1975,24,0,21,6,51
2/25/1975,23,0,15,17,55
2/26/1975,15,0,18,16,49
2/27/1975,26,0,9,6,41
2/28/1975,23,0,16,16,55
3/1/1975,17,0,19,19,55
3/2/1975,20,0,21,16,57
3/3/1975,26,0,30,12,68
3/4/1975,24,0,24,25,73
3/5/1975,24,0,31,21,76
3/6/1975,21,0,12,20,53
3/7/1975,24,0,23,7,54
3/8/1975,19,0,20,25,64
3/9/1975,22,0,23,19,64
3/10/1975,22,0,20,27,69
3/11/1975,20,0,16,35,71
3/12/1975,16,0,17,22,55
3/13/1975,24,0,23,24,71
3/14/1975,28,0,24,12,64
3/15/1975,27,0,28,12,67
3/16/1975,22,0,21,26,69
3/17/1975,27,0,14,12,53
3/18/1975,32,0,21,25,78
3/19/1975,30,0,16,15,61
3/20/1975,19,0,18,31,68
3/21/1975,29,0,16,15,60
3/22/1975,31,0,17,31,79
3/23/1975,23,0,14,15,52
3/24/1975,23,0,16,18,57
3/25/1975,29,0,16,17,62
3/26/1975,23,0,30,21,74
3/27/1975,20,0,10,24,54
3/28/1975,21,0,13,25,59
3/29/1975,25,0,26,23,74
3/30/1975,22,0,18,20,60
3/31/1975,17,0,20,17,54
4/1/1975,31,0,24,20,75
4/2/1975,28,0,13,17,58
4/3/1975,13,0,11,16,40
4/4/1975,15,0,28,19,62
4/5/1975,21,0,24,25,70
4/6/1975,12,0,25,15,52
4/7/1975,24,0,11,16,51
4/8/1975,19,0,17,17,53
4/9/1975,26,0,16,12,54
4/10/1975,18,0,20,16,54
4/11/1975,25,0,22,10,57
4/12/1975,31,0,24,15,70
4/13/1975,24,0,22,32,78
4/14/1975,25,0,27,11,63
4/15/1975,27,0,14,26,67
4/16/1975,22,0,30,22,74
4/17/1975,24,0,14,13,51
4/18/1975,23,0,25,6,54
4/19/1975,35,0,23,20,78
4/20/1975,17,0,17,22,56
4/21/1975,24,0,17,25,66
4/22/1975,19,0,18,10,47
4/23/1975,14,0,16,32,62
4/24/1975,14,0,26,24,64
4/25/1975,26,0,8,9,43
4/26/1975,23,0,19,24,66
4/27/1975,24,0,28,18,70
4/28/1975,29,0,28,19,76
4/29/1975,32,0,16,13,61
4/30/1975,21,0,23,28,72
5/1/1975,22,0,23,36,81
5/2/1975,17,0,17,21,55
5/3/1975,22,0,18,22,62
5/4/1975,18,0,25,28,71
5/5/1975,24,0,18,19,61
5/6/1975,30,0,17,19,66
5/7/1975,22,0,18,25,65
5/8/1975,31,0,19,29,79
5/9/1975,30,0,16,3,49
5/10/1975,19,0,24,15,58
5/11/1975,27,0,12,21,60
5/12/1975,17,0,17,19,53
5/13/1975,26,0,13,31,70
5/14/1975,18,0,27,15,60
5/15/1975,22,0,15,25,62
5/16/1975,24,0,27,21,72
5/17/1975,30,0,26,9,65
5/18/1975,16,0,12,20,48
5/19/1975,25,0,22,11,58
5/20/1975,23,0,23,11,57
5/21/1975,26,0,24,25,75
5/22/1975,17,0,30,21,68
5/23/1975,27,0,14,7,48
5/24/1975,21,0,21,37,79
5/25/1975,21,0,24,32,77
5/26/1975,33,0,28,33,94
5/27/1975,14,0,23,27,64
5/28/1975,27,0,18,21,66
5/29/1975,17,0,22,24,63
5/30/1975,24,0,22,11,57
5/31/1975,15,0,29,11,55
6/1/1975,28,0,24,18,70
6/2/1975,24,0,10,22,56
6/3/1975,31,0,19,29,79
6/4/1975,17,0,21,33,71
6/5/1975,23,0,23,26,72
6/6/1975,19,0,12,21,52
6/7/1975,20,0,29,25,74
6/8/1975,16,0,21,19,56
6/9/1975,26,0,16,25,67
6/10/1975,23,0,9,21,53
6/11/1975,23,0,24,10,57
6/12/1975,32,0,20,7,59
6/13/1975,23,0,27,20,70
6/14/1975,20,0,14,14,48
6/15/1975,19,0,24,29,72
6/16/1975,20,0,19,15,54
6/17/1975,33,0,24,34,91
6/18/1975,29,0,19,11,59
6/19/1975,21,0,18,24,63
6/20/1975,20,0,10,35,65
6/21/1975,29,0,22,26,77
6/22/1975,23,0,17,11,51
6/23/1975,23,0,19,19,61
6/24/1975,14,0,26,12,52
6/25/1975,21,0,21,20,62
6/26/1975,23,0,21,17,61
6/27/1975,19,0,19,26,64
6/28/1975,22,0,27,24,73
6/29/1975,27,0,21,24,72
6/30/1975,21,0,23,22,66
7/1/1975,18,0,22,21,61
7/2/1975,27,0,18,23,68
7/3/1975,26,0,15,23,64
7/4/1975,21,0,14,18,53
7/5/1975,15,0,15,20,50
7/6/1975,32,0,25,25,82
7/7/1975,32,0,15,33,80
7/8/1975,20,0,15,22,57
7/9/1975,22,0,18,23,63
7/10/1975,21,0,18,36,75
7/11/1975,23,0,13,19,55
7/12/1975,19,0,27,7,53
7/13/1975,18,0,26,28,72
7/14/1975,21,0,11,26,58
7/15/1975,18,0,19,17,54
7/16/1975,25,0,9,33,67
7/17/1975,19,0,18,26,63
7/18/1975,19,0,20,9,48
7/19/1975,30,0,26,25,81
7/20/1975,25,0,13,24,62
7/21/1975,18,0,28,21,67
7/22/1975,26,0,16,17,59
7/23/1975,26,0,12,16,54
7/24/1975,25,0,17,26,68
7/25/1975,20,0,25,12,57
7/26/1975,29,0,12,22,63
7/27/1975,26,0,13,8,47
7/28/1975,21,0,23,22,66
7/29/1975,25,0,23,3,51
7/30/1975,16,0,17,13,46
7/31/1975,22,0,14,18,54
8/1/1975,15,0,15,39,69
8/2/1975,21,0,21,25,67
8/3/1975,11,0,19,33,63
8/4/1975,17,0,22,25,64
8/5/1975,20,0,26,26,72
8/6/1975,29,0,22,17,68
8/7/1975,24,0,21,12,57
8/8/1975,24,0,30,24,78
8/9/1975,30,0,23,17,70
8/10/1975,21,0,26,27,74
8/11/1975,26,0,23,15,64
8/12/1975,30,0,25,25,80
8/13/1975,25,0,18,16,59
8/14/1975,25,0,23,15,63
8/15/1975,21,0,18,17,56
8/16/1975,25,0,24,20,69
8/17/1975,31,0,30,22,83
8/18/1975,20,0,24,25,69
8/19/1975,23,0,20,18,61
8/20/1975,24,0,20,16,60
8/21/1975,13,0,31,16,60
8/22/1975,23,0,24,20,67
8/23/1975,27,0,25,22,74
8/24/1975,24,0,19,26,69
8/25/1975,20,0,29,19,68
8/26/1975,21,0,14,11,46
8/27/1975,24,0,18,29,71
8/28/1975,24,0,28,22,74
8/29/1975,27,0,22,14,63
8/30/1975,27,0,21,26,74
8/31/1975,17,0,23,35,75
9/1/1975,17,0,25,18,60
9/2/1975,17,0,16,16,49
9/3/1975,21,0,14,19,54
9/4/1975,18,0,23,17,58
9/5/1975,21,0,30,9,60
9/6/1975,23,0,23,6,52
9/7/1975,21,0,31,19,71
9/8/1975,21,0,23,15,59
9/9/1975,28,0,21,25,74
9/10/1975,24,0,23,20,67
9/11/1975,17,0,26,19,62
9/12/1975,24,0,33,23,80
9/13/1975,30,0,20,29,79
9/14/1975,24,0,17,21,62
9/15/1975,20,0,20,14,54
9/16/1975,23,0,21,7,51
9/17/1975,18,0,26,28,72
9/18/1975,22,0,28,36,86
9/19/1975,22,0,18,20,60
9/20/1975,20,0,17,27,64
9/21/1975,27,0,20,8,55
9/22/1975,23,0,15,26,64
9/23/1975,23,0,24,13,60
9/24/1975,16,0,15,16,47
9/25/1975,23,0,14,14,51
9/26/1975,20,0,20,17,57
9/27/1975,17,0,15,23,55
9/28/1975,18,0,22,30,70
9/29/1975,26,0,18,19,63
9/30/1975,25,0,21,16,62
10/1/1975,24,0,17,24,65
10/2/1975,25,0,15,29,69
10/3/1975,17,0,20,20,57
10/4/1975,19,0,24,15,58
10/5/1975,23,0,16,4,43
10/6/1975,24,0,22,18,64
10/7/1975,14,0,15,19,48
10/8/1975,30,0,16,21,67
10/9/1975,28,0,26,17,71
10/10/1975,22,0,32,26,80
10/11/1975,23,0,16,25,64
10/12/1975,19,0,32,27,78
10/13/1975,21,0,10,27,58
10/14/1975,26,0,17,24,67
10/15/1975,20,0,29,11,60
10/16/1975,32,0,26,28,86
10/17/1975,20,0,26,24,70
10/18/1975,19,0,19,19,57
10/19/1975,20,0,16,12,48
10/20/1975,24,0,24,30,78
10/21/1975,18,0,26,8,52
10/22/1975,16,0,17,27,60
10/23/1975,16,0,19,18,53
10/24/1975,27,0,24,23,74
10/25/1975,28,0,22,15,65
10/26/1975,21,0,12,22,55
10/27/1975,23,0,26,8,57
10/28/1975,30,0,15,35,80
10/29/1975,33,0,21,15,69
10/30/1975,19,0,19,27,65
10/31/1975,24,0,27,28,79
11/1/1975,27,0,22,13,62
11/2/1975,30,0,19,23,72
11/3/1975,25,0,25,26,76
11/4/1975,28,0,22,30,80
11/5/1975,19,0,20,9,48
11/6/1975,30,0,23,18,71
11/7/1975,31,0,26,7,64
11/8/1975,25,0,24,6,55
11/9/1975,33,0,17,17,67
11/10/1975,18,0,19,27,64
11/11/1975,23,0,8,32,63
11/12/1975,25,0,15,27,67
11/13/1975,12,0,26,17,55
11/14/1975,20,0,24,21,65
11/15/1975,13,0,13,25,51
11/16/1975,23,0,21,26,70
11/17/1975,22,0,25,2,49
11/18/1975,18,0,27,27,72
11/19/1975,24,0,26,35,85
11/20/1975,19,0,16,17,52
11/21/1975,26,0,14,15,55
11/22/1975,18,0,21,23,62
11/23/1975,17,0,28,22,67
11/24/1975,21,0,26,16,63
11/25/1975,23,0,20,27,70
11/26/1975,21,0,17,16,54
11/27/1975,19,0,15,18,52
11/28/1975,28,0,17,10,55
11/29/1975,29,0,22,13,64
11/30/1975,16,0,19,17,52
12/1/1975,25,0,18,20,63
12/2/1975,15,0,13,23,51
12/3/1975,20,0,21,8,49
12/4/1975,17,0,22,25,64
12/5/1975,20,0,22,12,54
12/6/1975,23,0,23,29,75
12/7/1975,32,0,12,11,55
12/8/1975,18,0,22,22,62
12/9/1975,19,0,16,7,42
12/10/1975,30,0,17,31,78
12/11/1975,18,0,12,18,48
12/12/1975,24,0,23,28,75
12/13/1975,23,0,7,21,51
12/14/1975,15,0,23,27,65
12/15/1975,24,0,22,13,59
12/16/1975,22,0,20,22,64
12/17/1975,27,0,24,12,63
12/18/1975,23,0,13,29,65
12/19/1975,26,0,12,7,45
12/20/1975,20,0,21,22,63
12/21/1975,24,0,17,21,62
12/22/1975,21,0,23,22,66
12/23/1975,18,0,20,17,55
12/24/1975,24,0,18,24,66
12/25/1975,24,0,22,11,57
12/26/1975,18,0,22,15,55
12/27/1975,24,0,27,16,67
12/28/1975,21,0,28,30,79
12/29/1975,18,0,17,23,58
12/30/1975,23,0,28,16,67
12/31/1975,22,0,17,5,44
1/1/1976,20,0,14,23,57
1/2/1976,16,0,17,20,53
1/3/1976,23,0,7,33,63
1/4/1976,19,0,16,13,48
1/5/1976,15,0,25,34,74
1/6/1976,16,0,20,15,51
1/7/1976,19,0,23,26,68
1/8/1976,15,0,26,26,67
1/9/1976,17,0,22,21,60
1/10/1976,18,0,20,26,64
1/11/1976,20,0,9,28,57
1/12/1976,25,0,23,22,70
1/13/1976,21,0,21,18,60
1/14/1976,16,0,14,18,48
1/15/1976,24,0,15,37,76
1/16/1976,23,0,23,23,69
1/17/1976,23,0,20,31,74
1/18/1976,25,0,30,28,83
1/19/1976,15,0,27,13,55
1/20/1976,21,0,25,16,62
1/21/1976,25,0,31,23,79
1/22/1976,19,0,19,19,57
1/23/1976,21,0,16,18,55
1/24/1976,19,0,21,15,55
1/25/1976,26,0,20,26,72
1/26/1976,21,0,24,10,55
1/27/1976,28,0,13,9,50
1/28/1976,28,0,14,28,70
1/29/1976,23,0,23,19,65
1/30/1976,28,0,28,10,66
1/31/1976,16,0,22,16,54
2/1/1976,34,0,18,11,63
2/2/1976,14,0,11,14,39
2/3/1976,20,0,20,14,54
2/4/1976,22,0,32,19,73
2/5/1976,16,0,20,28,64
2/6/1976,34,0,26,7,67
2/7/1976,28,0,20,13,61
2/8/1976,21,0,19,23,63
2/9/1976,21,0,19,9,49
2/10/1976,17,0,15,28,60
2/11/1976,27,0,18,18,63
2/12/1976,26,0,28,12,66
2/13/1976,20,0,27,36,83
2/14/1976,29,0,13,10,52
2/15/1976,27,0,24,31,82
2/16/1976,28,0,11,29,68
2/17/1976,12,0,29,20,61
2/18/1976,24,0,21,22,67
2/19/1976,22,0,27,21,70
2/20/1976,28,0,18,11,57
2/21/1976,24,0,22,23,69
2/22/1976,18,0,26,13,57
2/23/1976,24,0,15,24,63
2/24/1976,27,0,17,23,67
2/25/1976,21,0,27,32,80
2/26/1976,19,0,30,35,84
2/27/1976,32,0,18,21,71
2/28/1976,27,0,11,18,56
2/29/1976,27,0,26,16,69
3/1/1976,17,0,18,17,52
3/2/1976,25,0,18,7,50
3/3/1976,28,0,18,23,69
3/4/1976,34,0,19,31,84
3/5/1976,17,0,21,17,55
3/6/1976,24,0,27,10,61
3/7/1976,16,0,20,28,64
3/8/1976,22,0,17,21,60
3/9/1976,18,0,13,17,48
3/10/1976,26,0,16,22,64
3/11/1976,29,0,23,22,74
3/12/1976,22,0,23,28,73
3/13/1976,18,0,21,10,49
3/14/1976,21,0,20,30,71
3/15/1976,20,0,25,19,64
3/16/1976,20,0,18,13,51
3/17/1976,25,0,21,11,57
3/18/1976,23,0,26,25,74
3/19/1976,25,0,16,10,51
3/20/1976,19,0,14,34,67
3/21/1976,10,0,14,22,46
3/22/1976,17,0,25,25,67
3/23/1976,30,0,9,31,70
3/24/1976,25,0,17,7,49
3/25/1976,14,0,10,22,46
3/26/1976,27,0,19,22,68
3/27/1976,31,0,19,24,74
3/28/1976,21,0,19,8,48
3/29/1976,20,0,23,15,58
3/30/1976,16,0,14,28,58
3/31/1976,19,0,25,10,54
4/1/1976,15,0,21,16,52
4/2/1976,26,0,8,22,56
4/3/1976,24,0,17,28,69
4/4/1976,27,0,18,35,80
4/5/1976,21,0,21,22,64
4/6/1976,24,0,30,18,72
4/7/1976,24,0,23,16,63
4/8/1976,23,0,24,18,65
4/9/1976,22,0,10,15,47
4/10/1976,16,0,18,4,38
4/11/1976,17,0,15,27,59
4/12/1976,32,0,17,30,79
4/13/1976,21,0,17,16,54
4/14/1976,26,0,25,19,70
4/15/1976,31,0,24,24,79
4/16/1976,21,0,24,26,71
4/17/1976,25,0,15,6,46
4/18/1976,26,0,18,14,58
4/19/1976,24,0,28,22,74
4/20/1976,23,0,32,35,90
4/21/1976,28,0,21,19,68
4/22/1976,15,0,12,24,51
4/23/1976,22,0,15,25,62
4/24/1976,20,0,9,23,52
4/25/1976,18,0,26,10,54
4/26/1976,24,0,15,25,64
4/27/1976,25,0,17,29,71
4/28/1976,13,0,27,30,70
4/29/1976,25,0,19,22,66
4/30/1976,25,0,33,21,79
5/1/1976,30,0,12,28,70
5/2/1976,26,0,29,10,65
5/3/1976,18,0,24,25,67
5/4/1976,19,0,19,29,67
5/5/1976,21,0,17,21,59
5/6/1976,24,0,7,28,59
5/7/1976,27,0,14,22,63
5/8/1976,27,0,23,28,78
5/9/1976,25,0,24,20,69
5/10/1976,26,0,24,19,69
5/11/1976,24,0,18,4,46
5/12/1976,18,0,32,8,58
5/13/1976,24,0,20,27,71
5/14/1976,23,0,17,21,61
5/15/1976,25,0,19,9,53
5/16/1976,27,0,19,23,69
5/17/1976,26,0,28,17,71
5/18/1976,24,0,22,9,55
5/19/1976,22,0,14,20,56
5/20/1976,28,0,19,18,65
5/21/1976,22,0,16,27,65
5/22/1976,21,0,21,11,53
5/23/1976,22,0,21,13,56
5/24/1976,20,0,15,10,45
5/25/1976,28,0,15,39,82
5/26/1976,32,0,24,17,73
5/27/1976,22,0,26,15,63
5/28/1976,25,0,22,26,73
5/29/1976,18,0,10,19,47
5/30/1976,24,0,19,28,71
5/31/1976,23,0,29,21,73
6/1/1976,24,0,23,6,53
6/2/1976,24,0,28,24,76
6/3/1976,28,0,20,30,78
6/4/1976,18,0,12,12,42
6/5/1976,29,0,22,15,66
6/6/1976,25,0,17,17,59
6/7/1976,17,0,13,24,54
6/8/1976,22,0,17,22,61
6/9/1976,16,0,14,15,45
6/10/1976,14,0,25,24,63
6/11/1976,27,0,21,18,66
6/12/1976,30,0,22,24,76
6/13/1976,19,0,25,26,70
6/14/1976,21,0,18,16,55
6/15/1976,31,0,20,22,73
6/16/1976,16,0,18,17,51
6/17/1976,21,0,24,20,65
6/18/1976,23,0,20,9,52
6/19/1976,25,0,8,22,55
6/20/1976,23,0,21,34,78
6/21/1976,21,0,25,20,66
6/22/1976,15,0,13,19,47
6/23/1976,16,0,13,25,54
6/24/1976,21,0,11,26,58
6/25/1976,18,0,23,17,58
6/26/1976,20,0,14,12,46
6/27/1976,25,0,16,29,70
6/28/1976,25,0,25,26,76
6/29/1976,30,0,23,21,74
6/30/1976,27,0,29,9,65
7/1/1976,21,0,30,33,84
7/2/1976,28,0,18,21,67
7/3/1976,23,0,20,18,61
7/4/1976,28,0,24,4,56
7/5/1976,25,0,22,15,62
7/6/1976,25,0,25,27,77
7/7/1976,24,0,20,26,70
7/8/1976,24,0,16,23,63
7/9/1976,28,0,21,32,81
7/10/1976,15,0,25,23,63
7/11/1976,21,0,25,17,63
7/12/1976,19,0,15,29,63
7/13/1976,25,0,27,19,71
7/14/1976,30,0,13,32,75
7/15/1976,13,0,26,14,53
7/16/1976,21,0,24,26,71
7/17/1976,17,0,22,23,62
7/18/1976,24,0,26,25,75
7/19/1976,18,0,22,22,62
7/20/1976,21,0,22,12,55
7/21/1976,18,0,17,23,58
7/22/1976,26,0,19,24,69
7/23/1976,15,0,15,20,50
7/24/1976,23,0,26,24,73
7/25/1976,29,0,22,13,64
7/26/1976,28,0,18,11,57
7/27/1976,24,0,27,17,68
7/28/1976,21,0,24,16,61
7/29/1976,31,0,17,11,59
7/30/1976,26,0,9,26,61
7/31/1976,22,0,17,25,64
8/1/1976,27,0,15,25,67
8/2/1976,18,0,11,18,47
8/3/1976,23,0,19,20,62
8/4/1976,14,0,27,17,58
8/5/1976,24,0,16,12,52
8/6/1976,24,0,21,9,54
8/7/1976,14,0,22,2,38
8/8/1976,25,0,23,25,73
8/9/1976,32,0,15,24,71
8/10/1976,28,0,15,25,68
8/11/1976,17,0,19,19,55
8/12/1976,17,0,18,32,67
8/13/1976,29,0,12,25,66
8/14/1976,25,0,26,24,75
8/15/1976,31,0,32,12,75
8/16/1976,27,0,22,10,59
8/17/1976,27,0,16,19,62
8/18/1976,20,0,20,10,50
8/19/1976,13,0,19,21,53
8/20/1976,23,0,12,28,63
8/21/1976,24,0,20,24,68
8/22/1976,20,0,26,14,60
8/23/1976,26,0,22,18,66
8/24/1976,31,0,17,14,62
8/25/1976,15,0,9,14,38
8/26/1976,13,0,27,25,65
8/27/1976,31,0,15,31,77
8/28/1976,20,0,24,25,69
8/29/1976,26,0,14,10,50
8/30/1976,33,0,19,31,83
8/31/1976,19,0,24,9,52
9/1/1976,21,0,23,18,62
9/2/1976,20,0,19,14,53
9/3/1976,28,0,27,39,94
9/4/1976,29,0,23,14,66
9/5/1976,23,0,31,18,72
9/6/1976,22,0,26,19,67
9/7/1976,18,0,29,14,61
9/8/1976,26,0,24,26,76
9/9/1976,17,0,8,27,52
9/10/1976,20,0,12,14,46
9/11/1976,30,0,23,16,69
9/12/1976,33,0,22,13,68
9/13/1976,26,0,13,28,67
9/14/1976,18,0,18,11,47
9/15/1976,25,0,24,22,71
9/16/1976,24,0,14,20,58
9/17/1976,17,0,16,19,52
9/18/1976,22,0,12,26,60
9/19/1976,23,0,16,34,73
9/20/1976,31,0,28,9,68
9/21/1976,23,0,19,17,59
9/22/1976,26,0,28,21,75
9/23/1976,21,0,22,26,69
9/24/1976,19,0,18,22,59
9/25/1976,31,0,16,15,62
9/26/1976,29,0,19,24,72
9/27/1976,25,0,20,19,64
9/28/1976,28,0,20,23,71
9/29/1976,25,0,17,16,58
9/30/1976,23,0,23,12,58
10/1/1976,21,0,18,24,63
10/2/1976,23,0,21,21,65
10/3/1976,26,0,17,22,65
10/4/1976,20,0,10,10,40
10/5/1976,20,0,19,15,54
10/6/1976,30,0,29,18,77
10/7/1976,18,0,24,30,72
10/8/1976,27,0,9,17,53
10/9/1976,22,0,26,10,58
10/10/1976,29,0,29,19,77
10/11/1976,23,0,15,21,59
10/12/1976,28,0,18,16,62
10/13/1976,23,0,26,11,60
10/14/1976,24,0,19,26,69
10/15/1976,23,0,16,33,72
10/16/1976,34,0,19,17,70
10/17/1976,23,0,24,8,55
10/18/1976,25,0,23,22,70
10/19/1976,29,0,18,14,61
10/20/1976,14,0,22,35,71
10/21/1976,22,0,15,15,52
10/22/1976,28,0,12,31,71
10/23/1976,27,0,16,16,59
10/24/1976,27,0,15,15,57
10/25/1976,17,0,28,21,66
10/26/1976,25,0,23,22,70
10/27/1976,24,0,22,28,74
10/28/1976,31,0,24,8,63
10/29/1976,22,0,13,30,65
10/30/1976,35,0,25,14,74
10/31/1976,24,0,30,19,73
11/1/1976,27,0,16,17,60
11/2/1976,26,0,18,26,70
11/3/1976,24,0,24,21,69
11/4/1976,17,0,14,23,54
11/5/1976,27,0,16,16,59
11/6/1976,27,0,21,16,64
11/7/1976,27,0,27,28,82
11/8/1976,16,0,23,18,57
11/9/1976,18,0,14,26,58
11/10/1976,26,0,26,29,81
11/11/1976,28,0,16,30,74
11/12/1976,31,0,25,31,87
11/13/1976,20,0,24,17,61
11/14/1976,22,0,13,21,56
11/15/1976,26,0,18,30,74
11/16/1976,25,0,10,11,46
11/17/1976,33,0,16,12,61
11/18/1976,23,0,18,13,54
11/19/1976,24,0,20,19,63
11/20/1976,20,0,16,13,49
11/21/1976,17,0,21,4,42
11/22/1976,17,0,30,20,67
11/23/1976,12,0,13,30,55
11/24/1976,21,0,16,21,58
11/25/1976,23,0,18,18,59
11/26/1976,28,0,27,26,81
11/27/1976,27,0,22,11,60
11/28/1976,30,0,13,26,69
11/29/1976,25,0,14,14,53
11/30/1976,21,0,11,31,63
12/1/1976,25,0,11,12,48
12/2/1976,22,0,11,21,54
12/3/1976,23,0,19,12,54
12/4/1976,22,0,17,21,60
12/5/1976,23,0,25,9,57
12/6/1976,13,0,23,12,48
12/7/1976,35,0,26,27,88
12/8/1976,25,0,12,22,59
12/9/1976,13,0,16,33,62
12/10/1976,19,0,19,11,49
12/11/1976,22,0,15,26,63
12/12/1976,16,0,23,16,55
12/13/1976,28,0,18,3,49
12/14/1976,21,0,26,19,66
12/15/1976,23,0,8,14,45
12/16/1976,15,0,27,29,71
12/17/1976,23,0,14,21,58
12/18/1976,19,0,17,20,56
12/19/1976,32,0,19,14,65
12/20/1976,14,0,16,24,54
12/21/1976,29,0,18,22,69
12/22/1976,26,0,31,30,87
12/23/1976,22,0,27,19,68
12/24/1976,34,0,16,12,62
12/25/1976,24,0,16,18,58
12/26/1976,29,0,13,17,59
12/27/1976,16,0,13,29,58
12/28/1976,21,0,24,34,79
12/29/1976,24,0,27,16,67
12/30/1976,16,0,25,33,74
12/31/1976,24,0,14,18,56
1/1/1977,31,0,34,23,88
1/2/1977,23,0,31,20,74
1/3/1977,21,0,29,17,67
1/4/1977,18,0,27,17,62
1/5/1977,18,0,22,13,53
1/6/1977,21,0,14,27,62
1/7/1977,24,0,27,7,58
1/8/1977,20,0,22,17,59
1/9/1977,26,0,24,25,75
1/10/1977,21,0,26,19,66
1/11/1977,20,0,23,19,62
1/12/1977,29,0,12,12,53
1/13/1977,34,0,23,22,79
1/14/1977,23,0,24,24,71
1/15/1977,26,0,27,17,70
1/16/1977,34,0,12,26,72
1/17/1977,19,0,23,26,68
1/18/1977,30,0,21,31,82
1/19/1977,18,0,20,8,46
1/20/1977,28,0,13,18,59
1/21/1977,21,0,17,23,61
1/22/1977,22,0,16,24,62
1/23/1977,17,0,17,14,48
1/24/1977,26,0,17,23,66
1/25/1977,28,0,23,21,72
1/26/1977,29,0,20,22,71
1/27/1977,21,0,18,13,52
1/28/1977,14,0,25,18,57
1/29/1977,18,0,15,11,44
1/30/1977,27,0,23,33,83
1/31/1977,28,0,27,25,80
2/1/1977,21,0,23,26,70
2/2/1977,19,0,19,27,65
2/3/1977,30,0,26,12,68
2/4/1977,24,0,17,19,60
2/5/1977,32,0,20,19,71
2/6/1977,16,0,29,17,62
2/7/1977,24,0,25,18,67
2/8/1977,28,0,22,24,74
2/9/1977,19,0,11,28,58
2/10/1977,20,0,23,15,58
2/11/1977,19,0,14,30,63
2/12/1977,23,0,26,29,78
2/13/1977,16,0,15,8,39
2/14/1977,17,0,28,25,70
2/15/1977,24,0,27,20,71
2/16/1977,16,0,23,36,75
2/17/1977,18,0,16,32,66
2/18/1977,18,0,21,30,69
2/19/1977,30,0,17,7,54
2/20/1977,29,0,13,14,56
2/21/1977,19,0,21,24,64
2/22/1977,19,0,24,18,61
2/23/1977,28,0,27,28,83
2/24/1977,31,0,30,5,66
2/25/1977,23,0,30,13,66
2/26/1977,30,0,20,25,75
2/27/1977,23,0,20,4,47
2/28/1977,25,0,14,32,71
3/1/1977,32,0,19,5,56
3/2/1977,14,0,30,9,53
3/3/1977,20,0,27,20,67
3/4/1977,25,0,17,26,68
3/5/1977,22,0,19,9,50
3/6/1977,26,0,20,25,71
3/7/1977,15,0,24,6,45
3/8/1977,24,0,24,29,77
3/9/1977,20,0,30,12,62
3/10/1977,22,0,24,12,58
3/11/1977,19,0,13,12,44
3/12/1977,22,0,23,32,77
3/13/1977,27,0,11,20,58
3/14/1977,31,0,17,16,64
3/15/1977,20,0,15,5,40
3/16/1977,21,0,28,13,62
3/17/1977,18,0,24,34,76
3/18/1977,14,0,20,19,53
3/19/1977,22,0,16,30,68
3/20/1977,22,0,22,29,73
3/21/1977,22,0,19,26,67
3/22/1977,22,0,19,8,49
3/23/1977,27,0,29,24,80
3/24/1977,18,0,23,22,63
3/25/1977,19,0,19,27,65
3/26/1977,14,0,18,22,54
3/27/1977,20,0,28,12,60
3/28/1977,28,0,8,28,64
3/29/1977,26,0,22,28,76
3/30/1977,24,0,14,9,47
3/31/1977,19,0,25,24,68
4/1/1977,20,0,20,14,54
4/2/1977,20,0,21,12,53
4/3/1977,19,0,21,28,68
4/4/1977,28,0,12,35,75
4/5/1977,16,0,17,11,44
4/6/1977,29,0,25,30,84
4/7/1977,30,0,21,26,77
4/8/1977,32,0,19,17,68
4/9/1977,25,0,18,15,58
4/10/1977,29,0,22,23,74
4/11/1977,20,0,22,5,47
4/12/1977,23,0,21,16,60
4/13/1977,30,0,22,27,79
4/14/1977,27,0,21,25,73
4/15/1977,22,0,21,22,65
4/16/1977,20,0,11,26,57
4/17/1977,21,0,10,18,49
4/18/1977,28,0,20,21,69
4/19/1977,24,0,30,13,67
4/20/1977,32,0,20,23,75
4/21/1977,21,0,17,17,55
4/22/1977,30,0,19,15,64
4/23/1977,30,0,9,7,46
4/24/1977,20,0,16,16,52
4/25/1977,23,0,29,18,70
4/26/1977,24,0,19,32,75
4/27/1977,26,0,28,11,65
4/28/1977,21,0,14,22,57
4/29/1977,21,0,25,24,70
4/30/1977,13,0,13,14,40
5/1/1977,22,0,23,4,49
5/2/1977,26,0,22,29,77
5/3/1977,33,0,20,33,86
5/4/1977,31,0,16,26,73
5/5/1977,23,0,17,26,66
5/6/1977,28,0,26,18,72
5/7/1977,20,0,25,12,57
5/8/1977,18,0,19,30,67
5/9/1977,17,0,16,22,55
5/10/1977,23,0,12,33,68
5/11/1977,24,0,19,16,59
5/12/1977,23,0,18,14,55
5/13/1977,27,0,21,17,65
5/14/1977,20,0,16,36,72
5/15/1977,19,0,22,16,57
5/16/1977,18,0,31,21,70
5/17/1977,23,0,18,21,62
5/18/1977,14,0,21,30,65
5/19/1977,22,0,13,24,59
5/20/1977,27,0,26,23,76
5/21/1977,21,0,11,20,52
5/22/1977,22,0,24,28,74
5/23/1977,24,0,22,36,82
5/24/1977,24,0,17,25,66
5/25/1977,21,0,20,23,64
5/26/1977,19,0,21,24,64
5/27/1977,24,0,16,12,52
5/28/1977,26,0,28,15,69
5/29/1977,18,0,26,29,73
5/30/1977,13,0,12,13,38
5/31/1977,26,0,21,19,66
6/1/1977,27,0,22,16,65
6/2/1977,20,0,14,15,49
6/3/1977,25,0,28,22,75
6/4/1977,29,0,15,30,74
6/5/1977,19,0,24,16,59
6/6/1977,24,0,21,15,60
6/7/1977,32,0,25,23,80
6/8/1977,16,0,10,36,62
6/9/1977,28,0,23,17,68
6/10/1977,25,0,13,27,65
6/11/1977,24,0,26,22,72
6/12/1977,22,0,19,18,59
6/13/1977,32,0,12,21,65
6/14/1977,23,0,14,27,64
6/15/1977,22,0,19,11,52
6/16/1977,20,0,11,8,39
6/17/1977,24,0,12,17,53
6/18/1977,12,0,20,4,36
6/19/1977,27,0,12,15,54
6/20/1977,27,0,23,9,59
6/21/1977,27,0,20,28,75
6/22/1977,22,0,25,14,61
6/23/1977,16,0,27,25,68
6/24/1977,20,0,18,24,62
6/25/1977,21,0,18,12,51
6/26/1977,34,0,14,16,64
6/27/1977,26,0,12,24,62
6/28/1977,26,0,12,12,50
6/29/1977,21,0,20,34,75
6/30/1977,24,0,23,25,72
7/1/1977,15,0,23,14,52
7/2/1977,27,0,8,23,58
7/3/1977,24,0,20,31,75
7/4/1977,21,0,24,27,72
7/5/1977,20,0,14,33,67
7/6/1977,26,0,20,15,61
7/7/1977,23,0,14,15,52
7/8/1977,23,0,19,28,70
7/9/1977,28,0,25,23,76
7/10/1977,24,0,9,25,58
7/11/1977,29,0,26,29,84
7/12/1977,26,0,13,25,64
7/13/1977,27,0,18,23,68
7/14/1977,26,0,25,29,80
7/15/1977,19,0,23,26,68
7/16/1977,26,0,26,15,67
7/17/1977,15,0,18,21,54
7/18/1977,17,0,9,11,37
7/19/1977,21,0,15,27,63
7/20/1977,19,0,7,9,35
7/21/1977,27,0,12,21,60
7/22/1977,18,0,15,28,61
7/23/1977,29,0,15,9,53
7/24/1977,22,0,25,11,58
7/25/1977,30,0,10,26,66
7/26/1977,16,0,11,24,51
7/27/1977,20,0,18,20,58
7/28/1977,31,0,24,2,57
7/29/1977,20,0,15,15,50
7/30/1977,23,0,15,22,60
7/31/1977,26,0,25,13,64
8/1/1977,15,0,27,31,73
8/2/1977,17,0,19,27,63
8/3/1977,21,0,24,9,54
8/4/1977,29,0,21,23,73
8/5/1977,18,0,25,11,54
8/6/1977,29,0,16,29,74
8/7/1977,29,0,17,16,62
8/8/1977,18,0,17,14,49
8/9/1977,20,0,26,22,68
8/10/1977,26,0,21,19,66
8/11/1977,18,0,24,1,43
8/12/1977,18,0,20,17,55
8/13/1977,19,0,17,21,57
8/14/1977,27,0,23,29,79
8/15/1977,26,0,23,11,60
8/16/1977,18,0,16,24,58
8/17/1977,19,0,18,32,69
8/18/1977,28,0,18,25,71
8/19/1977,26,0,24,24,74
8/20/1977,26,0,16,22,64
8/21/1977,24,0,18,16,58
8/22/1977,27,0,24,17,68
8/23/1977,19,0,23,23,65
8/24/1977,23,0,11,29,63
8/25/1977,22,0,29,25,76
8/26/1977,20,0,24,16,60
8/27/1977,22,0,20,4,46
8/28/1977,23,0,19,26,68
8/29/1977,21,0,15,28,64
8/30/1977,18,0,17,11,46
8/31/1977,28,0,33,17,78
9/1/1977,26,0,15,20,61
9/2/1977,17,0,24,25,66
9/3/1977,28,0,21,33,82
9/4/1977,23,0,30,11,64
9/5/1977,28,0,16,26,70
9/6/1977,26,0,28,21,75
9/7/1977,18,0,22,26,66
9/8/1977,26,0,21,13,60
9/9/1977,32,0,25,25,82
9/10/1977,28,0,16,19,63
9/11/1977,32,0,23,16,71
9/12/1977,15,0,21,27,63
9/13/1977,32,0,17,24,73
9/14/1977,26,0,30,19,75
9/15/1977,27,0,21,19,67
9/16/1977,23,0,17,10,50
9/17/1977,29,0,22,23,74
9/18/1977,30,0,26,26,82
9/19/1977,21,0,13,11,45
9/20/1977,17,0,18,14,49
9/21/1977,20,0,19,12,51
9/22/1977,18,0,11,26,55
9/23/1977,26,0,28,32,86
9/24/1977,29,0,26,22,77
9/25/1977,20,0,25,25,70
9/26/1977,26,0,23,24,73
9/27/1977,20,0,25,22,67
9/28/1977,29,0,19,21,69
9/29/1977,19,0,19,21,59
9/30/1977,14,0,18,16,48
10/1/1977,23,0,28,34,85
10/2/1977,24,0,32,21,77
10/3/1977,26,0,17,26,69
10/4/1977,18,0,18,13,49
10/5/1977,22,0,17,18,57
10/6/1977,15,0,11,21,47
10/7/1977,15,0,25,5,45
10/8/1977,22,0,21,24,67
10/9/1977,21,0,21,13,55
10/10/1977,13,0,11,28,52
10/11/1977,24,0,16,16,56
10/12/1977,26,0,20,25,71
10/13/1977,23,0,16,7,46
10/14/1977,25,0,26,36,87
10/15/1977,19,0,23,27,69
10/16/1977,18,0,24,30,72
10/17/1977,14,0,27,17,58
10/18/1977,23,0,20,14,57
10/19/1977,26,0,20,31,77
10/20/1977,30,0,12,5,47
10/21/1977,12,0,26,22,60
10/22/1977,23,0,17,19,59
10/23/1977,31,0,15,25,71
10/24/1977,24,0,21,13,58
10/25/1977,13,0,29,26,68
10/26/1977,17,0,21,27,65
10/27/1977,24,0,17,19,60
10/28/1977,18,0,24,16,58
10/29/1977,21,0,24,11,56
10/30/1977,20,0,24,19,63
10/31/1977,29,0,15,20,64
11/1/1977,22,0,15,27,64
11/2/1977,36,0,27,23,86
11/3/1977,27,0,23,13,63
11/4/1977,22,0,20,28,70
11/5/1977,16,0,12,9,37
11/6/1977,32,0,15,26,73
11/7/1977,24,0,25,21,70
11/8/1977,26,0,14,22,62
11/9/1977,21,0,27,38,86
11/10/1977,26,0,14,22,62
11/11/1977,29,0,24,22,75
11/12/1977,23,0,20,26,69
11/13/1977,16,0,18,8,42
11/14/1977,24,0,23,14,61
11/15/1977,24,0,18,15,57
11/16/1977,22,0,22,10,54
11/17/1977,13,0,19,20,52
11/18/1977,34,0,24,2,60
11/19/1977,19,0,19,15,53
11/20/1977,26,0,21,16,63
11/21/1977,20,0,30,18,68
11/22/1977,23,0,24,33,80
11/23/1977,22,0,11,24,57
11/24/1977,16,0,22,17,55
11/25/1977,28,0,26,16,70
11/26/1977,28,0,13,26,67
11/27/1977,20,0,25,10,55
11/28/1977,26,0,25,24,75
11/29/1977,27,0,15,10,52
11/30/1977,21,0,18,16,55
12/1/1977,31,0,17,24,72
12/2/1977,23,0,24,25,72
12/3/1977,27,0,29,20,76
12/4/1977,25,0,18,11,54
12/5/1977,20,0,24,17,61
12/6/1977,28,0,18,17,63
12/7/1977,25,0,17,20,62
12/8/1977,27,0,17,28,72
12/9/1977,27,0,28,25,80
12/10/1977,20,0,32,8,60
12/11/1977,13,0,17,22,52
12/12/1977,29,0,19,23,71
12/13/1977,25,0,26,18,69
12/14/1977,23,0,21,13,57
12/15/1977,24,0,15,6,45
12/16/1977,19,0,9,20,48
12/17/1977,17,0,22,13,52
12/18/1977,19,0,22,22,63
12/19/1977,16,0,17,12,45
12/20/1977,13,0,17,30,60
12/21/1977,17,0,26,5,48
12/22/1977,17,0,30,21,68
12/23/1977,14,0,22,23,59
12/24/1977,15,0,32,6,53
12/25/1977,14,0,26,19,59
12/26/1977,13,0,13,19,45
12/27/1977,22,0,25,28,75
12/28/1977,30,0,20,27,77
12/29/1977,20,0,16,22,58
12/30/1977,27,0,22,16,65
12/31/1977,16,0,22,26,64
1/1/1978,26,0,20,23,69
1/2/1978,23,0,13,18,54
1/3/1978,18,0,17,24,59
1/4/1978,17,0,15,29,61
1/5/1978,17,0,12,16,45
1/6/1978,25,0,18,22,65
1/7/1978,32,0,18,6,56
1/8/1978,26,0,16,19,61
1/9/1978,29,0,25,23,77
1/10/1978,31,0,11,12,54
1/11/1978,15,0,21,22,58
1/12/1978,17,0,30,21,68
1/13/1978,25,0,20,12,57
1/14/1978,15,0,18,31,64
1/15/1978,25,0,18,15,58
1/16/1978,20,0,16,14,50
1/17/1978,17,0,16,15,48
1/18/1978,19,0,26,17,62
1/19/1978,15,0,9,11,35
1/20/1978,32,0,17,25,74
1/21/1978,28,0,19,33,80
1/22/1978,27,0,22,16,65
1/23/1978,23,0,16,16,55
1/24/1978,28,0,19,25,72
1/25/1978,15,0,25,10,50
1/26/1978,13,0,16,19,48
1/27/1978,29,0,16,4,49
1/28/1978,25,0,24,34,83
1/29/1978,25,0,22,34,81
1/30/1978,23,0,21,14,58
1/31/1978,29,0,28,14,71
2/1/1978,33,0,27,19,79
2/2/1978,11,0,14,20,45
2/3/1978,31,0,19,14,64
2/4/1978,21,0,22,18,61
2/5/1978,26,0,25,27,78
2/6/1978,25,0,17,22,64
2/7/1978,23,0,20,24,67
2/8/1978,14,0,26,23,63
2/9/1978,28,0,25,21,74
2/10/1978,27,0,21,11,59
2/11/1978,22,0,24,26,72
2/12/1978,20,0,14,17,51
2/13/1978,12,0,22,13,47
2/14/1978,10,0,21,31,62
2/15/1978,23,0,19,15,57
2/16/1978,31,0,15,24,70
2/17/1978,28,0,20,34,82
2/18/1978,19,0,20,22,61
2/19/1978,25,0,23,16,64
2/20/1978,22,0,17,12,51
2/21/1978,27,0,20,20,67
2/22/1978,24,0,17,28,69
2/23/1978,29,0,19,23,71
2/24/1978,27,0,14,24,65
2/25/1978,28,0,19,21,68
2/26/1978,22,0,32,35,89
2/27/1978,23,0,24,23,70
2/28/1978,27,0,16,9,52
3/1/1978,27,0,16,26,69
3/2/1978,18,0,20,18,56
3/3/1978,25,0,15,22,62
3/4/1978,24,0,24,20,68
3/5/1978,20,0,23,18,61
3/6/1978,20,0,22,37,79
3/7/1978,32,0,16,22,70
3/8/1978,23,0,25,27,75
3/9/1978,21,0,27,16,64
3/10/1978,18,0,11,11,40
3/11/1978,35,0,14,14,63
3/12/1978,23,0,23,13,59
3/13/1978,28,0,11,27,66
3/14/1978,20,0,15,26,61
3/15/1978,24,0,24,34,82
3/16/1978,23,0,9,28,60
3/17/1978,14,0,25,23,62
3/18/1978,22,0,20,21,63
3/19/1978,26,0,18,12,56
3/20/1978,22,0,14,28,64
3/21/1978,24,0,27,9,60
3/22/1978,29,0,24,19,72
3/23/1978,28,0,24,13,65
3/24/1978,17,0,16,24,57
3/25/1978,22,0,17,19,58
3/26/1978,18,0,16,33,67
3/27/1978,22,0,14,6,42
3/28/1978,21,0,13,24,58
3/29/1978,28,0,11,17,56
3/30/1978,21,0,24,15,60
3/31/1978,22,0,22,13,57
4/1/1978,19,0,25,30,74
4/2/1978,17,0,20,25,62
4/3/1978,24,0,20,15,59
4/4/1978,19,0,23,22,64
4/5/1978,23,0,12,26,61
4/6/1978,27,0,22,8,57
4/7/1978,29,0,22,26,77
4/8/1978,28,0,22,23,73
4/9/1978,24,0,19,15,58
4/10/1978,25,0,8,17,50
4/11/1978,27,0,15,29,71
4/12/1978,23,0,28,8,59
4/13/1978,22,0,22,21,65
4/14/1978,26,0,21,8,55
4/15/1978,34,0,15,19,68
4/16/1978,24,0,21,26,71
4/17/1978,23,0,14,37,74
4/18/1978,17,0,17,16,50
4/19/1978,27,0,19,14,60
4/20/1978,30,0,28,15,73
4/21/1978,17,0,17,13,47
4/22/1978,16,0,23,20,59
4/23/1978,16,0,26,14,56
4/24/1978,31,0,22,33,86
4/25/1978,33,0,16,12,61
4/26/1978,15,0,24,28,67
4/27/1978,24,0,20,20,64
4/28/1978,24,0,20,37,81
4/29/1978,26,0,25,22,73
4/30/1978,26,0,12,27,65
5/1/1978,28,0,10,30,68
5/2/1978,18,0,15,27,60
5/3/1978,25,0,13,25,63
5/4/1978,21,0,19,21,61
5/5/1978,28,0,16,20,64
5/6/1978,16,0,15,9,40
5/7/1978,24,0,17,26,67
5/8/1978,17,0,22,32,71
5/9/1978,21,0,14,17,52
5/10/1978,19,0,22,10,51
5/11/1978,23,0,16,4,43
5/12/1978,13,0,15,13,41
5/13/1978,19,0,21,13,53
5/14/1978,27,0,28,20,75
5/15/1978,15,0,14,13,42
5/16/1978,18,0,16,33,67
5/17/1978,25,0,19,20,64
5/18/1978,17,0,21,26,64
5/19/1978,30,0,29,16,75
5/20/1978,19,0,17,17,53
5/21/1978,31,0,27,8,66
5/22/1978,15,0,22,13,50
5/23/1978,23,0,16,33,72
5/24/1978,21,0,22,21,64
5/25/1978,28,0,21,22,71
5/26/1978,19,0,9,19,47
5/27/1978,32,0,12,18,62
5/28/1978,32,0,12,16,60
5/29/1978,20,0,25,34,79
5/30/1978,31,0,21,30,82
5/31/1978,28,0,24,15,67
6/1/1978,25,0,11,27,63
6/2/1978,29,0,24,25,78
6/3/1978,27,0,18,14,59
6/4/1978,25,0,30,31,86
6/5/1978,28,0,31,14,73
6/6/1978,30,0,17,24,71
6/7/1978,23,0,20,26,69
6/8/1978,19,0,12,16,47
6/9/1978,32,0,23,15,70
6/10/1978,23,0,22,15,60
6/11/1978,22,0,28,24,74
6/12/1978,26,0,27,21,74
6/13/1978,21,0,18,15,54
6/14/1978,18,0,21,18,57
6/15/1978,22,0,22,14,58
6/16/1978,14,0,27,11,52
6/17/1978,28,0,24,13,65
6/18/1978,16,0,10,21,47
6/19/1978,23,0,32,22,77
6/20/1978,29,0,19,36,84
6/21/1978,20,0,19,34,73
6/22/1978,22,0,25,10,57
6/23/1978,30,0,29,15,74
6/24/1978,29,0,15,19,63
6/25/1978,29,0,12,18,59
6/26/1978,23,0,23,23,69
6/27/1978,24,0,17,18,59
6/28/1978,25,0,16,15,56
6/29/1978,26,0,20,23,69
6/30/1978,29,0,21,36,86
7/1/1978,30,0,17,16,63
7/2/1978,24,0,31,27,82
7/3/1978,19,0,27,19,65
7/4/1978,27,0,15,21,63
7/5/1978,28,0,16,17,61
7/6/1978,24,0,12,15,51
7/7/1978,20,0,23,15,58
7/8/1978,27,0,27,17,71
7/9/1978,22,0,13,26,61
7/10/1978,27,0,26,21,74
7/11/1978,15,0,14,13,42
7/12/1978,24,0,12,18,54
7/13/1978,26,0,29,34,89
7/14/1978,30,0,27,23,80
7/15/1978,21,0,12,21,54
7/16/1978,24,0,21,33,78
7/17/1978,19,0,28,13,60
7/18/1978,27,0,11,14,52
7/19/1978,28,0,27,24,79
7/20/1978,22,0,18,32,72
7/21/1978,22,0,21,26,69
7/22/1978,28,0,14,26,68
7/23/1978,31,0,20,18,69
7/24/1978,26,0,23,30,79
7/25/1978,27,0,19,18,64
7/26/1978,27,0,24,18,69
7/27/1978,21,0,30,21,72
7/28/1978,19,0,17,19,55
7/29/1978,18,0,26,27,71
7/30/1978,24,0,19,18,61
7/31/1978,23,0,26,32,81
8/1/1978,19,0,17,8,44
8/2/1978,13,0,21,17,51
8/3/1978,19,0,17,21,57
8/4/1978,23,0,20,27,70
8/5/1978,24,0,26,25,75
8/6/1978,25,0,21,28,74
8/7/1978,22,0,18,23,63
8/8/1978,19,0,10,21,50
8/9/1978,26,0,27,23,76
8/10/1978,28,0,19,26,73
8/11/1978,19,0,11,32,62
8/12/1978,22,0,23,6,51
8/13/1978,20,0,12,16,48
8/14/1978,23,0,22,15,60
8/15/1978,26,0,26,16,68
8/16/1978,18,0,26,18,62
8/17/1978,23,0,11,32,66
8/18/1978,19,0,23,23,65
8/19/1978,20,0,13,23,56
8/20/1978,21,0,17,15,53
8/21/1978,29,0,12,20,61
8/22/1978,27,0,18,21,66
8/23/1978,22,0,15,24,61
8/24/1978,22,0,19,17,58
8/25/1978,26,0,18,24,68
8/26/1978,27,0,17,17,61
8/27/1978,33,0,19,17,69
8/28/1978,23,0,26,10,59
8/29/1978,16,0,15,26,57
8/30/1978,22,0,22,12,56
8/31/1978,24,0,27,20,71
9/1/1978,18,0,24,12,54
9/2/1978,28,0,13,34,75
9/3/1978,17,0,22,27,66
9/4/1978,31,0,30,11,72
9/5/1978,22,0,12,13,47
9/6/1978,21,0,18,28,67
9/7/1978,33,0,15,25,73
9/8/1978,28,0,24,21,73
9/9/1978,22,0,21,16,59
9/10/1978,14,0,24,32,70
9/11/1978,23,0,24,20,67
9/12/1978,29,0,22,21,72
9/13/1978,16,0,19,7,42
9/14/1978,36,0,20,18,74
9/15/1978,22,0,13,11,46
9/16/1978,26,0,13,27,66
9/17/1978,31,0,22,11,64
9/18/1978,25,0,16,29,70
9/19/1978,24,0,14,16,54
9/20/1978,20,0,28,28,76
9/21/1978,22,0,22,33,77
9/22/1978,24,0,25,10,59
9/23/1978,27,0,18,23,68
9/24/1978,35,0,28,17,80
9/25/1978,28,0,25,21,74
9/26/1978,20,0,23,16,59
9/27/1978,31,0,23,19,73
9/28/1978,24,0,18,33,75
9/29/1978,33,0,19,11,63
9/30/1978,24,0,21,17,62
10/1/1978,22,0,25,25,72
10/2/1978,20,0,15,32,67
10/3/1978,20,0,29,26,75
10/4/1978,19,0,16,10,45
10/5/1978,28,0,33,28,89
10/6/1978,21,0,17,13,51
10/7/1978,26,0,24,15,65
10/8/1978,21,0,24,17,62
10/9/1978,25,0,12,23,60
10/10/1978,29,0,15,15,59
10/11/1978,25,0,20,16,61
10/12/1978,31,0,25,14,70
10/13/1978,26,0,9,14,49
10/14/1978,28,0,16,5,49
10/15/1978,17,0,26,26,69
10/16/1978,24,0,14,24,62
10/17/1978,22,0,25,30,77
10/18/1978,21,0,24,21,66
10/19/1978,17,0,20,14,51
10/20/1978,24,0,16,24,64
10/21/1978,26,0,22,11,59
10/22/1978,22,0,25,18,65
10/23/1978,16,0,21,32,69
10/24/1978,19,0,26,4,49
10/25/1978,22,0,13,12,47
10/26/1978,22,0,16,30,68
10/27/1978,15,0,13,26,54
10/28/1978,25,0,19,10,54
10/29/1978,34,0,27,23,84
10/30/1978,26,0,15,14,55
10/31/1978,30,0,22,24,76
11/1/1978,26,0,22,13,61
11/2/1978,25,0,15,19,59
11/3/1978,19,0,29,19,67
11/4/1978,19,0,22,3,44
11/5/1978,27,0,21,13,61
11/6/1978,24,0,19,17,60
11/7/1978,24,0,21,18,63
11/8/1978,26,0,22,5,53
11/9/1978,26,0,23,18,67
11/10/1978,22,0,23,28,73
11/11/1978,26,0,29,21,76
11/12/1978,20,0,22,16,58
11/13/1978,27,0,14,27,68
11/14/1978,24,0,17,31,72
11/15/1978,30,0,26,25,81
11/16/1978,18,0,13,11,42
11/17/1978,20,0,13,18,51
11/18/1978,26,0,19,24,69
11/19/1978,24,0,11,14,49
11/20/1978,24,0,22,7,53
11/21/1978,27,0,22,23,72
11/22/1978,25,0,30,2,57
11/23/1978,31,0,11,13,55
11/24/1978,27,0,22,12,61
11/25/1978,28,0,21,2,51
11/26/1978,28,0,18,13,59
11/27/1978,25,0,18,18,61
11/28/1978,18,0,19,15,52
11/29/1978,19,0,21,27,67
11/30/1978,29,0,15,22,66
12/1/1978,23,0,29,17,69
12/2/1978,23,0,24,21,68
12/3/1978,16,0,17,19,52
12/4/1978,23,0,16,12,51
12/5/1978,18,0,21,11,50
12/6/1978,29,0,24,14,67
12/7/1978,24,0,26,22,72
12/8/1978,27,0,20,32,79
12/9/1978,20,0,23,16,59
12/10/1978,21,0,16,14,51
12/11/1978,25,0,23,32,80
12/12/1978,21,0,13,17,51
12/13/1978,29,0,17,17,63
12/14/1978,18,0,17,20,55
12/15/1978,17,0,19,18,54
12/16/1978,23,0,12,22,57
12/17/1978,17,0,22,16,55
12/18/1978,14,0,18,8,40
12/19/1978,21,0,10,15,46
12/20/1978,33,0,16,22,71
12/21/1978,25,0,12,34,71
12/22/1978,26,0,17,7,50
12/23/1978,20,0,23,12,55
12/24/1978,20,0,15,10,45
12/25/1978,29,0,7,21,57
12/26/1978,21,0,16,21,58
12/27/1978,14,0,28,15,57
12/28/1978,33,0,21,38,92
12/29/1978,29,0,15,17,61
12/30/1978,23,0,25,22,70
12/31/1978,32,0,18,22,72
1/1/1979,30,0,23,25,78
1/2/1979,22,0,19,9,50
1/3/1979,26,0,11,19,56
1/4/1979,20,0,18,28,66
1/5/1979,23,0,26,19,68
1/6/1979,20,0,22,27,69
1/7/1979,29,0,22,20,71
1/8/1979,21,0,17,27,65
1/9/1979,25,0,28,13,66
1/10/1979,14,0,28,12,54
1/11/1979,23,0,19,16,58
1/12/1979,23,0,22,25,70
1/13/1979,19,0,18,22,59
1/14/1979,25,0,19,16,60
1/15/1979,20,0,22,20,62
1/16/1979,27,0,23,27,77
1/17/1979,20,0,23,28,71
1/18/1979,18,0,23,22,63
1/19/1979,14,0,9,15,38
1/20/1979,26,0,17,10,53
1/21/1979,31,0,19,24,74
1/22/1979,19,0,23,6,48
1/23/1979,25,0,13,21,59
1/24/1979,15,0,12,10,37
1/25/1979,21,0,27,19,67
1/26/1979,26,0,16,14,56
1/27/1979,28,0,14,16,58
1/28/1979,24,0,18,31,73
1/29/1979,17,0,22,24,63
1/30/1979,18,0,29,11,58
1/31/1979,22,0,19,19,60
2/1/1979,17,0,11,14,42
2/2/1979,23,0,22,4,49
2/3/1979,35,0,29,26,90
2/4/1979,23,0,11,16,50
2/5/1979,24,0,20,10,54
2/6/1979,29,0,21,9,59
2/7/1979,26,0,25,20,71
2/8/1979,16,0,25,25,66
2/9/1979,20,0,26,11,57
2/10/1979,16,0,22,21,59
2/11/1979,23,0,19,24,66
2/12/1979,19,0,15,12,46
2/13/1979,21,0,17,33,71
2/14/1979,34,0,12,15,61
2/15/1979,25,0,25,27,77
2/16/1979,18,0,19,21,58
2/17/1979,34,0,19,20,73
2/18/1979,24,0,18,15,57
2/19/1979,19,0,20,14,53
2/20/1979,31,0,18,8,57
2/21/1979,28,0,16,23,67
2/22/1979,21,0,17,24,62
2/23/1979,23,0,14,27,64
2/24/1979,12,0,24,32,68
2/25/1979,23,0,18,12,53
2/26/1979,19,0,24,38,81
2/27/1979,29,0,19,16,64
2/28/1979,25,0,18,24,67
3/1/1979,26,0,15,16,57
3/2/1979,27,0,23,19,69
3/3/1979,27,0,22,19,68
3/4/1979,22,0,25,25,72
3/5/1979,30,0,25,25,80
3/6/1979,27,0,15,15,57
3/7/1979,19,0,21,20,60
3/8/1979,28,0,18,14,60
3/9/1979,19,0,18,21,58
3/10/1979,22,0,23,19,64
3/11/1979,26,0,21,27,74
3/12/1979,22,0,15,12,49
3/13/1979,27,0,21,20,68
3/14/1979,19,0,15,21,55
3/15/1979,29,0,17,18,64
3/16/1979,24,0,19,25,68
3/17/1979,17,0,20,13,50
3/18/1979,24,0,12,23,59
3/19/1979,18,0,14,23,55
3/20/1979,26,0,16,18,60
3/21/1979,28,0,24,30,82
3/22/1979,30,0,32,9,71
3/23/1979,34,0,12,20,66
3/24/1979,27,0,24,34,85
3/25/1979,30,0,28,23,81
3/26/1979,28,0,27,19,74
3/27/1979,27,0,30,17,74
3/28/1979,24,0,21,23,68
3/29/1979,20,0,27,20,67
3/30/1979,26,0,28,18,72
3/31/1979,23,0,24,20,67
4/1/1979,23,0,21,11,55
4/2/1979,27,0,21,30,78
4/3/1979,26,0,23,16,65
4/4/1979,11,0,18,38,67
4/5/1979,27,0,23,22,72
4/6/1979,23,0,14,11,48
4/7/1979,19,0,24,22,65
4/8/1979,22,0,16,8,46
4/9/1979,32,0,17,6,55
4/10/1979,22,0,19,19,60
4/11/1979,21,0,19,5,45
4/12/1979,26,0,10,20,56
4/13/1979,27,0,14,25,66
4/14/1979,20,0,21,23,64
4/15/1979,22,0,23,8,53
4/16/1979,26,0,17,26,69
4/17/1979,28,0,21,27,76
4/18/1979,24,0,21,12,57
4/19/1979,28,0,19,24,71
4/20/1979,21,0,24,17,62
4/21/1979,14,0,20,16,50
4/22/1979,17,0,13,8,38
4/23/1979,19,0,23,16,58
4/24/1979,15,0,28,13,56
4/25/1979,24,0,19,28,71
4/26/1979,35,0,12,10,57
4/27/1979,18,0,23,4,45
4/28/1979,20,0,24,19,63
4/29/1979,13,0,19,15,47
4/30/1979,16,0,21,18,55
5/1/1979,23,0,22,21,66
5/2/1979,27,0,25,18,70
5/3/1979,18,0,14,20,52
5/4/1979,20,0,28,27,75
5/5/1979,30,0,13,17,60
5/6/1979,15,0,24,14,53
5/7/1979,27,0,18,16,61
5/8/1979,27,0,21,31,79
5/9/1979,25,0,17,22,64
5/10/1979,20,0,17,19,56
5/11/1979,30,0,17,17,64
5/12/1979,17,0,16,19,52
5/13/1979,23,0,12,17,52
5/14/1979,26,0,14,26,66
5/15/1979,29,0,16,22,67
5/16/1979,31,0,29,15,75
5/17/1979,27,0,25,11,63
5/18/1979,24,0,27,30,81
5/19/1979,18,0,19,8,45
5/20/1979,23,0,25,21,69
5/21/1979,25,0,29,11,65
5/22/1979,24,0,15,25,64
5/23/1979,20,0,12,27,59
5/24/1979,23,0,30,12,65
5/25/1979,22,0,30,28,80
5/26/1979,23,0,16,30,69
5/27/1979,21,0,17,16,54
5/28/1979,33,0,18,18,69
5/29/1979,18,0,19,21,58
5/30/1979,22,0,25,9,56
5/31/1979,30,0,11,17,58
6/1/1979,28,0,26,28,82
6/2/1979,29,0,27,30,86
6/3/1979,19,0,25,25,69
6/4/1979,25,0,27,20,72
6/5/1979,22,0,23,15,60
6/6/1979,22,0,17,19,58
6/7/1979,24,0,16,8,48
6/8/1979,17,0,11,23,51
6/9/1979,26,0,25,20,71
6/10/1979,29,0,15,15,59
6/11/1979,17,0,22,13,52
6/12/1979,21,0,22,16,59
6/13/1979,22,0,19,23,64
6/14/1979,20,0,30,22,72
6/15/1979,32,0,18,12,62
6/16/1979,23,0,13,28,64
6/17/1979,17,0,16,23,56
6/18/1979,28,0,17,9,54
6/19/1979,29,0,18,10,57
6/20/1979,15,0,22,19,56
6/21/1979,27,0,21,27,75
6/22/1979,23,0,22,5,50
6/23/1979,24,0,25,14,63
6/24/1979,16,0,22,16,54
6/25/1979,30,0,23,20,73
6/26/1979,19,0,12,9,40
6/27/1979,32,0,15,20,67
6/28/1979,30,0,25,24,79
6/29/1979,28,0,24,12,64
6/30/1979,22,0,22,24,68
7/1/1979,23,0,16,25,64
7/2/1979,28,0,28,15,71
7/3/1979,28,0,20,4,52
7/4/1979,16,0,23,8,47
7/5/1979,30,0,15,24,69
7/6/1979,21,0,18,25,64
7/7/1979,21,0,28,10,59
7/8/1979,21,0,22,27,70
7/9/1979,19,0,13,26,58
7/10/1979,19,0,26,12,57
7/11/1979,21,0,18,33,72
7/12/1979,26,0,22,20,68
7/13/1979,23,0,26,21,70
7/14/1979,17,0,21,18,56
7/15/1979,30,0,31,28,89
7/16/1979,19,0,11,12,42
7/17/1979,19,0,17,8,44
7/18/1979,27,0,15,4,46
7/19/1979,20,0,16,27,63
7/20/1979,19,0,11,19,49
7/21/1979,29,0,26,20,75
7/22/1979,24,0,22,20,66
7/23/1979,32,0,22,20,74
7/24/1979,24,0,17,28,69
7/25/1979,25,0,23,18,66
7/26/1979,27,0,12,15,54
7/27/1979,28,0,23,26,77
7/28/1979,23,0,21,7,51
7/29/1979,25,0,17,21,63
7/30/1979,22,0,11,5,38
7/31/1979,16,0,15,31,62
8/1/1979,21,0,20,9,50
8/2/1979,28,0,30,25,83
8/3/1979,24,0,19,29,72
8/4/1979,20,0,14,20,54
8/5/1979,28,0,16,25,69
8/6/1979,19,0,23,20,62
8/7/1979,25,0,25,15,65
8/8/1979,16,0,23,19,58
8/9/1979,28,0,26,17,71
8/10/1979,20,0,18,17,55
8/11/1979,22,0,20,31,73
8/12/1979,29,0,14,18,61
8/13/1979,30,0,26,18,74
8/14/1979,28,0,18,33,79
8/15/1979,26,0,28,15,69
8/16/1979,23,0,20,15,58
8/17/1979,15,0,11,29,55
8/18/1979,27,0,25,25,77
8/19/1979,21,0,18,13,52
8/20/1979,31,0,17,20,68
8/21/1979,28,0,19,19,66
8/22/1979,26,0,22,18,66
8/23/1979,20,0,14,22,56
8/24/1979,19,0,29,18,66
8/25/1979,25,0,18,10,53
8/26/1979,22,0,25,20,67
8/27/1979,19,0,18,20,57
8/28/1979,21,0,21,29,71
8/29/1979,18,0,27,19,64
8/30/1979,17,0,10,24,51
8/31/1979,26,0,9,16,51
9/1/1979,19,0,17,32,68
9/2/1979,18,0,25,22,65
9/3/1979,17,0,28,9,54
9/4/1979,13,0,14,13,40
9/5/1979,21,0,26,25,72
9/6/1979,22,0,18,33,73
9/7/1979,26,0,23,11,60
9/8/1979,33,0,11,22,66
9/9/1979,34,0,26,20,80
9/10/1979,22,0,19,12,53
9/11/1979,20,0,25,21,66
9/12/1979,25,0,18,18,61
9/13/1979,35,0,7,17,59
9/14/1979,27,0,20,19,66
9/15/1979,25,0,18,15,58
9/16/1979,23,0,21,30,74
9/17/1979,20,0,16,26,62
9/18/1979,26,0,18,22,66
9/19/1979,22,0,22,24,68
9/20/1979,17,0,9,16,42
9/21/1979,11,0,21,11,43
9/22/1979,24,0,15,15,54
9/23/1979,23,0,22,15,60
9/24/1979,21,0,14,18,53
9/25/1979,22,0,31,29,82
9/26/1979,26,0,21,25,72
9/27/1979,29,0,15,25,69
9/28/1979,26,0,17,8,51
9/29/1979,26,0,10,17,53
9/30/1979,26,0,22,16,64
10/1/1979,21,0,15,14,50
10/2/1979,28,0,24,14,66
10/3/1979,27,0,23,27,77
10/4/1979,21,0,26,15,62
10/5/1979,20,0,19,37,76
10/6/1979,20,0,19,26,65
10/7/1979,15,0,19,30,64
10/8/1979,28,0,26,19,73
10/9/1979,24,0,23,8,55
10/10/1979,31,0,14,14,59
10/11/1979,14,0,22,22,58
10/12/1979,20,0,22,34,76
10/13/1979,29,0,16,27,72
10/14/1979,26,0,19,13,58
10/15/1979,23,0,21,18,62
10/16/1979,29,0,24,8,61
10/17/1979,21,0,13,35,69
10/18/1979,27,0,25,12,64
10/19/1979,21,0,16,12,49
10/20/1979,30,0,22,36,88
10/21/1979,27,0,15,29,71
10/22/1979,19,0,13,31,63
10/23/1979,21,0,16,25,62
10/24/1979,18,0,23,14,55
10/25/1979,21,0,25,5,51
10/26/1979,18,0,10,19,47
10/27/1979,33,0,24,26,83
10/28/1979,21,0,30,20,71
10/29/1979,21,0,21,26,68
10/30/1979,30,0,17,13,60
10/31/1979,29,0,18,17,64
11/1/1979,20,0,13,24,57
11/2/1979,22,0,21,31,74
11/3/1979,18,0,9,29,56
11/4/1979,25,0,22,35,82
11/5/1979,17,0,14,20,51
11/6/1979,16,0,11,26,53
11/7/1979,23,0,19,20,62
11/8/1979,30,0,26,19,75
11/9/1979,17,0,22,3,42
11/10/1979,29,0,17,19,65
11/11/1979,24,0,14,17,55
11/12/1979,22,0,16,22,60
11/13/1979,26,0,9,19,54
11/14/1979,21,0,16,21,58
11/15/1979,35,0,17,15,67
11/16/1979,28,0,17,24,69
11/17/1979,21,0,25,24,70
11/18/1979,22,0,21,14,57
11/19/1979,16,0,22,16,54
11/20/1979,25,0,30,10,65
11/21/1979,21,0,15,18,54
11/22/1979,24,0,7,19,50
11/23/1979,27,0,28,18,73
11/24/1979,17,0,23,5,45
11/25/1979,18,0,25,31,74
11/26/1979,29,0,30,10,69
11/27/1979,21,0,27,24,72
11/28/1979,21,0,14,12,47
11/29/1979,28,0,18,6,52
11/30/1979,27,0,20,10,57
12/1/1979,22,0,20,14,56
12/2/1979,22,0,17,21,60
12/3/1979,29,0,20,25,74
12/4/1979,28,0,28,33,89
12/5/1979,18,0,8,20,46
12/6/1979,28,0,14,14,56
12/7/1979,28,0,21,33,82
12/8/1979,23,0,8,24,55
12/9/1979,12,0,20,17,49
12/10/1979,27,0,21,13,61
12/11/1979,14,0,18,11,43
12/12/1979,15,0,10,24,49
12/13/1979,14,0,21,16,51
12/14/1979,23,0,17,20,60
12/15/1979,33,0,20,22,75
12/16/1979,13,0,29,21,63
12/17/1979,26,0,22,5,53
12/18/1979,19,0,22,22,63
12/19/1979,26,0,18,14,58
12/20/1979,17,0,22,8,47
12/21/1979,13,0,15,11,39
12/22/1979,23,0,21,19,63
12/23/1979,22,0,14,21,57
12/24/1979,16,0,29,12,57
12/25/1979,29,0,15,10,54
12/26/1979,24,0,22,12,58
12/27/1979,26,0,16,17,59
12/28/1979,18,0,25,31,74
12/29/1979,15,0,27,21,63
12/30/1979,24,0,15,15,54
12/31/1979,24,0,18,33,75
1/1/1980,29,0,20,14,63
1/2/1980,20,0,21,36,77
1/3/1980,20,0,18,27,65
1/4/1980,20,0,28,22,70
1/5/1980,27,0,10,15,52
1/6/1980,14,0,10,9,33
1/7/1980,23,0,15,20,58
1/8/1980,19,0,8,19,46
1/9/1980,24,0,19,15,58
1/10/1980,29,0,18,12,59
1/11/1980,21,0,11,31,63
1/12/1980,25,0,17,21,63
1/13/1980,27,0,30,26,83
1/14/1980,19,0,23,22,64
1/15/1980,28,0,14,20,62
1/16/1980,20,0,29,21,70
1/17/1980,15,0,15,20,50
1/18/1980,28,0,15,30,73
1/19/1980,29,0,15,23,67
1/20/1980,31,0,28,29,88
1/21/1980,31,0,13,16,60
1/22/1980,26,0,15,17,58
1/23/1980,14,0,23,25,62
1/24/1980,30,0,26,15,71
1/25/1980,27,0,31,22,80
1/26/1980,24,0,24,10,58
1/27/1980,16,0,15,24,55
1/28/1980,22,0,25,28,75
1/29/1980,20,0,13,15,48
1/30/1980,26,0,19,17,62
1/31/1980,22,0,24,23,69
2/1/1980,22,0,19,12,53
2/2/1980,26,0,23,33,82
2/3/1980,33,0,17,16,66
2/4/1980,24,0,10,24,58
2/5/1980,28,0,29,15,72
2/6/1980,21,0,25,6,52
2/7/1980,30,0,21,23,74
2/8/1980,17,0,26,19,62
2/9/1980,15,0,15,17,47
2/10/1980,31,0,24,21,76
2/11/1980,20,0,21,5,46
2/12/1980,27,0,28,9,64
2/13/1980,21,0,20,20,61
2/14/1980,32,0,25,24,81
2/15/1980,22,0,17,26,65
2/16/1980,26,0,29,19,74
2/17/1980,18,0,25,14,57
2/18/1980,21,0,21,29,71
2/19/1980,20,0,24,35,79
2/20/1980,17,0,24,4,45
2/21/1980,25,0,25,35,85
2/22/1980,22,0,11,24,57
2/23/1980,29,0,16,12,57
2/24/1980,26,0,8,9,43
2/25/1980,19,0,22,20,61
2/26/1980,28,0,22,19,69
2/27/1980,22,0,20,26,68
2/28/1980,24,0,27,25,76
2/29/1980,22,0,19,19,60
3/1/1980,19,0,16,9,44
3/2/1980,21,0,17,18,56
3/3/1980,23,0,23,31,77
3/4/1980,24,0,23,7,54
3/5/1980,19,0,14,17,50
3/6/1980,24,0,29,18,71
3/7/1980,34,0,24,19,77
3/8/1980,30,0,19,23,72
3/9/1980,26,0,16,22,64
3/10/1980,18,0,20,32,70
3/11/1980,31,0,21,18,70
3/12/1980,23,0,14,30,67
3/13/1980,21,0,15,11,47
3/14/1980,19,0,26,11,56
3/15/1980,17,0,11,20,48
3/16/1980,27,0,18,26,71
3/17/1980,21,0,25,25,71
3/18/1980,24,0,12,23,59
3/19/1980,24,0,23,17,64
3/20/1980,21,0,18,24,63
3/21/1980,24,0,23,21,68
3/22/1980,26,0,20,13,59
3/23/1980,20,0,12,23,55
3/24/1980,18,0,26,17,61
3/25/1980,15,0,10,22,47
3/26/1980,20,0,17,25,62
3/27/1980,31,0,21,17,69
3/28/1980,23,0,27,17,67
3/29/1980,23,0,24,26,73
3/30/1980,32,0,21,17,70
3/31/1980,15,0,18,18,51
4/1/1980,17,0,17,21,55
4/2/1980,25,0,18,22,65
4/3/1980,32,0,24,18,74
4/4/1980,26,0,14,20,60
4/5/1980,14,0,19,24,57
4/6/1980,20,0,8,16,44
4/7/1980,23,0,21,32,76
4/8/1980,25,0,25,20,70
4/9/1980,22,0,28,27,77
4/10/1980,22,0,24,14,60
4/11/1980,26,0,20,4,50
4/12/1980,20,0,20,14,54
4/13/1980,22,0,18,15,55
4/14/1980,32,0,12,14,58
4/15/1980,31,0,13,30,74
4/16/1980,25,0,14,14,53
4/17/1980,22,0,12,25,59
4/18/1980,24,0,32,31,87
4/19/1980,20,0,15,19,54
4/20/1980,17,0,18,29,64
4/21/1980,17,0,22,20,59
4/22/1980,21,0,17,28,66
4/23/1980,29,0,24,22,75
4/24/1980,24,0,21,11,56
4/25/1980,32,0,19,10,61
4/26/1980,26,0,22,28,76
4/27/1980,21,0,19,3,43
4/28/1980,19,0,11,11,41
4/29/1980,22,0,17,10,49
4/30/1980,15,0,24,22,61
5/1/1980,19,0,19,26,64
5/2/1980,20,0,31,7,58
5/3/1980,23,0,21,25,69
5/4/1980,27,0,22,17,66
5/5/1980,28,0,8,25,61
5/6/1980,18,0,13,29,60
5/7/1980,30,0,17,23,70
5/8/1980,17,0,27,15,59
5/9/1980,22,0,28,15,65
5/10/1980,28,0,16,16,60
5/11/1980,20,0,18,30,68
5/12/1980,29,0,22,5,56
5/13/1980,26,0,20,4,50
5/14/1980,31,0,22,21,74
5/15/1980,25,0,11,13,49
5/16/1980,19,0,19,16,54
5/17/1980,29,0,22,35,86
5/18/1980,16,0,22,21,59
5/19/1980,26,0,32,18,76
5/20/1980,27,0,19,24,70
5/21/1980,30,0,17,14,61
5/22/1980,23,0,20,22,65
5/23/1980,30,0,17,22,69
5/24/1980,31,0,21,0,52
5/25/1980,29,0,24,26,79
5/26/1980,29,0,29,21,79
5/27/1980,19,0,13,21,53
5/28/1980,30,0,25,14,69
5/29/1980,27,0,25,29,81
5/30/1980,23,0,23,11,57
5/31/1980,24,0,19,27,70
6/1/1980,27,0,17,20,64
6/2/1980,32,0,21,14,67
6/3/1980,22,0,18,10,50
6/4/1980,14,0,18,23,55
6/5/1980,26,0,12,24,62
6/6/1980,16,0,22,32,70
6/7/1980,19,0,16,20,55
6/8/1980,24,0,16,17,57
6/9/1980,15,0,24,15,54
6/10/1980,20,0,28,23,71
6/11/1980,20,0,24,22,66
6/12/1980,23,0,28,26,77
6/13/1980,22,0,13,12,47
6/14/1980,25,0,23,9,57
6/15/1980,25,0,22,20,67
6/16/1980,20,0,23,10,53
6/17/1980,21,0,22,24,67
6/18/1980,18,0,19,13,50
6/19/1980,17,0,9,21,47
6/20/1980,20,0,11,20,51
6/21/1980,26,0,7,19,52
6/22/1980,32,0,11,21,64
6/23/1980,28,0,19,17,64
6/24/1980,28,0,21,9,58
6/25/1980,18,0,13,15,46
6/26/1980,22,0,10,18,50
6/27/1980,17,0,30,19,66
6/28/1980,23,0,20,31,74
6/29/1980,20,0,18,25,63
6/30/1980,26,0,19,15,60
7/1/1980,17,0,19,32,68
7/2/1980,30,0,27,18,75
7/3/1980,27,0,17,14,58
7/4/1980,23,0,27,16,66
7/5/1980,18,0,13,35,66
7/6/1980,20,0,19,34,73
7/7/1980,19,0,18,25,62
7/8/1980,19,0,26,29,74
7/9/1980,29,0,25,21,75
7/10/1980,17,0,19,5,41
7/11/1980,16,0,14,14,44
7/12/1980,20,0,18,25,63
7/13/1980,13,0,17,18,48
7/14/1980,29,0,13,20,62
7/15/1980,27,0,19,13,59
7/16/1980,25,0,29,34,88
7/17/1980,28,0,23,26,77
7/18/1980,28,0,17,12,57
7/19/1980,32,0,14,20,66
7/20/1980,26,0,26,8,60
7/21/1980,24,0,7,8,39
7/22/1980,22,0,21,29,72
7/23/1980,29,0,26,27,82
7/24/1980,25,0,24,18,67
7/25/1980,25,0,16,18,59
7/26/1980,24,0,17,12,53
7/27/1980,23,0,14,22,59
7/28/1980,20,0,16,27,63
7/29/1980,17,0,27,20,64
7/30/1980,29,0,16,17,62
7/31/1980,25,0,27,16,68
8/1/1980,20,0,14,15,49
8/2/1980,35,0,17,16,68
8/3/1980,22,0,14,4,40
8/4/1980,29,0,19,14,62
8/5/1980,20,0,20,8,48
8/6/1980,21,0,31,17,69
8/7/1980,16,0,18,21,55
8/8/1980,14,0,13,19,46
8/9/1980,17,0,25,29,71
8/10/1980,21,0,24,29,74
8/11/1980,19,0,26,15,60
8/12/1980,17,0,11,24,52
8/13/1980,13,0,17,21,51
8/14/1980,19,0,22,22,63
8/15/1980,23,0,10,22,55
8/16/1980,29,0,18,19,66
8/17/1980,17,0,22,15,54
8/18/1980,30,0,18,20,68
8/19/1980,25,0,14,19,58
8/20/1980,26,0,9,14,49
8/21/1980,13,0,13,26,52
8/22/1980,19,0,14,29,62
8/23/1980,18,0,23,18,59
8/24/1980,25,0,25,13,63
8/25/1980,23,0,25,6,54
8/26/1980,27,0,23,11,61
8/27/1980,26,0,29,19,74
8/28/1980,25,0,11,22,58
8/29/1980,21,0,28,32,81
8/30/1980,21,0,20,31,72
8/31/1980,24,0,16,18,58
9/1/1980,22,0,10,24,56
9/2/1980,21,0,9,30,60
9/3/1980,30,0,16,16,62
9/4/1980,28,0,15,17,60
9/5/1980,23,0,20,17,60
9/6/1980,23,0,25,9,57
9/7/1980,25,0,25,13,63
9/8/1980,22,0,11,30,63
9/9/1980,34,0,15,0,49
9/10/1980,23,0,30,36,89
9/11/1980,24,0,25,14,63
9/12/1980,32,0,13,16,61
9/13/1980,19,0,19,21,59
9/14/1980,23,0,20,22,65
9/15/1980,22,0,22,27,71
9/16/1980,18,0,19,13,50
9/17/1980,24,0,29,18,71
9/18/1980,16,0,21,12,49
9/19/1980,22,0,16,18,56
9/20/1980,27,0,23,24,74
9/21/1980,32,0,21,24,77
9/22/1980,22,0,27,18,67
9/23/1980,26,0,18,7,51
9/24/1980,30,0,24,28,82
9/25/1980,18,0,10,19,47
9/26/1980,28,0,19,10,57
9/27/1980,28,0,17,22,67
9/28/1980,22,0,22,25,69
9/29/1980,23,0,19,27,69
9/30/1980,27,0,13,15,55
10/1/1980,14,0,21,24,59
10/2/1980,27,0,18,29,74
10/3/1980,31,0,18,35,84
10/4/1980,18,0,22,20,60
10/5/1980,26,0,18,35,79
10/6/1980,15,0,23,17,55
10/7/1980,28,0,30,15,73
10/8/1980,29,0,28,8,65
10/9/1980,25,0,23,26,74
10/10/1980,21,0,26,21,68
10/11/1980,28,0,13,20,61
10/12/1980,31,0,19,13,63
10/13/1980,21,0,17,26,64
10/14/1980,17,0,24,21,62
10/15/1980,27,0,28,28,83
10/16/1980,21,0,21,18,60
10/17/1980,17,0,25,21,63
10/18/1980,19,0,9,14,42
10/19/1980,15,0,20,20,55
10/20/1980,14,0,24,25,63
10/21/1980,29,0,14,18,61
10/22/1980,25,0,20,17,62
10/23/1980,25,0,23,23,71
10/24/1980,31,0,25,14,70
10/25/1980,26,0,22,14,62
10/26/1980,19,0,17,10,46
10/27/1980,21,0,21,13,55
10/28/1980,27,0,30,32,89
10/29/1980,28,0,20,19,67
10/30/1980,19,0,14,22,55
10/31/1980,26,0,27,20,73
11/1/1980,23,0,20,27,70
11/2/1980,29,0,10,30,69
11/3/1980,25,0,10,37,72
11/4/1980,23,0,10,16,49
11/5/1980,28,0,24,32,84
11/6/1980,30,0,22,21,73
11/7/1980,22,0,25,15,62
11/8/1980,26,0,12,17,55
11/9/1980,11,0,16,11,38
11/10/1980,23,0,25,3,51
11/11/1980,21,0,21,20,62
11/12/1980,29,0,13,22,64
11/13/1980,24,0,21,22,67
11/14/1980,18,0,20,22,60
11/15/1980,17,0,16,18,51
11/16/1980,28,0,27,30,85
11/17/1980,20,0,26,34,80
11/18/1980,17,0,22,15,54
11/19/1980,25,0,22,12,59
11/20/1980,19,0,27,28,74
11/21/1980,22,0,21,28,71
11/22/1980,25,0,30,30,85
11/23/1980,16,0,29,9,54
11/24/1980,30,0,23,17,70
11/25/1980,21,0,22,25,68
11/26/1980,16,0,16,17,49
11/27/1980,34,0,27,27,88
11/28/1980,21,0,30,20,71
11/29/1980,15,0,14,8,37
11/30/1980,28,0,17,23,68
12/1/1980,23,0,19,11,53
12/2/1980,34,0,15,20,69
12/3/1980,15,0,18,16,49
12/4/1980,22,0,13,26,61
12/5/1980,22,0,22,24,68
12/6/1980,14,0,13,17,44
12/7/1980,14,0,29,14,57
12/8/1980,26,0,25,36,87
12/9/1980,24,0,9,25,58
12/10/1980,21,0,22,19,62
12/11/1980,18,0,23,29,70
12/12/1980,19,0,13,21,53
12/13/1980,19,0,12,15,46
12/14/1980,25,0,28,15,68
12/15/1980,14,0,32,22,68
12/16/1980,29,0,26,13,68
12/17/1980,28,0,17,3,48
12/18/1980,25,0,12,13,50
12/19/1980,22,0,27,10,59
12/20/1980,15,0,12,18,45
12/21/1980,21,0,18,25,64
12/22/1980,25,0,18,24,67
12/23/1980,18,0,21,10,49
12/24/1980,24,0,29,5,58
12/25/1980,20,0,23,9,52
12/26/1980,33,0,19,31,83
12/27/1980,25,0,15,30,70
12/28/1980,27,0,8,23,58
12/29/1980,24,0,28,21,73
12/30/1980,18,0,13,22,53
12/31/1980,27,0,20,24,71
1/1/1981,21,0,25,28,74
1/2/1981,26,0,15,32,73
1/3/1981,23,0,25,24,72
1/4/1981,16,0,21,29,66
1/5/1981,22,0,13,15,50
1/6/1981,17,0,22,7,46
1/7/1981,23,0,16,15,54
1/8/1981,15,0,28,12,55
1/9/1981,18,0,18,24,60
1/10/1981,26,0,22,24,72
1/11/1981,18,0,22,19,59
1/12/1981,18,0,15,25,58
1/13/1981,22,0,25,16,63
1/14/1981,25,0,7,17,49
1/15/1981,31,0,12,35,78
1/16/1981,21,0,16,32,69
1/17/1981,27,0,12,17,56
1/18/1981,14,0,17,21,52
1/19/1981,20,0,26,28,74
1/20/1981,31,0,16,15,62
1/21/1981,31,0,24,23,78
1/22/1981,19,0,17,23,59
1/23/1981,25,0,24,12,61
1/24/1981,30,0,11,20,61
1/25/1981,21,0,28,25,74
1/26/1981,22,0,17,16,55
1/27/1981,25,0,13,18,56
1/28/1981,19,0,20,13,52
1/29/1981,24,0,23,27,74
1/30/1981,25,0,11,7,43
1/31/1981,21,0,27,29,77
2/1/1981,21,0,27,16,64
2/2/1981,30,0,18,7,55
2/3/1981,19,0,21,15,55
2/4/1981,20,0,27,14,61
2/5/1981,16,0,23,22,61
2/6/1981,15,0,19,19,53
2/7/1981,16,0,23,12,51
2/8/1981,27,0,18,30,75
2/9/1981,31,0,21,12,64
2/10/1981,30,0,20,12,62
2/11/1981,23,0,27,12,62
2/12/1981,22,0,20,8,50
2/13/1981,25,0,24,20,69
2/14/1981,22,0,32,16,70
2/15/1981,20,0,21,27,68
2/16/1981,17,0,13,16,46
2/17/1981,17,0,25,25,67
2/18/1981,18,0,9,21,48
2/19/1981,22,0,14,18,54
2/20/1981,28,0,20,25,73
2/21/1981,18,0,20,15,53
2/22/1981,33,0,24,19,76
2/23/1981,24,0,22,26,72
2/24/1981,28,0,31,4,63
2/25/1981,18,0,14,27,59
2/26/1981,14,0,16,17,47
2/27/1981,15,0,26,23,64
2/28/1981,14,0,20,27,61
3/1/1981,20,0,19,17,56
3/2/1981,21,0,18,17,56
3/3/1981,23,0,31,13,67
3/4/1981,22,0,17,18,57
3/5/1981,22,0,23,16,61
3/6/1981,21,0,17,19,57
3/7/1981,35,0,28,18,81
3/8/1981,27,0,13,22,62
3/9/1981,25,0,16,19,60
3/10/1981,25,0,14,24,63
3/11/1981,20,0,16,24,60
3/12/1981,18,0,23,11,52
3/13/1981,28,0,17,31,76
3/14/1981,25,0,13,21,59
3/15/1981,26,0,20,31,77
3/16/1981,26,0,13,16,55
3/17/1981,19,0,26,22,67
3/18/1981,23,0,20,32,75
3/19/1981,28,0,24,28,80
3/20/1981,25,0,16,18,59
3/21/1981,29,0,20,26,75
3/22/1981,19,0,21,10,50
3/23/1981,25,0,20,19,64
3/24/1981,24,0,25,21,70
3/25/1981,14,0,15,25,54
3/26/1981,19,0,27,17,63
3/27/1981,22,0,27,14,63
3/28/1981,24,0,30,15,69
3/29/1981,26,0,13,21,60
3/30/1981,26,0,26,12,64
3/31/1981,21,0,10,26,57
4/1/1981,30,0,22,37,89
4/2/1981,21,0,19,17,57
4/3/1981,32,0,14,19,65
4/4/1981,26,0,14,14,54
4/5/1981,20,0,10,27,57
4/6/1981,26,0,19,28,73
4/7/1981,17,0,21,15,53
4/8/1981,26,0,22,20,68
4/9/1981,28,0,10,20,58
4/10/1981,19,0,20,29,68
4/11/1981,31,0,14,10,55
4/12/1981,18,0,19,19,56
4/13/1981,26,0,17,12,55
4/14/1981,22,0,24,28,74
4/15/1981,30,0,13,30,73
4/16/1981,22,0,24,35,81
4/17/1981,25,0,19,18,62
4/18/1981,25,0,12,14,51
4/19/1981,29,0,19,24,72
4/20/1981,25,0,21,22,68
4/21/1981,29,0,23,25,77
4/22/1981,25,0,23,10,58
4/23/1981,23,0,11,25,59
4/24/1981,29,0,21,22,72
4/25/1981,13,0,24,26,63
4/26/1981,20,0,13,20,53
4/27/1981,24,0,30,21,75
4/28/1981,18,0,22,17,57
4/29/1981,23,0,24,3,50
4/30/1981,16,0,23,24,63
5/1/1981,27,0,20,11,58
5/2/1981,25,0,16,30,71
5/3/1981,33,0,23,20,76
5/4/1981,27,0,18,15,60
5/5/1981,25,0,14,26,65
5/6/1981,23,0,23,17,63
5/7/1981,17,0,22,25,64
5/8/1981,22,0,12,17,51
5/9/1981,22,0,20,15,57
5/10/1981,19,0,27,10,56
5/11/1981,11,0,23,21,55
5/12/1981,27,0,11,27,65
5/13/1981,26,0,20,23,69
5/14/1981,19,0,20,20,59
5/15/1981,27,0,18,20,65
5/16/1981,20,0,14,15,49
5/17/1981,19,0,27,20,66
5/18/1981,19,0,29,20,68
5/19/1981,13,0,27,17,57
5/20/1981,26,0,22,24,72
5/21/1981,25,0,24,11,60
5/22/1981,33,0,18,7,58
5/23/1981,18,0,9,25,52
5/24/1981,28,0,25,14,67
5/25/1981,25,0,17,11,53
5/26/1981,30,0,17,13,60
5/27/1981,15,0,23,24,62
5/28/1981,28,0,18,18,64
5/29/1981,22,0,24,21,67
5/30/1981,23,0,11,20,54
5/31/1981,20,0,23,30,73
6/1/1981,30,0,27,17,74
6/2/1981,23,0,23,19,65
6/3/1981,29,0,23,13,65
6/4/1981,27,0,16,18,61
6/5/1981,27,0,25,14,66
6/6/1981,21,0,11,17,49
6/7/1981,23,0,24,21,68
6/8/1981,25,0,8,27,60
6/9/1981,21,0,24,29,74
6/10/1981,24,0,15,19,58
6/11/1981,24,0,19,25,68
6/12/1981,16,0,15,23,54
6/13/1981,22,0,19,25,66
6/14/1981,26,0,20,6,52
6/15/1981,20,0,31,18,69
6/16/1981,23,0,22,27,72
6/17/1981,18,0,21,14,53
6/18/1981,19,0,24,33,76
6/19/1981,23,0,21,29,73
6/20/1981,22,0,11,16,49
6/21/1981,14,0,24,21,59
6/22/1981,28,0,19,21,68
6/23/1981,30,0,18,16,64
6/24/1981,20,0,19,25,64
6/25/1981,24,0,27,22,73
6/26/1981,16,0,22,22,60
6/27/1981,24,0,25,18,67
6/28/1981,24,0,16,10,50
6/29/1981,10,0,18,28,56
6/30/1981,24,0,23,18,65
7/1/1981,25,0,20,36,81
7/2/1981,21,0,21,14,56
7/3/1981,15,0,12,37,64
7/4/1981,17,0,21,25,63
7/5/1981,33,0,20,23,76
7/6/1981,26,0,25,9,60
7/7/1981,19,0,14,27,60
7/8/1981,20,0,24,19,63
7/9/1981,28,0,27,19,74
7/10/1981,31,0,24,14,69
7/11/1981,20,0,24,33,77
7/12/1981,29,0,23,11,63
7/13/1981,27,0,20,26,73
7/14/1981,17,0,11,18,46
7/15/1981,24,0,27,26,77
7/16/1981,27,0,21,13,61
7/17/1981,25,0,27,11,63
7/18/1981,24,0,16,19,59
7/19/1981,24,0,12,32,68
7/20/1981,20,0,11,9,40
7/21/1981,24,0,22,15,61
7/22/1981,24,0,19,24,67
7/23/1981,25,0,22,21,68
7/24/1981,19,0,22,26,67
7/25/1981,15,0,32,20,67
7/26/1981,25,0,11,16,52
7/27/1981,22,0,19,28,69
7/28/1981,19,0,25,22,66
7/29/1981,27,0,10,16,53
7/30/1981,19,0,21,18,58
7/31/1981,23,0,23,13,59
8/1/1981,27,0,23,15,65
8/2/1981,20,0,12,22,54
8/3/1981,26,0,16,17,59
8/4/1981,19,0,23,16,58
8/5/1981,21,0,16,8,45
8/6/1981,17,0,31,23,71
8/7/1981,21,0,21,13,55
8/8/1981,22,0,25,7,54
8/9/1981,20,0,15,22,57
8/10/1981,13,0,24,10,47
8/11/1981,23,0,15,21,59
8/12/1981,31,0,17,25,73
8/13/1981,19,0,19,17,55
8/14/1981,24,0,9,18,51
8/15/1981,27,0,16,32,75
8/16/1981,32,0,19,10,61
8/17/1981,20,0,25,37,82
8/18/1981,15,0,16,26,57
8/19/1981,19,0,14,23,56
8/20/1981,31,0,26,20,77
8/21/1981,25,0,27,16,68
8/22/1981,21,0,26,19,66
8/23/1981,29,0,15,30,74
8/24/1981,26,0,17,29,72
8/25/1981,30,0,11,13,54
8/26/1981,31,0,17,11,59
8/27/1981,24,0,25,23,72
8/28/1981,22,0,16,13,51
8/29/1981,26,0,22,23,71
8/30/1981,21,0,14,18,53
8/31/1981,15,0,22,29,66
9/1/1981,13,0,22,16,51
9/2/1981,25,0,22,29,76
9/3/1981,26,0,24,11,61
9/4/1981,26,0,25,14,65
9/5/1981,32,0,14,23,69
9/6/1981,25,0,24,37,86
9/7/1981,30,0,24,10,64
9/8/1981,26,0,19,29,74
9/9/1981,28,0,11,17,56
9/10/1981,21,0,29,22,72
9/11/1981,26,0,20,15,61
9/12/1981,30,0,21,12,63
9/13/1981,22,0,16,18,56
9/14/1981,19,0,30,24,73
9/15/1981,26,0,15,31,72
9/16/1981,25,0,15,23,63
9/17/1981,24,0,18,27,69
9/18/1981,18,0,17,16,51
9/19/1981,20,0,26,26,72
9/20/1981,16,0,13,28,57
9/21/1981,19,0,24,14,57
9/22/1981,23,0,10,9,42
9/23/1981,28,0,21,18,67
9/24/1981,27,0,23,21,71
9/25/1981,19,0,26,20,65
9/26/1981,19,0,22,17,58
9/27/1981,17,0,26,13,56
9/28/1981,16,0,18,25,59
9/29/1981,32,0,12,5,49
9/30/1981,23,0,19,30,72
10/1/1981,24,0,23,15,62
10/2/1981,32,0,25,14,71
10/3/1981,30,0,20,14,64
10/4/1981,24,0,14,31,69
10/5/1981,20,0,24,21,65
10/6/1981,27,0,12,40,79
10/7/1981,34,0,22,24,80
10/8/1981,23,0,23,8,54
10/9/1981,14,0,16,4,34
10/10/1981,14,0,17,32,63
10/11/1981,26,0,21,22,69
10/12/1981,18,0,19,21,58
10/13/1981,31,0,19,21,71
10/14/1981,12,0,23,15,50
10/15/1981,24,0,17,17,58
10/16/1981,27,0,26,16,69
10/17/1981,26,0,29,19,74
10/18/1981,34,0,24,25,83
10/19/1981,19,0,22,27,68
10/20/1981,21,0,17,13,51
10/21/1981,23,0,24,13,60
10/22/1981,15,0,14,26,55
10/23/1981,17,0,16,30,63
10/24/1981,23,0,16,13,52
10/25/1981,18,0,25,13,56
10/26/1981,22,0,27,14,63
10/27/1981,18,0,30,17,65
10/28/1981,20,0,18,19,57
10/29/1981,23,0,22,13,58
10/30/1981,31,0,13,24,68
10/31/1981,24,0,12,32,68
11/1/1981,22,0,22,25,69
11/2/1981,29,0,19,18,66
11/3/1981,22,0,24,29,75
11/4/1981,14,0,18,8,40
11/5/1981,24,0,13,22,59
11/6/1981,25,0,26,15,66
11/7/1981,29,0,8,23,60
11/8/1981,27,0,28,22,77
11/9/1981,23,0,21,26,70
11/10/1981,21,0,16,22,59
11/11/1981,26,0,18,10,54
11/12/1981,17,0,18,29,64
11/13/1981,25,0,17,17,59
11/14/1981,26,0,27,18,71
11/15/1981,16,0,9,25,50
11/16/1981,24,0,17,23,64
11/17/1981,22,0,18,27,67
11/18/1981,25,0,7,15,47
11/19/1981,23,0,9,25,57
11/20/1981,22,0,18,25,65
11/21/1981,28,0,18,21,67
11/22/1981,24,0,11,14,49
11/23/1981,27,0,19,29,75
11/24/1981,19,0,15,18,52
11/25/1981,31,0,25,16,72
11/26/1981,32,0,8,12,52
11/27/1981,21,0,26,9,56
11/28/1981,22,0,26,10,58
11/29/1981,17,0,13,18,48
11/30/1981,21,0,27,13,61
12/1/1981,19,0,13,10,42
12/2/1981,27,0,16,27,70
12/3/1981,24,0,26,4,54
12/4/1981,25,0,22,12,59
12/5/1981,28,0,20,29,77
12/6/1981,20,0,19,25,64
12/7/1981,20,0,25,30,75
12/8/1981,26,0,27,13,66
12/9/1981,17,0,14,28,59
12/10/1981,27,0,22,25,74
12/11/1981,22,0,9,28,59
12/12/1981,21,0,22,17,60
12/13/1981,21,0,9,22,52
12/14/1981,26,0,14,24,64
12/15/1981,28,0,14,23,65
12/16/1981,19,0,13,21,53
12/17/1981,18,0,17,13,48
12/18/1981,28,0,28,19,75
12/19/1981,32,0,25,40,97
12/20/1981,26,0,19,12,57
12/21/1981,23,0,21,15,59
12/22/1981,20,0,21,14,55
12/23/1981,28,0,24,17,69
12/24/1981,32,0,23,31,86
12/25/1981,14,0,14,14,42
12/26/1981,29,0,23,15,67
12/27/1981,30,0,21,22,73
12/28/1981,14,0,25,22,61
12/29/1981,17,0,22,34,73
12/30/1981,10,0,17,25,52
12/31/1981,15,0,28,7,50
1/1/1982,28,0,18,30,76
1/2/1982,18,0,13,13,44
1/3/1982,13,0,17,29,59
1/4/1982,25,0,18,29,72
1/5/1982,17,0,25,27,69
1/6/1982,17,0,23,22,62
1/7/1982,22,0,20,21,63
1/8/1982,14,0,22,20,56
1/9/1982,22,0,18,27,67
1/10/1982,11,0,30,35,76
1/11/1982,25,0,21,16,62
1/12/1982,18,0,18,22,58
1/13/1982,22,0,25,31,78
1/14/1982,27,0,13,30,70
1/15/1982,25,0,19,20,64
1/16/1982,27,0,15,15,57
1/17/1982,35,0,13,12,60
1/18/1982,24,0,26,28,78
1/19/1982,20,0,16,21,57
1/20/1982,17,0,18,26,61
1/21/1982,22,0,17,28,67
1/22/1982,32,0,16,27,75
1/23/1982,21,0,17,18,56
1/24/1982,17,0,31,32,80
1/25/1982,15,0,21,14,50
1/26/1982,29,0,27,23,79
1/27/1982,25,0,21,15,61
1/28/1982,15,0,14,17,46
1/29/1982,18,0,24,24,66
1/30/1982,25,0,28,13,66
1/31/1982,21,0,23,27,71
2/1/1982,13,0,22,27,62
2/2/1982,18,0,17,7,42
2/3/1982,29,0,24,23,76
2/4/1982,29,0,21,9,59
2/5/1982,24,0,14,36,74
2/6/1982,28,0,23,24,75
2/7/1982,22,0,25,20,67
2/8/1982,22,0,23,32,77
2/9/1982,21,0,30,7,58
2/10/1982,21,0,24,34,79
2/11/1982,20,0,27,31,78
2/12/1982,29,0,25,31,85
2/13/1982,33,0,22,25,80
2/14/1982,18,0,18,24,60
2/15/1982,21,0,25,26,72
2/16/1982,25,0,16,18,59
2/17/1982,31,0,29,11,71
2/18/1982,18,0,22,18,58
2/19/1982,22,0,22,22,66
2/20/1982,22,0,22,17,61
2/21/1982,16,0,14,25,55
2/22/1982,21,0,7,24,52
2/23/1982,32,0,12,21,65
2/24/1982,30,0,28,29,87
2/25/1982,21,0,31,15,67
2/26/1982,21,0,13,19,53
2/27/1982,15,0,15,18,48
2/28/1982,18,0,26,10,54
3/1/1982,24,0,24,22,70
3/2/1982,19,0,13,36,68
3/3/1982,15,0,8,11,34
3/4/1982,25,0,21,21,67
3/5/1982,27,0,22,25,74
3/6/1982,30,0,12,33,75
3/7/1982,16,0,12,17,45
3/8/1982,29,0,24,8,61
3/9/1982,22,0,29,13,64
3/10/1982,22,0,22,4,48
3/11/1982,21,0,24,21,66
3/12/1982,28,0,21,15,64
3/13/1982,28,0,29,28,85
3/14/1982,21,0,24,22,67
3/15/1982,18,0,18,19,55
3/16/1982,22,0,21,25,68
3/17/1982,26,0,9,14,49
3/18/1982,25,0,25,21,71
3/19/1982,21,0,31,11,63
3/20/1982,25,0,24,28,77
3/21/1982,29,0,17,19,65
3/22/1982,31,0,25,16,72
3/23/1982,32,0,25,25,82
3/24/1982,22,0,27,23,72
3/25/1982,22,0,22,12,56
3/26/1982,21,0,29,7,57
3/27/1982,26,0,18,16,60
3/28/1982,23,0,17,20,60
3/29/1982,21,0,27,11,59
3/30/1982,28,0,14,16,58
3/31/1982,22,0,17,18,57
4/1/1982,24,0,22,23,69
4/2/1982,33,0,24,18,75
4/3/1982,20,0,16,27,63
4/4/1982,14,0,12,21,47
4/5/1982,21,0,25,29,75
4/6/1982,21,0,24,24,69
4/7/1982,21,0,14,7,42
4/8/1982,26,0,22,16,64
4/9/1982,24,0,22,22,68
4/10/1982,30,0,19,34,83
4/11/1982,33,0,11,10,54
4/12/1982,13,0,19,22,54
4/13/1982,18,0,19,30,67
4/14/1982,23,0,23,30,76
4/15/1982,15,0,24,29,68
4/16/1982,23,0,29,11,63
4/17/1982,22,0,14,27,63
4/18/1982,25,0,21,32,78
4/19/1982,14,0,16,28,58
4/20/1982,18,0,12,9,39
4/21/1982,23,0,18,24,65
4/22/1982,19,0,20,25,64
4/23/1982,21,0,10,20,51
4/24/1982,26,0,23,33,82
4/25/1982,17,0,23,13,53
4/26/1982,27,0,20,39,86
4/27/1982,23,0,13,18,54
4/28/1982,24,0,23,14,61
4/29/1982,24,0,15,29,68
4/30/1982,25,0,18,29,72
5/1/1982,20,0,19,16,55
5/2/1982,24,0,17,29,70
5/3/1982,30,0,17,28,75
5/4/1982,23,0,27,19,69
5/5/1982,25,0,27,19,71
5/6/1982,22,0,17,19,58
5/7/1982,28,0,24,16,68
5/8/1982,27,0,20,22,69
5/9/1982,24,0,19,17,60
5/10/1982,19,0,15,18,52
5/11/1982,33,0,15,23,71
5/12/1982,31,0,19,20,70
5/13/1982,32,0,14,25,71
5/14/1982,27,0,21,16,64
5/15/1982,21,0,23,25,69
5/16/1982,20,0,26,16,62
5/17/1982,24,0,9,21,54
5/18/1982,21,0,23,9,53
5/19/1982,18,0,17,25,60
5/20/1982,22,0,18,13,53
5/21/1982,18,0,14,10,42
5/22/1982,19,0,32,23,74
5/23/1982,19,0,24,17,60
5/24/1982,28,0,23,20,71
5/25/1982,32,0,18,19,69
5/26/1982,30,0,15,13,58
5/27/1982,24,0,26,16,66
5/28/1982,33,0,26,20,79
5/29/1982,14,0,15,12,41
5/30/1982,17,0,26,8,51
5/31/1982,28,0,17,20,65
6/1/1982,29,0,12,34,75
6/2/1982,26,0,16,10,52
6/3/1982,31,0,28,29,88
6/4/1982,21,0,23,17,61
6/5/1982,22,0,21,17,60
6/6/1982,28,0,17,26,71
6/7/1982,21,0,15,29,65
6/8/1982,15,0,13,19,47
6/9/1982,14,0,19,33,66
6/10/1982,18,0,28,3,49
6/11/1982,20,0,25,24,69
6/12/1982,27,0,15,19,61
6/13/1982,13,0,17,10,40
6/14/1982,28,0,21,24,73
6/15/1982,26,0,14,25,65
6/16/1982,17,0,25,24,66
6/17/1982,25,0,18,22,65
6/18/1982,24,0,12,16,52
6/19/1982,18,0,26,28,72
6/20/1982,22,0,21,18,61
6/21/1982,17,0,18,15,50
6/22/1982,19,0,16,7,42
6/23/1982,31,0,13,28,72
6/24/1982,12,0,22,20,54
6/25/1982,19,0,27,15,61
6/26/1982,14,0,18,17,49
6/27/1982,31,0,23,27,81
6/28/1982,19,0,21,27,67
6/29/1982,31,0,14,17,62
6/30/1982,19,0,24,24,67
7/1/1982,29,0,18,13,60
7/2/1982,22,0,25,23,70
7/3/1982,19,0,16,19,54
7/4/1982,18,0,15,21,54
7/5/1982,28,0,7,19,54
7/6/1982,26,0,22,33,81
7/7/1982,19,0,15,18,52
7/8/1982,27,0,28,12,67
7/9/1982,29,0,20,16,65
7/10/1982,26,0,25,21,72
7/11/1982,31,0,20,31,82
7/12/1982,28,0,26,28,82
7/13/1982,22,0,23,13,58
7/14/1982,18,0,19,16,53
7/15/1982,25,0,23,16,64
7/16/1982,24,0,9,28,61
7/17/1982,22,0,20,15,57
7/18/1982,18,0,31,11,60
7/19/1982,17,0,22,21,60
7/20/1982,30,0,20,25,75
7/21/1982,18,0,31,14,63
7/22/1982,17,0,27,21,65
7/23/1982,26,0,9,13,48
7/24/1982,29,0,14,13,56
7/25/1982,16,0,15,32,63
7/26/1982,19,0,16,13,48
7/27/1982,28,0,15,11,54
7/28/1982,18,0,20,29,67
7/29/1982,21,0,28,10,59
7/30/1982,20,0,20,33,73
7/31/1982,24,0,15,23,62
8/1/1982,30,0,24,25,79
8/2/1982,16,0,11,35,62
8/3/1982,29,0,24,28,81
8/4/1982,20,0,20,25,65
8/5/1982,20,0,14,34,68
8/6/1982,18,0,10,13,41
8/7/1982,16,0,28,25,69
8/8/1982,21,0,15,33,69
8/9/1982,19,0,21,26,66
8/10/1982,26,0,13,30,69
8/11/1982,23,0,13,21,57
8/12/1982,29,0,23,21,73
8/13/1982,21,0,29,19,69
8/14/1982,30,0,28,11,69
8/15/1982,19,0,20,30,69
8/16/1982,23,0,13,12,48
8/17/1982,21,0,29,23,73
8/18/1982,24,0,13,26,63
8/19/1982,26,0,22,16,64
8/20/1982,23,0,7,22,52
8/21/1982,22,0,25,25,72
8/22/1982,26,0,12,20,58
8/23/1982,26,0,25,19,70
8/24/1982,15,0,26,9,50
8/25/1982,24,0,8,19,51
8/26/1982,29,0,10,34,73
8/27/1982,24,0,17,23,64
8/28/1982,32,0,15,13,60
8/29/1982,16,0,22,20,58
8/30/1982,27,0,32,13,72
8/31/1982,18,0,20,26,64
9/1/1982,24,0,24,21,69
9/2/1982,21,0,24,16,61
9/3/1982,25,0,14,23,62
9/4/1982,21,0,16,1,38
9/5/1982,26,0,25,22,73
9/6/1982,25,0,13,19,57
9/7/1982,22,0,21,32,75
9/8/1982,15,0,20,5,40
9/9/1982,27,0,26,13,66
9/10/1982,28,0,15,15,58
9/11/1982,21,0,17,17,55
9/12/1982,23,0,13,9,45
9/13/1982,26,0,26,18,70
9/14/1982,17,0,20,18,55
9/15/1982,27,0,21,19,67
9/16/1982,17,0,21,20,58
9/17/1982,24,0,20,15,59
9/18/1982,20,0,21,5,46
9/19/1982,23,0,27,18,68
9/20/1982,24,0,16,9,49
9/21/1982,22,0,19,28,69
9/22/1982,16,0,24,8,48
9/23/1982,16,0,13,19,48
9/24/1982,21,0,20,25,66
9/25/1982,28,0,20,30,78
9/26/1982,15,0,24,10,49
9/27/1982,25,0,15,25,65
9/28/1982,17,0,26,3,46
9/29/1982,25,0,24,2,51
9/30/1982,20,0,28,16,64
10/1/1982,14,0,17,21,52
10/2/1982,26,0,12,3,41
10/3/1982,18,0,23,15,56
10/4/1982,23,0,24,26,73
10/5/1982,19,0,16,26,61
10/6/1982,28,0,21,28,77
10/7/1982,26,0,10,21,57
10/8/1982,22,0,22,28,72
10/9/1982,25,0,12,23,60
10/10/1982,20,0,19,23,62
10/11/1982,15,0,30,21,66
10/12/1982,26,0,17,19,62
10/13/1982,17,0,12,24,53
10/14/1982,19,0,17,27,63
10/15/1982,14,0,18,14,46
10/16/1982,25,0,26,19,70
10/17/1982,26,0,28,33,87
10/18/1982,21,0,22,14,57
10/19/1982,19,0,26,17,62
10/20/1982,24,0,18,9,51
10/21/1982,24,0,11,29,64
10/22/1982,20,0,8,33,61
10/23/1982,12,0,26,21,59
10/24/1982,23,0,19,29,71
10/25/1982,20,0,19,26,65
10/26/1982,20,0,14,23,57
10/27/1982,26,0,7,30,63
10/28/1982,22,0,18,12,52
10/29/1982,30,0,17,26,73
10/30/1982,16,0,25,34,75
10/31/1982,33,0,27,25,85
11/1/1982,19,0,19,27,65
11/2/1982,24,0,20,17,61
11/3/1982,29,0,26,17,72
11/4/1982,33,0,23,26,82
11/5/1982,25,0,26,22,73
11/6/1982,28,0,23,27,78
11/7/1982,16,0,18,22,56
11/8/1982,20,0,15,26,61
11/9/1982,22,0,19,21,62
11/10/1982,21,0,23,16,60
11/11/1982,25,0,13,29,67
11/12/1982,18,0,17,15,50
11/13/1982,24,0,27,17,68
11/14/1982,13,0,18,22,53
11/15/1982,27,0,16,24,67
11/16/1982,27,0,22,29,78
11/17/1982,29,0,31,19,79
11/18/1982,30,0,24,17,71
11/19/1982,25,0,27,16,68
11/20/1982,30,0,22,11,63
11/21/1982,24,0,15,22,61
11/22/1982,29,0,24,7,60
11/23/1982,25,0,30,5,60
11/24/1982,23,0,23,24,70
11/25/1982,19,0,16,29,64
11/26/1982,19,0,8,24,51
11/27/1982,29,0,20,16,65
11/28/1982,22,0,25,17,64
11/29/1982,21,0,14,26,61
11/30/1982,27,0,18,33,78
12/1/1982,30,0,22,16,68
12/2/1982,31,0,16,22,69
12/3/1982,21,0,23,33,77
12/4/1982,18,0,16,27,61
12/5/1982,16,0,19,25,60
12/6/1982,22,0,19,24,65
12/7/1982,28,0,16,22,66
12/8/1982,23,0,20,13,56
12/9/1982,17,0,18,20,55
12/10/1982,24,0,21,16,61
12/11/1982,23,0,15,30,68
12/12/1982,28,0,30,26,84
12/13/1982,22,0,14,26,62
12/14/1982,33,0,19,18,70
12/15/1982,16,0,18,23,57
12/16/1982,31,0,16,24,71
12/17/1982,18,0,20,19,57
12/18/1982,21,0,20,20,61
12/19/1982,31,0,25,16,72
12/20/1982,22,0,30,24,76
12/21/1982,24,0,26,13,63
12/22/1982,16,0,14,17,47
12/23/1982,18,0,22,3,43
12/24/1982,21,0,24,32,77
12/25/1982,17,0,19,28,64
12/26/1982,22,0,16,22,60
12/27/1982,32,0,25,25,82
12/28/1982,24,0,15,18,57
12/29/1982,24,0,16,25,65
12/30/1982,21,0,21,18,60
12/31/1982,18,0,24,35,77
1/1/1983,19,0,13,15,47
1/2/1983,19,0,8,27,54
1/3/1983,20,0,14,27,61
1/4/1983,14,0,17,39,70
1/5/1983,16,0,21,22,59
1/6/1983,29,0,13,23,65
1/7/1983,21,0,25,15,61
1/8/1983,15,0,27,6,48
1/9/1983,25,0,23,19,67
1/10/1983,23,0,25,3,51
1/11/1983,22,0,18,25,65
1/12/1983,17,0,14,19,50
1/13/1983,26,0,16,9,51
1/14/1983,12,0,15,23,50
1/15/1983,22,0,24,21,67
1/16/1983,26,0,19,26,71
1/17/1983,14,0,33,19,66
1/18/1983,20,0,22,19,61
1/19/1983,21,0,29,18,68
1/20/1983,21,0,25,23,69
1/21/1983,22,0,27,30,79
1/22/1983,16,0,22,34,72
1/23/1983,16,0,17,19,52
1/24/1983,29,0,31,26,86
1/25/1983,18,0,25,21,64
1/26/1983,21,0,23,25,69
1/27/1983,17,0,15,13,45
1/28/1983,17,0,10,28,55
1/29/1983,19,0,22,16,57
1/30/1983,10,0,25,16,51
1/31/1983,19,0,30,16,65
2/1/1983,35,0,16,11,62
2/2/1983,23,0,16,27,66
2/3/1983,21,0,10,22,53
2/4/1983,19,0,24,34,77
2/5/1983,23,0,26,20,69
2/6/1983,15,0,15,21,51
2/7/1983,24,0,13,31,68
2/8/1983,27,0,16,17,60
2/9/1983,25,0,15,22,62
2/10/1983,24,0,21,30,75
2/11/1983,25,0,29,11,65
2/12/1983,21,0,14,15,50
2/13/1983,33,0,17,33,83
2/14/1983,24,0,19,23,66
2/15/1983,31,0,23,36,90
2/16/1983,18,0,15,19,52
2/17/1983,17,0,23,20,60
2/18/1983,27,0,15,27,69
2/19/1983,23,0,33,16,72
2/20/1983,23,0,31,16,70
2/21/1983,16,0,23,18,57
2/22/1983,26,0,17,8,51
2/23/1983,15,0,22,16,53
2/24/1983,25,0,22,21,68
2/25/1983,19,0,20,32,71
2/26/1983,28,0,16,19,63
2/27/1983,31,0,24,16,71
2/28/1983,32,0,32,19,83
3/1/1983,22,0,13,16,51
3/2/1983,26,0,31,17,74
3/3/1983,19,0,25,27,71
3/4/1983,21,0,27,17,65
3/5/1983,34,0,13,28,75
3/6/1983,23,0,16,25,64
3/7/1983,13,0,7,15,35
3/8/1983,22,0,10,19,51
3/9/1983,28,0,19,21,68
3/10/1983,31,0,12,27,70
3/11/1983,21,0,23,26,70
3/12/1983,25,0,19,15,59
3/13/1983,22,0,15,20,57
3/14/1983,31,0,21,16,68
3/15/1983,22,0,16,25,63
3/16/1983,28,0,24,22,74
3/17/1983,18,0,21,20,59
3/18/1983,14,0,28,8,50
3/19/1983,19,0,16,14,49
3/20/1983,26,0,14,25,65
3/21/1983,26,0,30,28,84
3/22/1983,14,0,24,32,70
3/23/1983,22,0,26,15,63
3/24/1983,21,0,22,18,61
3/25/1983,27,0,18,17,62
3/26/1983,18,0,16,30,64
3/27/1983,19,0,31,17,67
3/28/1983,23,0,11,16,50
3/29/1983,11,0,30,19,60
3/30/1983,33,0,18,21,72
3/31/1983,22,0,30,19,71
4/1/1983,22,0,14,16,52
4/2/1983,22,0,21,34,77
4/3/1983,16,0,13,29,58
4/4/1983,14,0,21,28,63
4/5/1983,26,0,23,20,69
4/6/1983,20,0,19,27,66
4/7/1983,17,0,17,20,54
4/8/1983,28,0,25,22,75
4/9/1983,20,0,15,16,51
4/10/1983,23,0,21,34,78
4/11/1983,20,0,19,36,75
4/12/1983,14,0,20,23,57
4/13/1983,19,0,25,16,60
4/14/1983,18,0,19,7,44
4/15/1983,18,0,24,19,61
4/16/1983,14,0,19,23,56
4/17/1983,15,0,27,13,55
4/18/1983,24,0,26,21,71
4/19/1983,31,0,13,19,63
4/20/1983,25,0,11,20,56
4/21/1983,16,0,18,14,48
4/22/1983,27,0,17,31,75
4/23/1983,21,0,19,28,68
4/24/1983,26,0,25,25,76
4/25/1983,18,0,19,13,50
4/26/1983,21,0,15,32,68
4/27/1983,17,0,20,31,68
4/28/1983,21,0,25,12,58
4/29/1983,23,0,29,21,73
4/30/1983,30,0,26,16,72
5/1/1983,31,0,21,36,88
5/2/1983,22,0,24,16,62
5/3/1983,28,0,19,20,67
5/4/1983,28,0,26,22,76
5/5/1983,16,0,26,12,54
5/6/1983,14,0,24,16,54
5/7/1983,22,0,26,34,82
5/8/1983,25,0,16,22,63
5/9/1983,26,0,11,13,50
5/10/1983,21,0,20,21,62
5/11/1983,27,0,15,32,74
5/12/1983,18,0,11,22,51
5/13/1983,17,0,30,22,69
5/14/1983,21,0,18,14,53
5/15/1983,18,0,21,25,64
5/16/1983,33,0,24,19,76
5/17/1983,25,0,15,4,44
5/18/1983,28,0,22,20,70
5/19/1983,20,0,18,12,50
5/20/1983,32,0,19,28,79
5/21/1983,23,0,27,15,65
5/22/1983,30,0,17,20,67
5/23/1983,33,0,16,13,62
5/24/1983,32,0,19,14,65
5/25/1983,23,0,17,25,65
5/26/1983,16,0,23,15,54
5/27/1983,26,0,13,22,61
5/28/1983,29,0,28,18,75
5/29/1983,29,0,33,18,80
5/30/1983,26,0,23,28,77
5/31/1983,21,0,22,15,58
6/1/1983,25,0,30,23,78
6/2/1983,24,0,13,10,47
6/3/1983,25,0,19,23,67
6/4/1983,29,0,24,25,78
6/5/1983,20,0,17,18,55
6/6/1983,25,0,22,13,60
6/7/1983,21,0,28,29,78
6/8/1983,16,0,28,18,62
6/9/1983,30,0,16,12,58
6/10/1983,27,0,27,13,67
6/11/1983,16,0,18,33,67
6/12/1983,20,0,20,13,53
6/13/1983,22,0,27,18,67
6/14/1983,21,0,19,25,65
6/15/1983,19,0,25,15,59
6/16/1983,23,0,11,16,50
6/17/1983,23,0,24,29,76
6/18/1983,16,0,23,16,55
6/19/1983,19,0,13,26,58
6/20/1983,18,0,19,16,53
6/21/1983,15,0,26,21,62
6/22/1983,25,0,20,14,59
6/23/1983,28,0,19,31,78
6/24/1983,25,0,16,36,77
6/25/1983,21,0,18,21,60
6/26/1983,19,0,10,30,59
6/27/1983,29,0,16,14,59
6/28/1983,15,0,16,26,57
6/29/1983,29,0,19,18,66
6/30/1983,26,0,16,30,72
7/1/1983,27,0,23,13,63
7/2/1983,20,0,10,12,42
7/3/1983,19,0,26,10,55
7/4/1983,28,0,23,22,73
7/5/1983,19,0,7,16,42
7/6/1983,26,0,25,27,78
7/7/1983,25,0,14,2,41
7/8/1983,29,0,29,32,90
7/9/1983,24,0,27,28,79
7/10/1983,16,0,25,31,72
7/11/1983,26,0,16,25,67
7/12/1983,26,0,12,22,60
7/13/1983,19,0,19,16,54
7/14/1983,26,0,14,20,60
7/15/1983,26,0,20,21,67
7/16/1983,18,0,30,15,63
7/17/1983,25,0,24,30,79
7/18/1983,25,0,33,20,78
7/19/1983,25,0,22,20,67
7/20/1983,13,0,16,24,53
7/21/1983,24,0,8,22,54
7/22/1983,28,0,26,19,73
7/23/1983,26,0,18,19,63
7/24/1983,21,0,28,28,77
7/25/1983,18,0,21,9,48
7/26/1983,16,0,22,26,64
7/27/1983,22,0,29,12,63
7/28/1983,23,0,22,27,72
7/29/1983,17,0,28,31,76
7/30/1983,33,0,21,14,68
7/31/1983,29,0,24,25,78
8/1/1983,26,0,11,7,44
8/2/1983,21,0,26,29,76
8/3/1983,25,0,13,11,49
8/4/1983,23,0,19,23,65
8/5/1983,21,0,24,11,56
8/6/1983,13,0,17,31,61
8/7/1983,25,0,21,20,66
8/8/1983,28,0,23,18,69
8/9/1983,29,0,17,11,57
8/10/1983,22,0,25,12,59
8/11/1983,33,0,23,22,78
8/12/1983,14,0,19,11,44
8/13/1983,25,0,11,11,47
8/14/1983,23,0,20,16,59
8/15/1983,26,0,13,22,61
8/16/1983,17,0,17,17,51
8/17/1983,24,0,18,24,66
8/18/1983,26,0,21,17,64
8/19/1983,24,0,24,24,72
8/20/1983,31,0,18,28,77
8/21/1983,20,0,29,17,66
8/22/1983,22,0,22,26,70
8/23/1983,14,0,15,11,40
8/24/1983,27,0,27,16,70
8/25/1983,29,0,31,15,75
8/26/1983,24,0,30,12,66
8/27/1983,29,0,24,15,68
8/28/1983,34,0,12,14,60
8/29/1983,27,0,23,27,77
8/30/1983,20,0,15,31,66
8/31/1983,28,0,13,10,51
9/1/1983,23,0,24,26,73
9/2/1983,18,0,10,11,39
9/3/1983,25,0,29,27,81
9/4/1983,32,0,22,24,78
9/5/1983,19,0,30,13,62
9/6/1983,27,0,17,26,70
9/7/1983,15,0,19,27,61
9/8/1983,27,0,26,15,68
9/9/1983,19,0,13,21,53
9/10/1983,24,0,18,23,65
9/11/1983,22,0,28,25,75
9/12/1983,20,0,22,16,58
9/13/1983,23,0,18,25,66
9/14/1983,24,0,21,17,62
9/15/1983,13,0,15,14,42
9/16/1983,29,0,10,30,69
9/17/1983,20,0,27,17,64
9/18/1983,24,0,17,21,62
9/19/1983,27,0,19,21,67
9/20/1983,23,0,14,22,59
9/21/1983,21,0,22,14,57
9/22/1983,35,0,18,10,63
9/23/1983,20,0,15,22,57
9/24/1983,29,0,22,19,70
9/25/1983,19,0,22,29,70
9/26/1983,18,0,14,29,61
9/27/1983,19,0,22,23,64
9/28/1983,29,0,27,29,85
9/29/1983,32,0,25,7,64
9/30/1983,25,0,14,25,64
10/1/1983,23,0,25,21,69
10/2/1983,23,0,16,17,56
10/3/1983,16,0,25,24,65
10/4/1983,15,0,22,28,65
10/5/1983,25,0,17,27,69
10/6/1983,21,0,20,17,58
10/7/1983,19,0,27,22,68
10/8/1983,11,0,16,22,49
10/9/1983,25,0,26,26,77
10/10/1983,27,0,27,8,62
10/11/1983,18,0,19,14,51
10/12/1983,22,0,16,33,71
10/13/1983,24,0,10,22,56
10/14/1983,20,0,17,27,64
10/15/1983,26,0,28,35,89
10/16/1983,26,0,25,15,66
10/17/1983,28,0,19,33,80
10/18/1983,15,0,16,20,51
10/19/1983,23,0,13,23,59
10/20/1983,24,0,21,19,64
10/21/1983,22,0,25,17,64
10/22/1983,30,0,22,14,66
10/23/1983,23,0,20,25,68
10/24/1983,16,0,12,27,55
10/25/1983,18,0,26,18,62
10/26/1983,17,0,27,12,56
10/27/1983,27,0,30,11,68
10/28/1983,21,0,15,15,51
10/29/1983,16,0,20,20,56
10/30/1983,19,0,11,20,50
10/31/1983,13,0,11,21,45
11/1/1983,13,0,22,30,65
11/2/1983,26,0,27,8,61
11/3/1983,24,0,24,26,74
11/4/1983,25,0,27,22,74
11/5/1983,33,0,25,14,72
11/6/1983,32,0,25,37,94
11/7/1983,16,0,25,17,58
11/8/1983,12,0,16,33,61
11/9/1983,29,0,13,32,74
11/10/1983,21,0,26,17,64
11/11/1983,21,0,22,19,62
11/12/1983,18,0,14,31,63
11/13/1983,29,0,13,15,57
11/14/1983,23,0,20,12,55
11/15/1983,19,0,26,32,77
11/16/1983,13,0,25,20,58
11/17/1983,21,0,18,33,72
11/18/1983,32,0,26,19,77
11/19/1983,28,0,11,18,57
11/20/1983,27,0,21,13,61
11/21/1983,32,0,12,19,63
11/22/1983,16,0,18,17,51
11/23/1983,17,0,23,22,62
11/24/1983,28,0,29,18,75
11/25/1983,30,0,28,18,76
11/26/1983,22,0,24,24,70
11/27/1983,15,0,21,26,62
11/28/1983,16,0,12,18,46
11/29/1983,24,0,23,14,61
11/30/1983,26,0,12,31,69
12/1/1983,19,0,19,20,58
12/2/1983,23,0,17,22,62
12/3/1983,18,0,15,15,48
12/4/1983,24,0,25,22,71
12/5/1983,32,0,22,23,77
12/6/1983,23,0,20,14,57
12/7/1983,17,0,17,13,47
12/8/1983,30,0,22,23,75
12/9/1983,31,0,8,12,51
12/10/1983,18,0,21,17,56
12/11/1983,29,0,27,11,67
12/12/1983,21,0,18,14,53
12/13/1983,21,0,20,37,78
12/14/1983,23,0,18,17,58
12/15/1983,20,0,22,19,61
12/16/1983,22,0,21,24,67
12/17/1983,14,0,10,20,44
12/18/1983,19,0,23,29,71
12/19/1983,21,0,18,12,51
12/20/1983,24,0,26,35,85
12/21/1983,22,0,21,18,61
12/22/1983,18,0,28,17,63
12/23/1983,24,0,17,24,65
12/24/1983,25,0,11,31,67
12/25/1983,23,0,29,20,72
12/26/1983,24,0,18,19,61
12/27/1983,22,0,16,15,53
12/28/1983,19,0,24,24,67
12/29/1983,26,0,15,35,76
12/30/1983,22,0,19,19,60
12/31/1983,27,0,25,10,62
1/1/1984,29,0,22,10,61
1/2/1984,23,0,22,16,61
1/3/1984,23,0,21,19,63
1/4/1984,27,0,21,19,67
1/5/1984,22,0,14,28,64
1/6/1984,24,0,16,7,47
1/7/1984,23,0,18,16,57
1/8/1984,23,0,16,11,50
1/9/1984,14,0,22,34,70
1/10/1984,32,0,22,23,77
1/11/1984,12,0,17,22,51
1/12/1984,25,0,27,21,73
1/13/1984,19,0,21,29,69
1/14/1984,14,0,27,17,58
1/15/1984,26,0,20,14,60
1/16/1984,33,0,11,31,75
1/17/1984,26,0,24,13,63
1/18/1984,24,0,12,21,57
1/19/1984,29,0,26,12,67
1/20/1984,31,0,23,30,84
1/21/1984,20,0,18,21,59
1/22/1984,20,0,24,23,67
1/23/1984,21,0,18,23,62
1/24/1984,19,0,15,4,38
1/25/1984,21,0,19,17,57
1/26/1984,19,0,19,17,55
1/27/1984,20,0,13,33,66
1/28/1984,26,0,20,22,68
1/29/1984,27,0,14,26,67
1/30/1984,31,0,21,27,79
1/31/1984,21,0,20,21,62
2/1/1984,26,0,21,28,75
2/2/1984,17,0,12,26,55
2/3/1984,12,0,26,14,52
2/4/1984,29,0,18,21,68
2/5/1984,32,0,18,27,77
2/6/1984,33,0,31,33,97
2/7/1984,24,0,24,26,74
2/8/1984,22,0,18,25,65
2/9/1984,24,0,20,21,65
2/10/1984,20,0,24,39,83
2/11/1984,17,0,17,27,61
2/12/1984,29,0,18,15,62
2/13/1984,27,0,15,21,63
2/14/1984,25,0,14,24,63
2/15/1984,30,0,28,29,87
2/16/1984,31,0,9,23,63
2/17/1984,26,0,14,21,61
2/18/1984,24,0,24,26,74
2/19/1984,24,0,17,26,67
2/20/1984,25,0,28,12,65
2/21/1984,30,0,20,7,57
2/22/1984,30,0,10,32,72
2/23/1984,26,0,18,34,78
2/24/1984,17,0,16,18,51
2/25/1984,16,0,19,10,45
2/26/1984,16,0,15,27,58
2/27/1984,25,0,18,29,72
2/28/1984,29,0,27,17,73
2/29/1984,22,0,24,1,47
3/1/1984,21,0,25,20,66
3/2/1984,18,0,20,24,62
3/3/1984,26,0,28,21,75
3/4/1984,27,0,23,28,78
3/5/1984,28,0,21,25,74
3/6/1984,23,0,15,28,66
3/7/1984,23,0,21,16,60
3/8/1984,17,0,33,27,77
3/9/1984,23,0,19,17,59
3/10/1984,28,0,15,24,67
3/11/1984,19,0,23,26,68
3/12/1984,20,0,19,21,60
3/13/1984,28,0,14,35,77
3/14/1984,17,0,14,29,60
3/15/1984,25,0,20,11,56
3/16/1984,28,0,23,5,56
3/17/1984,25,0,27,24,76
3/18/1984,28,0,15,35,78
3/19/1984,28,0,19,12,59
3/20/1984,29,0,27,17,73
3/21/1984,20,0,27,24,71
3/22/1984,11,0,15,31,57
3/23/1984,27,0,16,19,62
3/24/1984,24,0,25,14,63
3/25/1984,26,0,21,18,65
3/26/1984,23,0,22,19,64
3/27/1984,28,0,25,25,78
3/28/1984,28,0,31,30,89
3/29/1984,21,0,13,6,40
3/30/1984,26,0,15,23,64
3/31/1984,21,0,13,20,54
4/1/1984,18,0,26,34,78
4/2/1984,24,0,9,21,54
4/3/1984,12,0,13,30,55
4/4/1984,23,0,18,29,70
4/5/1984,20,0,20,23,63
4/6/1984,16,0,21,16,53
4/7/1984,24,0,17,21,62
4/8/1984,30,0,14,11,55
4/9/1984,24,0,20,4,48
4/10/1984,17,0,15,22,54
4/11/1984,14,0,24,26,64
4/12/1984,30,0,24,27,81
4/13/1984,25,0,21,30,76
4/14/1984,29,0,29,21,79
4/15/1984,23,0,27,32,82
4/16/1984,13,0,12,15,40
4/17/1984,33,0,23,18,74
4/18/1984,26,0,18,13,57
4/19/1984,14,0,15,16,45
4/20/1984,26,0,27,6,59
4/21/1984,22,0,18,33,73
4/22/1984,34,0,20,21,75
4/23/1984,28,0,25,26,79
4/24/1984,13,0,21,8,42
4/25/1984,16,0,17,22,55
4/26/1984,26,0,26,20,72
4/27/1984,31,0,19,18,68
4/28/1984,22,0,15,12,49
4/29/1984,22,0,15,32,69
4/30/1984,29,0,21,17,67
5/1/1984,13,0,30,18,61
5/2/1984,23,0,11,36,70
5/3/1984,16,0,19,23,58
5/4/1984,23,0,26,31,80
5/5/1984,20,0,28,28,76
5/6/1984,31,0,9,29,69
5/7/1984,24,0,20,14,58
5/8/1984,26,0,15,25,66
5/9/1984,24,0,13,20,57
5/10/1984,27,0,13,4,44
5/11/1984,12,0,24,15,51
5/12/1984,19,0,9,20,48
5/13/1984,21,0,10,14,45
5/14/1984,31,0,20,12,63
5/15/1984,20,0,13,14,47
5/16/1984,19,0,20,10,49
5/17/1984,24,0,12,19,55
5/18/1984,33,0,18,15,66
5/19/1984,23,0,20,17,60
5/20/1984,19,0,10,20,49
5/21/1984,12,0,24,37,73
5/22/1984,28,0,13,26,67
5/23/1984,20,0,21,11,52
5/24/1984,30,0,27,26,83
5/25/1984,20,0,28,16,64
5/26/1984,15,0,31,16,62
5/27/1984,19,0,24,26,69
5/28/1984,14,0,23,37,74
5/29/1984,32,0,20,29,81
5/30/1984,28,0,20,6,54
5/31/1984,14,0,16,5,35
6/1/1984,23,0,22,29,74
6/2/1984,26,0,19,21,66
6/3/1984,17,0,28,24,69
6/4/1984,17,0,26,23,66
6/5/1984,19,0,24,20,63
6/6/1984,18,0,18,7,43
6/7/1984,24,0,17,16,57
6/8/1984,26,0,18,14,58
6/9/1984,20,0,26,27,73
6/10/1984,17,0,19,20,56
6/11/1984,21,0,21,30,72
6/12/1984,14,0,22,30,66
6/13/1984,23,0,20,13,56
6/14/1984,23,0,22,18,63
6/15/1984,17,0,26,19,62
6/16/1984,21,0,11,15,47
6/17/1984,19,0,22,16,57
6/18/1984,22,0,20,11,53
6/19/1984,19,0,10,24,53
6/20/1984,24,0,23,11,58
6/21/1984,26,0,19,22,67
6/22/1984,30,0,12,24,66
6/23/1984,25,0,28,28,81
6/24/1984,29,0,24,24,77
6/25/1984,20,0,24,11,55
6/26/1984,27,0,22,5,54
6/27/1984,21,0,15,17,53
6/28/1984,28,0,24,20,72
6/29/1984,20,0,23,19,62
6/30/1984,17,0,27,21,65
7/1/1984,21,0,16,32,69
7/2/1984,24,0,13,9,46
7/3/1984,20,0,14,17,51
7/4/1984,16,0,25,21,62
7/5/1984,21,0,22,24,67
7/6/1984,29,0,24,16,69
7/7/1984,16,0,19,20,55
7/8/1984,27,0,20,21,68
7/9/1984,27,0,14,13,54
7/10/1984,29,0,25,27,81
7/11/1984,30,0,18,14,62
7/12/1984,17,0,24,25,66
7/13/1984,30,0,32,14,76
7/14/1984,27,0,15,10,52
7/15/1984,22,0,14,16,52
7/16/1984,27,0,21,12,60
7/17/1984,14,0,23,26,63
7/18/1984,26,0,23,15,64
7/19/1984,24,0,29,19,72
7/20/1984,22,0,24,19,65
7/21/1984,26,0,23,14,63
7/22/1984,16,0,25,22,63
7/23/1984,19,0,9,12,40
7/24/1984,18,0,24,28,70
7/25/1984,23,0,14,13,50
7/26/1984,25,0,11,13,49
7/27/1984,22,0,15,22,59
7/28/1984,22,0,25,18,65
7/29/1984,21,0,22,20,63
7/30/1984,21,0,16,29,66
7/31/1984,24,0,26,24,74
8/1/1984,29,0,16,19,64
8/2/1984,30,0,13,11,54
8/3/1984,19,0,11,23,53
8/4/1984,28,0,28,21,77
8/5/1984,32,0,21,28,81
8/6/1984,25,0,20,9,54
8/7/1984,28,0,16,16,60
8/8/1984,18,0,17,25,60
8/9/1984,21,0,22,13,56
8/10/1984,21,0,12,9,42
8/11/1984,19,0,29,16,64
8/12/1984,29,0,14,14,57
8/13/1984,22,0,17,10,49
8/14/1984,20,0,22,30,72
8/15/1984,22,0,17,19,58
8/16/1984,25,0,13,14,52
8/17/1984,24,0,21,18,63
8/18/1984,25,0,28,13,66
8/19/1984,24,0,16,21,61
8/20/1984,31,0,16,27,74
8/21/1984,24,0,20,25,69
8/22/1984,19,0,18,33,70
8/23/1984,27,0,12,23,62
8/24/1984,25,0,16,25,66
8/25/1984,25,0,6,8,39
8/26/1984,23,0,18,13,54
8/27/1984,26,0,25,34,85
8/28/1984,19,0,22,9,50
8/29/1984,24,0,10,35,69
8/30/1984,27,0,26,18,71
8/31/1984,26,0,19,11,56
9/1/1984,25,0,29,21,75
9/2/1984,24,0,27,27,78
9/3/1984,30,0,29,14,73
9/4/1984,22,0,12,23,57
9/5/1984,27,0,15,16,58
9/6/1984,27,0,24,15,66
9/7/1984,16,0,20,7,43
9/8/1984,23,0,16,18,57
9/9/1984,31,0,17,25,73
9/10/1984,19,0,21,24,64
9/11/1984,26,0,23,27,76
9/12/1984,35,0,19,30,84
9/13/1984,26,0,23,11,60
9/14/1984,28,0,19,37,84
9/15/1984,23,0,28,22,73
9/16/1984,29,0,14,13,56
9/17/1984,25,0,17,21,63
9/18/1984,27,0,19,24,70
9/19/1984,21,0,13,17,51
9/20/1984,20,0,17,30,67
9/21/1984,12,0,12,27,51
9/22/1984,27,0,26,18,71
9/23/1984,33,0,12,24,69
9/24/1984,23,0,15,7,45
9/25/1984,25,0,13,26,64
9/26/1984,30,0,21,12,63
9/27/1984,32,0,19,8,59
9/28/1984,24,0,11,29,64
9/29/1984,21,0,19,20,60
9/30/1984,30,0,21,12,63
10/1/1984,12,0,16,19,47
10/2/1984,23,0,20,14,57
10/3/1984,22,0,30,6,58
10/4/1984,23,0,11,11,45
10/5/1984,26,0,25,14,65
10/6/1984,22,0,18,14,54
10/7/1984,23,0,17,24,64
10/8/1984,28,0,25,25,78
10/9/1984,26,0,21,20,67
10/10/1984,25,0,15,13,53
10/11/1984,21,0,26,25,72
10/12/1984,20,0,28,21,69
10/13/1984,16,0,17,18,51
10/14/1984,21,0,16,22,59
10/15/1984,14,0,21,9,44
10/16/1984,31,0,19,35,85
10/17/1984,22,0,18,34,74
10/18/1984,21,0,27,22,70
10/19/1984,21,0,30,33,84
10/20/1984,24,0,14,12,50
10/21/1984,24,0,29,17,70
10/22/1984,19,0,13,26,58
10/23/1984,29,0,25,32,86
10/24/1984,23,0,19,18,60
10/25/1984,21,0,16,28,65
10/26/1984,25,0,18,23,66
10/27/1984,22,0,21,30,73
10/28/1984,18,0,19,32,69
10/29/1984,25,0,20,15,60
10/30/1984,24,0,30,29,83
10/31/1984,12,0,13,14,39
11/1/1984,20,0,15,16,51
11/2/1984,27,0,23,30,80
11/3/1984,23,0,25,19,67
11/4/1984,19,0,18,27,64
11/5/1984,24,0,14,8,46
11/6/1984,22,0,22,19,63
11/7/1984,18,0,25,8,51
11/8/1984,23,0,24,16,63
11/9/1984,17,0,19,24,60
11/10/1984,19,0,29,26,74
11/11/1984,19,0,22,24,65
11/12/1984,21,0,21,11,53
11/13/1984,21,0,25,11,57
11/14/1984,19,0,16,16,51
11/15/1984,18,0,25,15,58
11/16/1984,14,0,15,23,52
11/17/1984,23,0,19,15,57
11/18/1984,25,0,23,15,63
11/19/1984,25,0,14,26,65
11/20/1984,32,0,25,18,75
11/21/1984,16,0,24,29,69
11/22/1984,18,0,14,19,51
11/23/1984,26,0,16,20,62
11/24/1984,25,0,16,12,53
11/25/1984,16,0,22,24,62
11/26/1984,18,0,15,12,45
11/27/1984,19,0,17,17,53
11/28/1984,23,0,12,18,53
11/29/1984,31,0,28,2,61
11/30/1984,25,0,25,24,74
12/1/1984,20,0,16,21,57
12/2/1984,29,0,27,14,70
12/3/1984,12,0,22,23,57
12/4/1984,22,0,19,20,61
12/5/1984,33,0,23,14,70
12/6/1984,23,0,17,2,42
12/7/1984,21,0,17,28,66
12/8/1984,21,0,18,16,55
12/9/1984,26,0,12,16,54
12/10/1984,23,0,15,17,55
12/11/1984,24,0,24,32,80
12/12/1984,25,0,20,25,70
12/13/1984,23,0,25,24,72
12/14/1984,25,0,19,17,61
12/15/1984,26,0,21,29,76
12/16/1984,20,0,26,18,64
12/17/1984,27,0,12,27,66
12/18/1984,31,0,17,22,70
12/19/1984,29,0,12,19,60
12/20/1984,22,0,29,25,76
12/21/1984,22,0,31,16,69
12/22/1984,27,0,18,17,62
12/23/1984,23,0,16,19,58
12/24/1984,22,0,31,32,85
12/25/1984,29,0,31,20,80
12/26/1984,23,0,22,14,59
12/27/1984,20,0,19,32,71
12/28/1984,22,0,25,28,75
12/29/1984,14,0,12,28,54
12/30/1984,34,0,20,23,77
12/31/1984,20,0,17,24,61
1/1/1985,32,0,19,27,78
1/2/1985,18,0,15,21,54
1/3/1985,26,0,15,13,54
1/4/1985,20,0,16,10,46
1/5/1985,21,0,22,23,66
1/6/1985,18,0,18,32,68
1/7/1985,25,0,25,25,75
1/8/1985,22,0,28,17,67
1/9/1985,22,0,10,25,57
1/10/1985,14,0,22,27,63
1/11/1985,24,0,23,30,77
1/12/1985,22,0,23,30,75
1/13/1985,25,0,14,23,62
1/14/1985,19,0,11,22,52
1/15/1985,27,0,19,20,66
1/16/1985,25,0,12,16,53
1/17/1985,19,0,17,30,66
1/18/1985,24,0,23,21,68
1/19/1985,20,0,26,24,70
1/20/1985,19,0,20,28,67
1/21/1985,31,0,15,7,53
1/22/1985,22,0,17,13,52
1/23/1985,25,0,16,16,57
1/24/1985,26,0,17,22,65
1/25/1985,28,0,26,20,74
1/26/1985,15,0,16,17,48
1/27/1985,21,0,23,25,69
1/28/1985,21,0,16,23,60
1/29/1985,24,0,22,26,72
1/30/1985,31,0,17,21,69
1/31/1985,28,0,25,9,62
2/1/1985,25,0,17,16,58
2/2/1985,17,0,25,26,68
2/3/1985,29,0,14,8,51
2/4/1985,23,0,25,28,76
2/5/1985,22,0,25,11,58
2/6/1985,20,0,26,18,64
2/7/1985,22,0,31,23,76
2/8/1985,29,0,25,27,81
2/9/1985,12,0,13,19,44
2/10/1985,15,0,11,4,30
2/11/1985,20,0,17,23,60
2/12/1985,25,0,21,21,67
2/13/1985,23,0,27,31,81
2/14/1985,27,0,17,26,70
2/15/1985,19,0,22,16,57
2/16/1985,22,0,20,26,68
2/17/1985,24,0,15,18,57
2/18/1985,22,0,18,28,68
2/19/1985,16,0,21,21,58
2/20/1985,26,0,25,27,78
2/21/1985,23,0,18,28,69
2/22/1985,25,0,26,27,78
2/23/1985,29,0,17,21,67
2/24/1985,33,0,25,10,68
2/25/1985,25,0,23,15,63
2/26/1985,31,0,14,15,60
2/27/1985,21,0,23,21,65
2/28/1985,21,0,17,12,50
3/1/1985,26,0,19,18,63
3/2/1985,17,0,18,27,62
3/3/1985,19,0,12,22,53
3/4/1985,29,0,10,15,54
3/5/1985,25,0,15,9,49
3/6/1985,22,0,20,15,57
3/7/1985,12,0,24,21,57
3/8/1985,17,0,14,16,47
3/9/1985,16,0,29,26,71
3/10/1985,24,0,19,29,72
3/11/1985,23,0,20,16,59
3/12/1985,25,0,20,7,52
3/13/1985,31,0,16,22,69
3/14/1985,17,0,16,37,70
3/15/1985,29,0,16,20,65
3/16/1985,25,0,25,18,68
3/17/1985,28,0,18,26,72
3/18/1985,19,0,21,20,60
3/19/1985,21,0,25,34,80
3/20/1985,23,0,17,23,63
3/21/1985,29,0,17,25,71
3/22/1985,27,0,23,15,65
3/23/1985,20,0,19,25,64
3/24/1985,25,0,17,8,50
3/25/1985,29,0,10,37,76
3/26/1985,19,0,24,29,72
3/27/1985,18,0,28,19,65
3/28/1985,26,0,22,15,63
3/29/1985,24,0,19,16,59
3/30/1985,26,0,14,12,52
3/31/1985,22,0,25,27,74
4/1/1985,28,0,27,32,87
4/2/1985,26,0,25,31,82
4/3/1985,26,0,29,17,72
4/4/1985,15,0,21,21,57
4/5/1985,25,0,17,16,58
4/6/1985,19,0,18,3,40
4/7/1985,18,0,19,12,49
4/8/1985,22,0,22,21,65
4/9/1985,18,0,27,7,52
4/10/1985,26,0,25,23,74
4/11/1985,19,0,23,13,55
4/12/1985,15,0,18,16,49
4/13/1985,30,0,14,6,50
4/14/1985,31,0,15,27,73
4/15/1985,25,0,22,17,64
4/16/1985,27,0,17,23,67
4/17/1985,29,0,13,26,68
4/18/1985,13,0,29,25,67
4/19/1985,24,0,27,13,64
4/20/1985,26,0,20,16,62
4/21/1985,30,0,26,25,81
4/22/1985,26,0,16,11,53
4/23/1985,27,0,6,21,54
4/24/1985,22,0,13,18,53
4/25/1985,24,0,26,5,55
4/26/1985,23,0,19,13,55
4/27/1985,21,0,19,6,46
4/28/1985,24,0,33,19,76
4/29/1985,19,0,14,18,51
4/30/1985,21,0,18,23,62
5/1/1985,23,0,24,25,72
5/2/1985,23,0,18,25,66
5/3/1985,22,0,21,22,65
5/4/1985,27,0,16,23,66
5/5/1985,33,0,28,9,70
5/6/1985,25,0,16,1,42
5/7/1985,14,0,25,11,50
5/8/1985,20,0,23,15,58
5/9/1985,21,0,24,12,57
5/10/1985,24,0,18,26,68
5/11/1985,30,0,18,31,79
5/12/1985,25,0,23,17,65
5/13/1985,18,0,31,23,72
5/14/1985,12,0,28,22,62
5/15/1985,30,0,17,10,57
5/16/1985,22,0,17,12,51
5/17/1985,22,0,20,34,76
5/18/1985,17,0,20,27,64
5/19/1985,22,0,18,24,64
5/20/1985,21,0,9,23,53
5/21/1985,22,0,17,23,62
5/22/1985,22,0,17,22,61
5/23/1985,22,0,14,13,49
5/24/1985,26,0,13,27,66
5/25/1985,29,0,18,17,64
5/26/1985,28,0,20,16,64
5/27/1985,19,0,26,19,64
5/28/1985,27,0,23,26,76
5/29/1985,16,0,18,30,64
5/30/1985,25,0,22,8,55
5/31/1985,30,0,19,20,69
6/1/1985,14,0,12,19,45
6/2/1985,26,0,17,18,61
6/3/1985,21,0,17,15,53
6/4/1985,30,0,22,24,76
6/5/1985,21,0,14,18,53
6/6/1985,17,0,22,23,62
6/7/1985,29,0,16,28,73
6/8/1985,20,0,17,27,64
6/9/1985,21,0,25,23,69
6/10/1985,26,0,19,8,53
6/11/1985,30,0,29,10,69
6/12/1985,21,0,23,16,60
6/13/1985,24,0,23,20,67
6/14/1985,26,0,16,12,54
6/15/1985,30,0,33,17,80
6/16/1985,22,0,20,20,62
6/17/1985,25,0,11,14,50
6/18/1985,22,0,13,24,59
6/19/1985,23,0,21,17,61
6/20/1985,24,0,17,29,70
6/21/1985,21,0,21,22,64
6/22/1985,24,0,28,16,68
6/23/1985,22,0,19,21,62
6/24/1985,14,0,22,16,52
6/25/1985,23,0,21,10,54
6/26/1985,13,0,13,29,55
6/27/1985,21,0,23,18,62
6/28/1985,28,0,21,20,69
6/29/1985,27,0,23,7,57
6/30/1985,26,0,13,24,63
7/1/1985,16,0,21,16,53
7/2/1985,23,0,21,31,75
7/3/1985,25,0,11,20,56
7/4/1985,20,0,20,19,59
7/5/1985,26,0,19,6,51
7/6/1985,23,0,13,25,61
7/7/1985,27,0,20,24,71
7/8/1985,23,0,23,20,66
7/9/1985,18,0,18,27,63
7/10/1985,20,0,14,25,59
7/11/1985,24,0,19,20,63
7/12/1985,20,0,20,18,58
7/13/1985,29,0,21,25,75
7/14/1985,30,0,20,20,70
7/15/1985,23,0,18,26,67
7/16/1985,30,0,14,6,50
7/17/1985,27,0,18,19,64
7/18/1985,17,0,21,14,52
7/19/1985,24,0,22,19,65
7/20/1985,27,0,18,23,68
7/21/1985,30,0,22,15,67
7/22/1985,31,0,15,17,63
7/23/1985,26,0,30,32,88
7/24/1985,18,0,19,19,56
7/25/1985,24,0,27,5,56
7/26/1985,21,0,15,22,58
7/27/1985,20,0,12,14,46
7/28/1985,21,0,19,11,51
7/29/1985,21,0,28,24,73
7/30/1985,22,0,27,16,65
7/31/1985,20,0,14,6,40
8/1/1985,28,0,20,34,82
8/2/1985,27,0,30,23,80
8/3/1985,31,0,9,13,53
8/4/1985,30,0,19,23,72
8/5/1985,26,0,15,13,54
8/6/1985,29,0,13,16,58
8/7/1985,25,0,9,6,40
8/8/1985,13,0,13,2,28
8/9/1985,26,0,13,15,54
8/10/1985,21,0,20,27,68
8/11/1985,22,0,16,9,47
8/12/1985,26,0,27,30,83
8/13/1985,25,0,17,30,72
8/14/1985,17,0,29,16,62
8/15/1985,30,0,33,13,76
8/16/1985,14,0,25,8,47
8/17/1985,24,0,19,36,79
8/18/1985,24,0,9,12,45
8/19/1985,26,0,15,29,70
8/20/1985,13,0,30,15,58
8/21/1985,25,0,21,14,60
8/22/1985,12,0,23,30,65
8/23/1985,28,0,15,15,58
8/24/1985,21,0,26,14,61
8/25/1985,23,0,14,15,52
8/26/1985,28,0,23,4,55
8/27/1985,18,0,25,22,65
8/28/1985,20,0,19,20,59
8/29/1985,18,0,17,22,57
8/30/1985,25,0,18,11,54
8/31/1985,22,0,22,24,68
9/1/1985,29,0,17,21,67
9/2/1985,26,0,20,15,61
9/3/1985,16,0,20,32,68
9/4/1985,29,0,15,1,45
9/5/1985,24,0,23,26,73
9/6/1985,34,0,24,19,77
9/7/1985,16,0,20,6,42
9/8/1985,27,0,18,16,61
9/9/1985,26,0,20,20,66
9/10/1985,19,0,24,24,67
9/11/1985,27,0,21,22,70
9/12/1985,29,0,33,12,74
9/13/1985,28,0,25,16,69
9/14/1985,31,0,10,16,57
9/15/1985,31,0,10,22,63
9/16/1985,21,0,14,22,57
9/17/1985,20,0,20,18,58
9/18/1985,15,0,24,23,62
9/19/1985,22,0,13,22,57
9/20/1985,25,0,11,21,57
9/21/1985,28,0,27,20,75
9/22/1985,16,0,21,34,71
9/23/1985,20,0,23,10,53
9/24/1985,34,0,26,20,80
9/25/1985,24,0,12,6,42
9/26/1985,12,0,16,31,59
9/27/1985,28,0,20,23,71
9/28/1985,33,0,13,18,64
9/29/1985,24,0,23,32,79
9/30/1985,25,0,16,25,66
10/1/1985,34,0,32,32,98
10/2/1985,23,0,27,20,70
10/3/1985,21,0,16,22,59
10/4/1985,24,0,24,18,66
10/5/1985,28,0,12,22,62
10/6/1985,30,0,21,22,73
10/7/1985,32,0,21,25,78
10/8/1985,31,0,22,13,66
10/9/1985,27,0,19,16,62
10/10/1985,13,0,20,16,49
10/11/1985,22,0,18,23,63
10/12/1985,22,0,19,35,76
10/13/1985,27,0,27,14,68
10/14/1985,23,0,32,25,80
10/15/1985,22,0,17,24,63
10/16/1985,23,0,27,32,82
10/17/1985,21,0,24,20,65
10/18/1985,27,0,12,25,64
10/19/1985,17,0,32,28,77
10/20/1985,23,0,19,12,54
10/21/1985,13,0,23,21,57
10/22/1985,24,0,18,20,62
10/23/1985,19,0,12,20,51
10/24/1985,23,0,21,9,53
10/25/1985,14,0,23,22,59
10/26/1985,30,0,11,9,50
10/27/1985,20,0,22,15,57
10/28/1985,19,0,24,11,54
10/29/1985,27,0,10,23,60
10/30/1985,18,0,21,10,49
10/31/1985,17,0,17,37,71
11/1/1985,25,0,23,21,69
11/2/1985,27,0,19,16,62
11/3/1985,22,0,18,24,64
11/4/1985,25,0,10,10,45
11/5/1985,26,0,21,13,60
11/6/1985,19,0,17,16,52
11/7/1985,21,0,22,30,73
11/8/1985,16,0,15,19,50
11/9/1985,33,0,17,22,72
11/10/1985,35,0,28,9,72
11/11/1985,16,0,12,25,53
11/12/1985,27,0,25,31,83
11/13/1985,29,0,23,26,78
11/14/1985,23,0,11,15,49
11/15/1985,22,0,33,29,84
11/16/1985,28,0,12,21,61
11/17/1985,19,0,20,18,57
11/18/1985,14,0,22,8,44
11/19/1985,24,0,12,16,52
11/20/1985,25,0,14,13,52
11/21/1985,21,0,27,28,76
11/22/1985,18,0,25,17,60
11/23/1985,17,0,12,28,57
11/24/1985,25,0,23,20,68
11/25/1985,28,0,22,27,77
11/26/1985,19,0,22,5,46
11/27/1985,13,0,20,31,64
11/28/1985,28,0,16,30,74
11/29/1985,28,0,26,19,73
11/30/1985,29,0,20,1,50
12/1/1985,30,0,22,34,86
12/2/1985,27,0,26,24,77
12/3/1985,25,0,15,21,61
12/4/1985,26,0,24,18,68
12/5/1985,13,0,28,19,60
12/6/1985,13,0,20,14,47
12/7/1985,19,0,26,16,61
12/8/1985,27,0,16,14,57
12/9/1985,22,0,23,26,71
12/10/1985,17,0,21,31,69
12/11/1985,18,0,23,13,54
12/12/1985,28,0,22,23,73
12/13/1985,15,0,24,14,53
12/14/1985,20,0,18,13,51
12/15/1985,20,0,17,7,44
12/16/1985,18,0,29,20,67
12/17/1985,15,0,12,20,47
12/18/1985,16,0,21,27,64
12/19/1985,26,0,25,18,69
12/20/1985,22,0,22,24,68
12/21/1985,26,0,12,11,49
12/22/1985,28,0,21,18,67
12/23/1985,25,0,23,17,65
12/24/1985,18,0,28,13,59
12/25/1985,19,0,14,10,43
12/26/1985,23,0,10,15,48
12/27/1985,28,0,17,17,62
12/28/1985,20,0,20,11,51
12/29/1985,30,0,19,26,75
12/30/1985,24,0,17,10,51
12/31/1985,24,0,25,11,60
1/1/1986,26,0,22,10,58
1/2/1986,19,0,13,35,67
1/3/1986,20,0,27,22,69
1/4/1986,17,0,10,27,54
1/5/1986,13,0,23,26,62
1/6/1986,14,0,19,9,42
1/7/1986,20,0,22,18,60
1/8/1986,30,0,19,26,75
1/9/1986,19,0,22,23,64
1/10/1986,18,0,19,21,58
1/11/1986,29,0,21,17,67
1/12/1986,23,0,22,10,55
1/13/1986,24,0,21,18,63
1/14/1986,30,0,27,14,71
1/15/1986,25,0,13,28,66
1/16/1986,25,0,17,19,61
1/17/1986,26,0,15,22,63
1/18/1986,24,0,16,8,48
1/19/1986,21,0,19,17,57
1/20/1986,28,0,20,11,59
1/21/1986,20,0,26,24,70
1/22/1986,27,0,17,29,73
1/23/1986,21,0,13,12,46
1/24/1986,29,0,23,23,75
1/25/1986,19,0,28,15,62
1/26/1986,16,0,21,22,59
1/27/1986,33,0,18,30,81
1/28/1986,16,0,31,7,54
1/29/1986,20,0,22,38,80
1/30/1986,19,0,15,16,50
1/31/1986,23,0,18,10,51
2/1/1986,27,0,12,15,54
2/2/1986,19,0,11,15,45
2/3/1986,14,0,19,6,39
2/4/1986,24,0,24,12,60
2/5/1986,18,0,15,28,61
2/6/1986,18,0,11,13,42
2/7/1986,17,0,19,9,45
2/8/1986,21,0,31,16,68
2/9/1986,17,0,13,38,68
2/10/1986,15,0,19,22,56
2/11/1986,25,0,20,20,65
2/12/1986,24,0,32,19,75
2/13/1986,20,0,20,28,68
2/14/1986,16,0,25,22,63
2/15/1986,30,0,9,15,54
2/16/1986,11,0,24,18,53
2/17/1986,23,0,20,20,63
2/18/1986,28,0,25,18,71
2/19/1986,32,0,19,33,84
2/20/1986,21,0,21,26,68
2/21/1986,22,0,21,17,60
2/22/1986,21,0,27,19,67
2/23/1986,26,0,17,12,55
2/24/1986,26,0,30,11,67
2/25/1986,25,0,13,16,54
2/26/1986,30,0,27,26,83
2/27/1986,30,0,18,18,66
2/28/1986,17,0,27,22,66
3/1/1986,35,0,18,27,80
3/2/1986,15,0,20,15,50
3/3/1986,25,0,15,17,57
3/4/1986,18,0,14,25,57
3/5/1986,20,0,21,7,48
3/6/1986,19,0,11,23,53
3/7/1986,34,0,13,23,70
3/8/1986,25,0,27,12,64
3/9/1986,28,0,17,24,69
3/10/1986,29,0,25,15,69
3/11/1986,20,0,25,14,59
3/12/1986,22,0,27,12,61
3/13/1986,22,0,21,16,59
3/14/1986,11,0,24,11,46
3/15/1986,26,0,17,30,73
3/16/1986,29,0,9,30,68
3/17/1986,21,0,15,12,48
3/18/1986,26,0,19,21,66
3/19/1986,29,0,14,20,63
3/20/1986,30,0,23,12,65
3/21/1986,19,0,22,28,69
3/22/1986,22,0,28,2,52
3/23/1986,29,0,19,30,78
3/24/1986,23,0,19,25,67
3/25/1986,18,0,25,31,74
3/26/1986,26,0,28,21,75
3/27/1986,24,0,17,17,58
3/28/1986,19,0,19,31,69
3/29/1986,32,0,28,16,76
3/30/1986,18,0,15,28,61
3/31/1986,31,0,25,8,64
4/1/1986,23,0,28,25,76
4/2/1986,22,0,33,31,86
4/3/1986,20,0,17,28,65
4/4/1986,20,0,18,20,58
4/5/1986,21,0,16,5,42
4/6/1986,27,0,18,14,59
4/7/1986,22,0,27,16,65
4/8/1986,24,0,18,11,53
4/9/1986,32,0,20,22,74
4/10/1986,22,0,26,30,78
4/11/1986,16,0,29,11,56
4/12/1986,26,0,8,23,57
4/13/1986,22,0,30,20,72
4/14/1986,25,0,18,20,63
4/15/1986,21,0,25,10,56
4/16/1986,27,0,15,19,61
4/17/1986,17,0,25,10,52
4/18/1986,25,0,21,11,57
4/19/1986,21,0,12,17,50
4/20/1986,20,0,23,10,53
4/21/1986,29,0,26,15,70
4/22/1986,25,0,26,16,67
4/23/1986,19,0,27,9,55
4/24/1986,21,0,17,27,65
4/25/1986,20,0,21,28,69
4/26/1986,10,0,23,32,65
4/27/1986,17,0,20,19,56
4/28/1986,19,0,18,9,46
4/29/1986,30,0,15,18,63
4/30/1986,15,0,12,30,57
5/1/1986,19,0,21,23,63
5/2/1986,14,0,28,16,58
5/3/1986,15,0,14,22,51
5/4/1986,23,0,25,27,75
5/5/1986,22,0,24,19,65
5/6/1986,22,0,20,5,47
5/7/1986,24,0,27,32,83
5/8/1986,25,0,14,31,70
5/9/1986,21,0,9,14,44
5/10/1986,32,0,18,27,77
5/11/1986,26,0,19,22,67
5/12/1986,26,0,18,19,63
5/13/1986,19,0,16,17,52
5/14/1986,12,0,28,21,61
5/15/1986,19,0,15,16,50
5/16/1986,20,0,26,19,65
5/17/1986,26,0,18,24,68
5/18/1986,22,0,14,13,49
5/19/1986,19,0,25,31,75
5/20/1986,28,0,17,16,61
5/21/1986,32,0,27,17,76
5/22/1986,17,0,22,22,61
5/23/1986,20,0,25,17,62
5/24/1986,30,0,21,26,77
5/25/1986,24,0,13,30,67
5/26/1986,23,0,24,17,64
5/27/1986,26,0,28,25,79
5/28/1986,26,0,19,22,67
5/29/1986,23,0,9,6,38
5/30/1986,21,0,18,17,56
5/31/1986,24,0,11,34,69
6/1/1986,32,0,22,5,59
6/2/1986,20,0,14,16,50
6/3/1986,34,0,16,23,73
6/4/1986,17,0,13,23,53
6/5/1986,11,0,28,19,58
6/6/1986,23,0,18,18,59
6/7/1986,21,0,14,17,52
6/8/1986,17,0,19,12,48
6/9/1986,28,0,23,16,67
6/10/1986,22,0,19,14,55
6/11/1986,18,0,25,10,53
6/12/1986,16,0,24,22,62
6/13/1986,21,0,8,18,47
6/14/1986,33,0,17,20,70
6/15/1986,22,0,23,9,54
6/16/1986,24,0,21,24,69
6/17/1986,18,0,10,25,53
6/18/1986,25,0,28,18,71
6/19/1986,32,0,12,19,63
6/20/1986,26,0,15,29,70
6/21/1986,19,0,26,19,64
6/22/1986,11,0,22,27,60
6/23/1986,14,0,22,18,54
6/24/1986,16,0,31,22,69
6/25/1986,34,0,21,22,77
6/26/1986,21,0,16,21,58
6/27/1986,30,0,22,17,69
6/28/1986,25,0,23,25,73
6/29/1986,29,0,23,21,73
6/30/1986,12,0,20,24,56
7/1/1986,22,0,16,17,55
7/2/1986,29,0,27,16,72
7/3/1986,27,0,24,27,78
7/4/1986,17,0,14,36,67
7/5/1986,19,0,21,21,61
7/6/1986,28,0,21,10,59
7/7/1986,26,0,16,13,55
7/8/1986,25,0,14,15,54
7/9/1986,26,0,26,15,67
7/10/1986,22,0,15,27,64
7/11/1986,20,0,20,20,60
7/12/1986,27,0,20,23,70
7/13/1986,26,0,22,23,71
7/14/1986,15,0,30,27,72
7/15/1986,18,0,31,13,62
7/16/1986,20,0,17,23,60
7/17/1986,25,0,12,22,59
7/18/1986,18,0,30,7,55
7/19/1986,28,0,20,24,72
7/20/1986,27,0,26,26,79
7/21/1986,27,0,15,30,72
7/22/1986,15,0,27,10,52
7/23/1986,25,0,16,30,71
7/24/1986,20,0,12,20,52
7/25/1986,25,0,20,29,74
7/26/1986,25,0,13,24,62
7/27/1986,26,0,20,5,51
7/28/1986,23,0,23,26,72
7/29/1986,26,0,11,18,55
7/30/1986,24,0,16,22,62
7/31/1986,28,0,22,8,58
8/1/1986,24,0,23,22,69
8/2/1986,21,0,18,19,58
8/3/1986,22,0,23,20,65
8/4/1986,28,0,22,21,71
8/5/1986,23,0,17,11,51
8/6/1986,34,0,30,27,91
8/7/1986,23,0,20,21,64
8/8/1986,20,0,31,22,73
8/9/1986,26,0,26,23,75
8/10/1986,21,0,19,10,50
8/11/1986,27,0,27,23,77
8/12/1986,26,0,21,15,62
8/13/1986,21,0,20,17,58
8/14/1986,19,0,18,17,54
8/15/1986,31,0,24,17,72
8/16/1986,21,0,25,23,69
8/17/1986,23,0,14,27,64
8/18/1986,26,0,19,20,65
8/19/1986,25,0,17,12,54
8/20/1986,22,0,12,32,66
8/21/1986,25,0,26,17,68
8/22/1986,23,0,27,9,59
8/23/1986,21,0,16,27,64
8/24/1986,20,0,25,18,63
8/25/1986,19,0,16,9,44
8/26/1986,20,0,17,22,59
8/27/1986,24,0,24,18,66
8/28/1986,28,0,19,25,72
8/29/1986,26,0,16,14,56
8/30/1986,21,0,27,23,71
8/31/1986,18,0,20,27,65
9/1/1986,28,0,24,21,73
9/2/1986,17,0,25,15,57
9/3/1986,26,0,16,21,63
9/4/1986,23,0,19,27,69
9/5/1986,28,0,17,12,57
9/6/1986,24,0,22,16,62
9/7/1986,25,0,23,10,58
9/8/1986,20,0,20,4,44
9/9/1986,24,0,30,6,60
9/10/1986,24,0,32,30,86
9/11/1986,29,0,21,23,73
9/12/1986,29,0,28,10,67
9/13/1986,29,0,16,36,81
9/14/1986,13,0,23,9,45
9/15/1986,26,0,27,22,75
9/16/1986,32,0,16,20,68
9/17/1986,15,0,20,34,69
9/18/1986,23,0,18,25,66
9/19/1986,12,0,21,14,47
9/20/1986,22,0,25,24,71
9/21/1986,32,0,16,2,50
9/22/1986,15,0,15,17,47
9/23/1986,20,0,10,21,51
9/24/1986,28,0,17,22,67
9/25/1986,19,0,25,28,72
9/26/1986,29,0,14,5,48
9/27/1986,19,0,22,33,74
9/28/1986,26,0,22,27,75
9/29/1986,27,0,33,15,75
9/30/1986,17,0,26,22,65
10/1/1986,20,0,18,11,49
10/2/1986,16,0,21,15,52
10/3/1986,19,0,20,10,49
10/4/1986,26,0,19,16,61
10/5/1986,23,0,14,15,52
10/6/1986,20,0,24,26,70
10/7/1986,20,0,22,16,58
10/8/1986,20,0,24,33,77
10/9/1986,29,0,18,17,64
10/10/1986,21,0,23,16,60
10/11/1986,19,0,29,19,67
10/12/1986,25,0,21,12,58
10/13/1986,27,0,12,26,65
10/14/1986,14,0,10,16,40
10/15/1986,24,0,28,25,77
10/16/1986,34,0,21,10,65
10/17/1986,14,0,13,23,50
10/18/1986,32,0,20,18,70
10/19/1986,25,0,13,17,55
10/20/1986,13,0,26,21,60
10/21/1986,25,0,27,18,70
10/22/1986,23,0,20,27,70
10/23/1986,28,0,23,9,60
10/24/1986,23,0,15,27,65
10/25/1986,25,0,10,20,55
10/26/1986,18,0,23,24,65
10/27/1986,15,0,12,25,52
10/28/1986,22,0,30,27,79
10/29/1986,19,0,24,20,63
10/30/1986,17,0,20,12,49
10/31/1986,18,0,17,22,57
11/1/1986,25,0,26,17,68
11/2/1986,17,0,22,12,51
11/3/1986,23,0,19,17,59
11/4/1986,34,0,25,26,85
11/5/1986,26,0,24,32,82
11/6/1986,29,0,18,17,64
11/7/1986,32,0,17,8,57
11/8/1986,23,0,32,33,88
11/9/1986,16,0,16,26,58
11/10/1986,22,0,20,30,72
11/11/1986,33,0,15,23,71
11/12/1986,19,0,18,21,58
11/13/1986,20,0,18,29,67
11/14/1986,17,0,19,22,58
11/15/1986,20,0,18,22,60
11/16/1986,17,0,17,25,59
11/17/1986,25,0,20,29,74
11/18/1986,24,0,28,23,75
11/19/1986,30,0,19,30,79
11/20/1986,18,0,11,13,42
11/21/1986,23,0,24,35,82
11/22/1986,21,0,22,5,48
11/23/1986,24,0,28,22,74
11/24/1986,20,0,21,27,68
11/25/1986,19,0,23,10,52
11/26/1986,28,0,28,29,85
11/27/1986,31,0,18,19,68
11/28/1986,17,0,17,24,58
11/29/1986,18,0,22,15,55
11/30/1986,20,0,21,25,66
12/1/1986,24,0,21,31,76
12/2/1986,19,0,17,16,52
12/3/1986,18,0,22,24,64
12/4/1986,29,0,22,23,74
12/5/1986,21,0,25,9,55
12/6/1986,25,0,9,28,62
12/7/1986,25,0,30,36,91
12/8/1986,32,0,28,27,87
12/9/1986,22,0,20,32,74
12/10/1986,20,0,24,12,56
12/11/1986,22,0,20,27,69
12/12/1986,15,0,19,0,34
12/13/1986,22,0,12,8,42
12/14/1986,27,0,26,23,76
12/15/1986,17,0,30,15,62
12/16/1986,18,0,24,20,62
12/17/1986,27,0,25,21,73
12/18/1986,15,0,23,10,48
12/19/1986,25,0,16,10,51
12/20/1986,16,0,17,19,52
12/21/1986,20,0,25,13,58
12/22/1986,21,0,24,21,66
12/23/1986,26,0,11,28,65
12/24/1986,24,0,27,15,66
12/25/1986,22,0,21,20,63
12/26/1986,26,0,26,12,64
12/27/1986,23,0,16,22,61
12/28/1986,20,0,18,4,42
12/29/1986,23,0,22,33,78
12/30/1986,17,0,23,22,62
12/31/1986,15,0,14,19,48
1/1/1987,24,0,11,22,57
1/2/1987,19,0,17,27,63
1/3/1987,19,0,29,22,70
1/4/1987,25,0,11,33,69
1/5/1987,27,0,16,18,61
1/6/1987,17,0,24,20,61
1/7/1987,32,0,22,23,77
1/8/1987,20,0,17,10,47
1/9/1987,28,0,23,25,76
1/10/1987,20,0,21,28,69
1/11/1987,23,0,26,6,55
1/12/1987,28,0,21,23,72
1/13/1987,26,0,28,23,77
1/14/1987,29,0,21,5,55
1/15/1987,23,0,18,29,70
1/16/1987,23,0,11,16,50
1/17/1987,24,0,16,20,60
1/18/1987,25,0,22,20,67
1/19/1987,21,0,24,8,53
1/20/1987,16,0,14,34,64
1/21/1987,15,0,15,28,58
1/22/1987,26,0,10,20,56
1/23/1987,14,0,22,14,50
1/24/1987,19,0,23,22,64
1/25/1987,30,0,16,20,66
1/26/1987,22,0,17,19,58
1/27/1987,22,0,26,9,57
1/28/1987,20,0,17,12,49
1/29/1987,15,0,30,22,67
1/30/1987,25,0,12,12,49
1/31/1987,27,0,24,20,71
2/1/1987,17,0,21,17,55
2/2/1987,17,0,24,29,70
2/3/1987,22,0,22,18,62
2/4/1987,19,0,30,7,56
2/5/1987,18,0,18,12,48
2/6/1987,22,0,29,22,73
2/7/1987,17,0,17,17,51
2/8/1987,27,0,25,21,73
2/9/1987,33,0,15,26,74
2/10/1987,24,0,17,11,52
2/11/1987,29,0,14,18,61
2/12/1987,25,0,28,31,84
2/13/1987,25,0,23,28,76
2/14/1987,15,0,24,10,49
2/15/1987,18,0,25,16,59
2/16/1987,29,0,27,26,82
2/17/1987,20,0,20,19,59
2/18/1987,27,0,15,22,64
2/19/1987,25,0,15,16,56
2/20/1987,20,0,18,14,52
2/21/1987,24,0,11,26,61
2/22/1987,22,0,25,23,70
2/23/1987,29,0,22,26,77
2/24/1987,28,0,19,19,66
2/25/1987,27,0,28,37,92
2/26/1987,21,0,21,7,49
2/27/1987,18,0,24,22,64
2/28/1987,28,0,17,30,75
3/1/1987,29,0,27,34,90
3/2/1987,18,0,18,27,63
3/3/1987,24,0,26,29,79
3/4/1987,20,0,25,19,64
3/5/1987,24,0,18,30,72
3/6/1987,25,0,20,31,76
3/7/1987,24,0,21,25,70
3/8/1987,22,0,18,28,68
3/9/1987,17,0,25,13,55
3/10/1987,24,0,18,12,54
3/11/1987,20,0,11,17,48
3/12/1987,18,0,15,36,69
3/13/1987,26,0,30,13,69
3/14/1987,24,0,25,6,55
3/15/1987,19,0,20,22,61
3/16/1987,28,0,20,29,77
3/17/1987,29,0,24,23,76
3/18/1987,19,0,28,12,59
3/19/1987,35,0,12,10,57
3/20/1987,20,0,24,11,55
3/21/1987,25,0,29,33,87
3/22/1987,28,0,13,26,67
3/23/1987,23,0,8,23,54
3/24/1987,19,0,25,7,51
3/25/1987,27,0,15,10,52
3/26/1987,29,0,27,19,75
3/27/1987,31,0,18,14,63
3/28/1987,22,0,22,20,64
3/29/1987,23,0,22,22,67
3/30/1987,17,0,11,33,61
3/31/1987,20,0,18,23,61
4/1/1987,26,0,23,26,75
4/2/1987,28,0,14,7,49
4/3/1987,22,0,31,38,91
4/4/1987,20,0,12,21,53
4/5/1987,22,0,13,23,58
4/6/1987,25,0,19,6,50
4/7/1987,19,0,19,20,58
4/8/1987,22,0,11,15,48
4/9/1987,28,0,24,22,74
4/10/1987,22,0,32,30,84
4/11/1987,17,0,23,23,63
4/12/1987,20,0,25,34,79
4/13/1987,29,0,22,9,60
4/14/1987,18,0,33,4,55
4/15/1987,30,0,17,23,70
4/16/1987,19,0,17,23,59
4/17/1987,28,0,25,26,79
4/18/1987,34,0,26,14,74
4/19/1987,26,0,12,18,56
4/20/1987,20,0,12,21,53
4/21/1987,15,0,13,31,59
4/22/1987,25,0,27,18,70
4/23/1987,33,0,21,10,64
4/24/1987,19,0,15,20,54
4/25/1987,21,0,15,24,60
4/26/1987,23,0,16,18,57
4/27/1987,18,0,13,23,54
4/28/1987,20,0,11,25,56
4/29/1987,24,0,19,28,71
4/30/1987,20,0,21,23,64
5/1/1987,20,0,13,11,44
5/2/1987,11,0,13,32,56
5/3/1987,12,0,16,19,47
5/4/1987,25,0,16,29,70
5/5/1987,33,0,17,29,79
5/6/1987,22,0,15,18,55
5/7/1987,24,0,18,28,70
5/8/1987,30,0,21,17,68
5/9/1987,32,0,24,13,69
5/10/1987,22,0,20,31,73
5/11/1987,23,0,19,8,50
5/12/1987,27,0,21,35,83
5/13/1987,13,0,26,10,49
5/14/1987,26,0,20,27,73
5/15/1987,31,0,18,21,70
5/16/1987,15,0,26,12,53
5/17/1987,17,0,28,17,62
5/18/1987,16,0,23,22,61
5/19/1987,21,0,11,16,48
5/20/1987,24,0,14,22,60
5/21/1987,17,0,21,9,47
5/22/1987,20,0,10,14,44
5/23/1987,18,0,22,24,64
5/24/1987,28,0,10,18,56
5/25/1987,19,0,25,15,59
5/26/1987,21,0,27,35,83
5/27/1987,26,0,16,20,62
5/28/1987,13,0,16,36,65
5/29/1987,19,0,24,16,59
5/30/1987,27,0,18,14,59
5/31/1987,23,0,26,24,73
6/1/1987,25,0,24,16,65
6/2/1987,19,0,21,19,59
6/3/1987,18,0,22,21,61
6/4/1987,20,0,23,19,62
6/5/1987,18,0,28,11,57
6/6/1987,20,0,25,20,65
6/7/1987,18,0,19,13,50
6/8/1987,21,0,16,30,67
6/9/1987,32,0,23,11,66
6/10/1987,15,0,17,23,55
6/11/1987,22,0,24,9,55
6/12/1987,24,0,21,21,66
6/13/1987,23,0,7,29,59
6/14/1987,27,0,23,21,71
6/15/1987,14,0,22,11,47
6/16/1987,29,0,16,13,58
6/17/1987,26,0,15,22,63
6/18/1987,17,0,19,11,47
6/19/1987,21,0,10,30,61
6/20/1987,26,0,15,11,52
6/21/1987,27,0,12,17,56
6/22/1987,20,0,21,25,66
6/23/1987,23,0,29,32,84
6/24/1987,19,0,18,11,48
6/25/1987,22,0,19,18,59
6/26/1987,29,0,19,26,74
6/27/1987,26,0,19,23,68
6/28/1987,13,0,25,12,50
6/29/1987,21,0,19,24,64
6/30/1987,24,0,12,20,56
7/1/1987,27,0,28,6,61
7/2/1987,14,0,20,27,61
7/3/1987,18,0,29,19,66
7/4/1987,22,0,21,32,75
7/5/1987,23,0,24,25,72
7/6/1987,20,0,21,21,62
7/7/1987,31,0,24,15,70
7/8/1987,23,0,20,17,60
7/9/1987,28,0,20,21,69
7/10/1987,16,0,20,15,51
7/11/1987,15,0,22,18,55
7/12/1987,26,0,26,27,79
7/13/1987,26,0,17,29,72
7/14/1987,32,0,21,15,68
7/15/1987,24,0,14,33,71
7/16/1987,32,0,18,26,76
7/17/1987,29,0,12,8,49
7/18/1987,20,0,19,33,72
7/19/1987,17,0,24,22,63
7/20/1987,26,0,26,14,66
7/21/1987,27,0,17,31,75
7/22/1987,26,0,22,22,70
7/23/1987,24,0,11,17,52
7/24/1987,26,0,18,14,58
7/25/1987,26,0,18,6,50
7/26/1987,28,0,19,21,68
7/27/1987,32,0,22,21,75
7/28/1987,17,0,29,23,69
7/29/1987,19,0,21,18,58
7/30/1987,27,0,17,29,73
7/31/1987,14,0,19,20,53
8/1/1987,22,0,16,16,54
8/2/1987,19,0,13,29,61
8/3/1987,26,0,19,27,72
8/4/1987,29,0,22,16,67
8/5/1987,21,0,21,30,72
8/6/1987,22,0,28,8,58
8/7/1987,26,0,18,11,55
8/8/1987,23,0,9,26,58
8/9/1987,24,0,15,22,61
8/10/1987,25,0,15,16,56
8/11/1987,24,0,28,20,72
8/12/1987,29,0,17,16,62
8/13/1987,26,0,16,20,62
8/14/1987,26,0,13,20,59
8/15/1987,23,0,22,27,72
8/16/1987,16,0,18,11,45
8/17/1987,24,0,24,28,76
8/18/1987,22,0,34,10,66
8/19/1987,23,0,28,8,59
8/20/1987,24,0,25,23,72
8/21/1987,23,0,17,27,67
8/22/1987,29,0,16,16,61
8/23/1987,26,0,19,19,64
8/24/1987,31,0,32,28,91
8/25/1987,19,0,31,26,76
8/26/1987,25,0,29,18,72
8/27/1987,31,0,28,22,81
8/28/1987,24,0,23,14,61
8/29/1987,19,0,23,18,60
8/30/1987,25,0,21,31,77
8/31/1987,26,0,25,25,76
9/1/1987,21,0,15,31,67
9/2/1987,24,0,11,17,52
9/3/1987,21,0,27,18,66
9/4/1987,30,0,24,28,82
9/5/1987,24,0,24,23,71
9/6/1987,25,0,8,33,66
9/7/1987,27,0,25,16,68
9/8/1987,22,0,13,31,66
9/9/1987,18,0,16,33,67
9/10/1987,14,0,23,8,45
9/11/1987,16,0,17,26,59
9/12/1987,14,0,16,26,56
9/13/1987,27,0,19,17,63
9/14/1987,18,0,15,9,42
9/15/1987,34,0,15,20,69
9/16/1987,28,0,17,13,58
9/17/1987,17,0,14,5,36
9/18/1987,27,0,23,16,66
9/19/1987,28,0,18,15,61
9/20/1987,23,0,18,17,58
9/21/1987,15,0,20,24,59
9/22/1987,23,0,21,21,65
9/23/1987,25,0,31,19,75
9/24/1987,27,0,8,38,73
9/25/1987,16,0,24,21,61
9/26/1987,17,0,19,16,52
9/27/1987,16,0,15,23,54
9/28/1987,19,0,25,21,65
9/29/1987,26,0,15,26,67
9/30/1987,22,0,25,14,61
10/1/1987,29,0,19,21,69
10/2/1987,28,0,19,18,65
10/3/1987,31,0,23,13,67
10/4/1987,10,0,18,26,54
10/5/1987,23,0,22,27,72
10/6/1987,33,0,17,25,75
10/7/1987,25,0,28,19,72
10/8/1987,17,0,24,10,51
10/9/1987,25,0,14,30,69
10/10/1987,21,0,17,30,68
10/11/1987,28,0,25,16,69
10/12/1987,19,0,25,26,70
10/13/1987,27,0,18,21,66
10/14/1987,18,0,20,17,55
10/15/1987,25,0,16,38,79
10/16/1987,29,0,22,19,70
10/17/1987,20,0,24,19,63
10/18/1987,20,0,22,20,62
10/19/1987,18,0,13,20,51
10/20/1987,24,0,16,21,61
10/21/1987,32,0,26,9,67
10/22/1987,23,0,15,20,58
10/23/1987,29,0,18,13,60
10/24/1987,28,0,9,11,48
10/25/1987,28,0,13,27,68
10/26/1987,32,0,26,17,75
10/27/1987,19,0,25,21,65
10/28/1987,23,0,18,22,63
10/29/1987,24,0,24,23,71
10/30/1987,17,0,21,27,65
10/31/1987,21,0,12,15,48
11/1/1987,15,0,22,15,52
11/2/1987,20,0,19,18,57
11/3/1987,21,0,23,16,60
11/4/1987,22,0,18,19,59
11/5/1987,22,0,23,17,62
11/6/1987,30,0,10,16,56
11/7/1987,21,0,15,25,61
11/8/1987,24,0,13,21,58
11/9/1987,30,0,21,21,72
11/10/1987,25,0,12,19,56
11/11/1987,33,0,23,12,68
11/12/1987,13,0,10,25,48
11/13/1987,22,0,22,18,62
11/14/1987,28,0,12,37,77
11/15/1987,26,0,21,16,63
11/16/1987,26,0,21,16,63
11/17/1987,26,0,11,11,48
11/18/1987,24,0,14,16,54
11/19/1987,29,0,17,16,62
11/20/1987,25,0,21,13,59
11/21/1987,22,0,22,11,55
11/22/1987,24,0,23,19,66
11/23/1987,31,0,24,25,80
11/24/1987,25,0,16,15,56
11/25/1987,24,0,26,24,74
11/26/1987,26,0,19,19,64
11/27/1987,19,0,21,14,54
11/28/1987,29,0,26,20,75
11/29/1987,24,0,28,14,66
11/30/1987,25,0,26,23,74
12/1/1987,26,0,26,22,74
12/2/1987,21,0,19,25,65
12/3/1987,13,0,21,25,59
12/4/1987,22,0,16,7,45
12/5/1987,19,0,26,19,64
12/6/1987,24,0,28,23,75
12/7/1987,19,0,26,25,70
12/8/1987,23,0,20,17,60
12/9/1987,21,0,25,20,66
12/10/1987,19,0,17,22,58
12/11/1987,22,0,17,9,48
12/12/1987,21,0,17,25,63
12/13/1987,28,0,19,12,59
12/14/1987,30,0,15,23,68
12/15/1987,17,0,26,19,62
12/16/1987,28,0,25,14,67
12/17/1987,22,0,29,30,81
12/18/1987,23,0,13,11,47
12/19/1987,33,0,14,22,69
12/20/1987,22,0,20,16,58
12/21/1987,26,0,30,22,78
12/22/1987,17,0,31,27,75
12/23/1987,25,0,14,20,59
12/24/1987,24,0,28,6,58
12/25/1987,20,0,31,28,79
12/26/1987,19,0,18,24,61
12/27/1987,24,0,21,26,71
12/28/1987,20,0,12,28,60
12/29/1987,23,0,11,29,63
12/30/1987,18,0,20,14,52
12/31/1987,15,0,23,22,60
1/1/1988,32,0,24,21,77
1/2/1988,19,0,18,10,47
1/3/1988,22,0,16,4,42
1/4/1988,21,0,20,32,73
1/5/1988,27,0,18,13,58
1/6/1988,32,0,17,16,65
1/7/1988,25,0,18,21,64
1/8/1988,19,0,15,25,59
1/9/1988,16,0,20,29,65
1/10/1988,30,0,17,19,66
1/11/1988,27,0,17,24,68
1/12/1988,24,0,13,32,69
1/13/1988,23,0,25,16,64
1/14/1988,16,0,15,19,50
1/15/1988,21,0,20,13,54
1/16/1988,21,0,22,5,48
1/17/1988,23,0,21,7,51
1/18/1988,23,0,14,36,73
1/19/1988,25,0,13,29,67
1/20/1988,20,0,23,16,59
1/21/1988,17,0,29,15,61
1/22/1988,24,0,27,26,77
1/23/1988,25,0,9,21,55
1/24/1988,29,0,11,11,51
1/25/1988,27,0,18,25,70
1/26/1988,21,0,8,15,44
1/27/1988,32,0,11,18,61
1/28/1988,16,0,21,10,47
1/29/1988,20,0,24,17,61
1/30/1988,19,0,23,28,70
1/31/1988,32,0,20,16,68
2/1/1988,28,0,27,19,74
2/2/1988,26,0,18,22,66
2/3/1988,21,0,28,25,74
2/4/1988,15,0,24,26,65
2/5/1988,22,0,14,32,68
2/6/1988,25,0,25,29,79
2/7/1988,31,0,22,30,83
2/8/1988,25,0,27,26,78
2/9/1988,18,0,10,25,53
2/10/1988,26,0,19,9,54
2/11/1988,21,0,28,14,63
2/12/1988,18,0,19,14,51
2/13/1988,16,0,20,28,64
2/14/1988,19,0,13,35,67
2/15/1988,22,0,21,16,59
2/16/1988,24,0,12,20,56
2/17/1988,31,0,22,21,74
2/18/1988,20,0,17,36,73
2/19/1988,20,0,18,12,50
2/20/1988,27,0,20,29,76
2/21/1988,24,0,18,34,76
2/22/1988,24,0,17,13,54
2/23/1988,21,0,18,6,45
2/24/1988,27,0,28,19,74
2/25/1988,27,0,16,18,61
2/26/1988,17,0,24,17,58
2/27/1988,26,0,22,33,81
2/28/1988,19,0,22,11,52
2/29/1988,19,0,20,28,67
3/1/1988,24,0,20,17,61
3/2/1988,22,0,15,18,55
3/3/1988,23,0,22,19,64
3/4/1988,18,0,22,14,54
3/5/1988,23,0,20,18,61
3/6/1988,11,0,22,33,66
3/7/1988,16,0,23,27,66
3/8/1988,27,0,13,29,69
3/9/1988,27,0,22,7,56
3/10/1988,26,0,27,26,79
3/11/1988,29,0,20,12,61
3/12/1988,22,0,26,18,66
3/13/1988,34,0,17,35,86
3/14/1988,22,0,15,23,60
3/15/1988,25,0,23,21,69
3/16/1988,27,0,34,6,67
3/17/1988,23,0,22,27,72
3/18/1988,30,0,25,10,65
3/19/1988,20,0,20,29,69
3/20/1988,21,0,18,18,57
3/21/1988,15,0,25,17,57
3/22/1988,22,0,10,15,47
3/23/1988,28,0,20,20,68
3/24/1988,25,0,25,15,65
3/25/1988,29,0,32,5,66
3/26/1988,26,0,10,15,51
3/27/1988,28,0,15,6,49
3/28/1988,23,0,24,27,74
3/29/1988,19,0,17,11,47
3/30/1988,28,0,29,22,79
3/31/1988,16,0,20,21,57
4/1/1988,22,0,19,40,81
4/2/1988,26,0,20,26,72
4/3/1988,29,0,19,12,60
4/4/1988,19,0,13,20,52
4/5/1988,21,0,15,15,51
4/6/1988,22,0,28,15,65
4/7/1988,17,0,12,11,40
4/8/1988,24,0,12,18,54
4/9/1988,28,0,27,22,77
4/10/1988,28,0,15,18,61
4/11/1988,13,0,12,28,53
4/12/1988,25,0,14,19,58
4/13/1988,26,0,21,19,66
4/14/1988,23,0,23,15,61
4/15/1988,30,0,22,19,71
4/16/1988,26,0,28,23,77
4/17/1988,21,0,21,21,63
4/18/1988,27,0,10,23,60
4/19/1988,22,0,28,21,71
4/20/1988,25,0,20,21,66
4/21/1988,21,0,23,21,65
4/22/1988,23,0,11,14,48
4/23/1988,23,0,22,25,70
4/24/1988,14,0,28,9,51
4/25/1988,23,0,11,22,56
4/26/1988,30,0,16,17,63
4/27/1988,22,0,24,7,53
4/28/1988,29,0,19,8,56
4/29/1988,29,0,10,11,50
4/30/1988,24,0,13,9,46
5/1/1988,21,0,15,10,46
5/2/1988,22,0,19,10,51
5/3/1988,18,0,22,17,57
5/4/1988,29,0,22,18,69
5/5/1988,25,0,14,19,58
5/6/1988,30,0,15,18,63
5/7/1988,26,0,20,18,64
5/8/1988,21,0,17,12,50
5/9/1988,29,0,24,28,81
5/10/1988,19,0,20,12,51
5/11/1988,24,0,19,35,78
5/12/1988,19,0,26,29,74
5/13/1988,20,0,25,21,66
5/14/1988,17,0,15,21,53
5/15/1988,20,0,14,20,54
5/16/1988,24,0,8,26,58
5/17/1988,18,0,17,25,60
5/18/1988,14,0,21,23,58
5/19/1988,18,0,23,22,63
5/20/1988,32,0,16,14,62
5/21/1988,20,0,18,7,45
5/22/1988,26,0,23,25,74
5/23/1988,23,0,29,11,63
5/24/1988,21,0,16,13,50
5/25/1988,23,0,18,12,53
5/26/1988,22,0,29,14,65
5/27/1988,18,0,29,24,71
5/28/1988,22,0,22,1,45
5/29/1988,19,0,27,32,78
5/30/1988,22,0,14,25,61
5/31/1988,18,0,11,11,40
6/1/1988,19,0,30,16,65
6/2/1988,28,0,18,27,73
6/3/1988,18,0,24,11,53
6/4/1988,24,0,24,6,54
6/5/1988,23,0,6,19,48
6/6/1988,25,0,26,24,75
6/7/1988,33,0,28,17,78
6/8/1988,15,0,23,21,59
6/9/1988,28,0,27,22,77
6/10/1988,16,0,8,10,34
6/11/1988,31,0,12,9,52
6/12/1988,31,0,19,17,67
6/13/1988,22,0,19,15,56
6/14/1988,28,0,11,14,53
6/15/1988,31,0,14,20,65
6/16/1988,19,0,24,12,55
6/17/1988,23,0,30,15,68
6/18/1988,21,0,11,13,45
6/19/1988,28,0,29,10,67
6/20/1988,26,0,32,13,71
6/21/1988,22,0,17,13,52
6/22/1988,23,0,25,17,65
6/23/1988,24,0,16,27,67
6/24/1988,25,0,19,26,70
6/25/1988,27,0,20,17,64
6/26/1988,26,0,19,18,63
6/27/1988,23,0,9,4,36
6/28/1988,35,0,7,17,59
6/29/1988,20,0,18,19,57
6/30/1988,22,0,18,37,77
7/1/1988,22,0,22,17,61
7/2/1988,23,0,18,28,69
7/3/1988,27,0,26,25,78
7/4/1988,18,0,28,27,73
7/5/1988,30,0,22,18,70
7/6/1988,23,0,25,12,60
7/7/1988,20,0,17,20,57
7/8/1988,27,0,13,25,65
7/9/1988,27,0,26,14,67
7/10/1988,14,0,19,14,47
7/11/1988,32,0,20,18,70
7/12/1988,15,0,24,18,57
7/13/1988,35,0,27,18,80
7/14/1988,32,0,13,25,70
7/15/1988,21,0,27,21,69
7/16/1988,19,0,20,13,52
7/17/1988,21,0,15,8,44
7/18/1988,26,0,22,32,80
7/19/1988,16,0,26,31,73
7/20/1988,25,0,16,15,56
7/21/1988,20,0,15,22,57
7/22/1988,19,0,18,27,64
7/23/1988,31,0,17,19,67
7/24/1988,23,0,18,25,66
7/25/1988,30,0,22,12,64
7/26/1988,28,0,27,21,76
7/27/1988,23,0,20,9,52
7/28/1988,28,0,19,25,72
7/29/1988,20,0,19,27,66
7/30/1988,17,0,26,16,59
7/31/1988,25,0,16,24,65
8/1/1988,14,0,24,28,66
8/2/1988,21,0,16,18,55
8/3/1988,20,0,13,27,60
8/4/1988,20,0,22,32,74
8/5/1988,32,0,30,15,77
8/6/1988,19,0,26,21,66
8/7/1988,20,0,15,19,54
8/8/1988,19,0,23,11,53
8/9/1988,25,0,16,17,58
8/10/1988,14,0,16,21,51
8/11/1988,23,0,12,10,45
8/12/1988,13,0,24,11,48
8/13/1988,24,0,25,11,60
8/14/1988,23,0,12,27,62
8/15/1988,26,0,20,18,64
8/16/1988,29,0,23,15,67
8/17/1988,18,0,12,8,38
8/18/1988,28,0,16,17,61
8/19/1988,27,0,21,24,72
8/20/1988,27,0,26,17,70
8/21/1988,25,0,25,17,67
8/22/1988,22,0,28,29,79
8/23/1988,18,0,12,21,51
8/24/1988,20,0,12,31,63
8/25/1988,16,0,21,15,52
8/26/1988,22,0,20,32,74
8/27/1988,17,0,22,6,45
8/28/1988,30,0,23,20,73
8/29/1988,26,0,26,7,59
8/30/1988,27,0,19,12,58
8/31/1988,23,0,23,29,75
9/1/1988,27,0,13,19,59
9/2/1988,32,0,24,23,79
9/3/1988,23,0,11,10,44
9/4/1988,30,0,19,19,68
9/5/1988,24,0,20,25,69
9/6/1988,30,0,25,21,76
9/7/1988,20,0,23,17,60
9/8/1988,23,0,12,23,58
9/9/1988,26,0,16,33,75
9/10/1988,22,0,32,13,67
9/11/1988,25,0,21,11,57
9/12/1988,19,0,27,19,65
9/13/1988,28,0,10,28,66
9/14/1988,16,0,20,29,65
9/15/1988,27,0,13,19,59
9/16/1988,25,0,22,25,72
9/17/1988,32,0,15,13,60
9/18/1988,22,0,26,12,60
9/19/1988,21,0,29,17,67
9/20/1988,26,0,26,22,74
9/21/1988,19,0,11,22,52
9/22/1988,18,0,23,18,59
9/23/1988,25,0,15,31,71
9/24/1988,19,0,13,16,48
9/25/1988,20,0,14,23,57
9/26/1988,17,0,16,28,61
9/27/1988,19,0,13,2,34
9/28/1988,13,0,18,20,51
9/29/1988,21,0,21,28,70
9/30/1988,16,0,16,17,49
10/1/1988,25,0,25,21,71
10/2/1988,30,0,17,35,82
10/3/1988,25,0,27,24,76
10/4/1988,24,0,19,25,68
10/5/1988,27,0,25,19,71
10/6/1988,22,0,21,31,74
10/7/1988,22,0,13,28,63
10/8/1988,15,0,18,21,54
10/9/1988,24,0,21,26,71
10/10/1988,23,0,20,20,63
10/11/1988,26,0,22,27,75
10/12/1988,19,0,28,22,69
10/13/1988,13,0,13,25,51
10/14/1988,20,0,20,10,50
10/15/1988,28,0,21,23,72
10/16/1988,18,0,27,23,68
10/17/1988,14,0,13,27,54
10/18/1988,29,0,19,27,75
10/19/1988,18,0,19,15,52
10/20/1988,20,0,20,17,57
10/21/1988,16,0,25,19,60
10/22/1988,23,0,12,19,54
10/23/1988,20,0,14,14,48
10/24/1988,19,0,21,11,51
10/25/1988,23,0,20,20,63
10/26/1988,15,0,32,33,80
10/27/1988,14,0,31,20,65
10/28/1988,18,0,30,16,64
10/29/1988,27,0,16,14,57
10/30/1988,31,0,21,27,79
10/31/1988,28,0,24,24,76
11/1/1988,21,0,12,15,48
11/2/1988,17,0,21,10,48
11/3/1988,16,0,22,27,65
11/4/1988,16,0,23,9,48
11/5/1988,31,0,14,17,62
11/6/1988,16,0,10,15,41
11/7/1988,18,0,18,11,47
11/8/1988,16,0,19,31,66
11/9/1988,28,0,14,35,77
11/10/1988,27,0,12,15,54
11/11/1988,25,0,22,14,61
11/12/1988,30,0,28,26,84
11/13/1988,26,0,24,22,72
11/14/1988,28,0,23,20,71
11/15/1988,28,0,19,12,59
11/16/1988,18,0,18,20,56
11/17/1988,16,0,24,15,55
11/18/1988,28,0,23,22,73
11/19/1988,28,0,22,25,75
11/20/1988,11,0,26,19,56
11/21/1988,31,0,21,13,65
11/22/1988,13,0,21,12,46
11/23/1988,18,0,10,8,36
11/24/1988,18,0,24,25,67
11/25/1988,19,0,23,21,63
11/26/1988,22,0,17,28,67
11/27/1988,26,0,25,13,64
11/28/1988,15,0,11,28,54
11/29/1988,26,0,24,25,75
11/30/1988,22,0,14,16,52
12/1/1988,27,0,22,19,68
12/2/1988,23,0,31,27,81
12/3/1988,25,0,29,21,75
12/4/1988,33,0,16,12,61
12/5/1988,22,0,19,10,51
12/6/1988,19,0,27,12,58
12/7/1988,19,0,29,13,61
12/8/1988,28,0,13,6,47
12/9/1988,27,0,8,21,56
12/10/1988,19,0,16,24,59
12/11/1988,15,0,10,25,50
12/12/1988,27,0,18,16,61
12/13/1988,21,0,22,19,62
12/14/1988,23,0,28,18,69
12/15/1988,21,0,13,12,46
12/16/1988,23,0,23,22,68
12/17/1988,27,0,20,18,65
12/18/1988,29,0,11,18,58
12/19/1988,32,0,22,24,78
12/20/1988,24,0,26,13,63
12/21/1988,23,0,20,17,60
12/22/1988,22,0,19,22,63
12/23/1988,16,0,15,33,64
12/24/1988,22,0,29,36,87
12/25/1988,17,0,19,18,54
12/26/1988,18,0,11,26,55
12/27/1988,27,0,22,36,85
12/28/1988,22,0,15,17,54
12/29/1988,20,0,21,21,62
12/30/1988,27,0,19,25,71
12/31/1988,21,0,29,26,76
1/1/1989,27,0,26,27,80
1/2/1989,30,0,22,22,74
1/3/1989,21,0,18,33,72
1/4/1989,26,0,16,12,54
1/5/1989,24,0,15,13,52
1/6/1989,29,0,24,20,73
1/7/1989,28,0,16,25,69
1/8/1989,20,0,23,13,56
1/9/1989,21,0,11,31,63
1/10/1989,28,0,15,16,59
1/11/1989,23,0,24,17,64
1/12/1989,27,0,30,31,88
1/13/1989,14,0,22,17,53
1/14/1989,19,0,22,31,72
1/15/1989,19,0,18,12,49
1/16/1989,24,0,11,20,55
1/17/1989,19,0,14,13,46
1/18/1989,32,0,23,19,74
1/19/1989,19,0,28,25,72
1/20/1989,31,0,12,9,52
1/21/1989,28,0,26,9,63
1/22/1989,25,0,25,31,81
1/23/1989,18,0,22,19,59
1/24/1989,33,0,17,18,68
1/25/1989,16,0,12,23,51
1/26/1989,25,0,22,17,64
1/27/1989,33,0,19,28,80
1/28/1989,17,0,22,24,63
1/29/1989,24,0,16,15,55
1/30/1989,16,0,14,25,55
1/31/1989,20,0,23,22,65
2/1/1989,25,0,23,22,70
2/2/1989,27,0,26,20,73
2/3/1989,22,0,24,11,57
2/4/1989,17,0,24,18,59
2/5/1989,26,0,9,29,64
2/6/1989,24,0,27,21,72
2/7/1989,23,0,23,28,74
2/8/1989,16,0,20,20,56
2/9/1989,24,0,17,20,61
2/10/1989,25,0,19,11,55
2/11/1989,22,0,29,6,57
2/12/1989,17,0,16,21,54
2/13/1989,24,0,31,13,68
2/14/1989,16,0,14,17,47
2/15/1989,17,0,21,8,46
2/16/1989,19,0,20,23,62
2/17/1989,26,0,31,15,72
2/18/1989,29,0,14,13,56
2/19/1989,29,0,20,22,71
2/20/1989,26,0,14,21,61
2/21/1989,14,0,25,3,42
2/22/1989,27,0,24,22,73
2/23/1989,17,0,13,29,59
2/24/1989,17,0,13,33,63
2/25/1989,31,0,22,26,79
2/26/1989,29,0,15,21,65
2/27/1989,21,0,32,23,76
2/28/1989,27,0,17,7,51
3/1/1989,22,0,19,16,57
3/2/1989,31,0,18,28,77
3/3/1989,32,0,19,24,75
3/4/1989,34,0,10,19,63
3/5/1989,19,0,31,17,67
3/6/1989,17,0,26,19,62
3/7/1989,20,0,13,19,52
3/8/1989,27,0,27,31,85
3/9/1989,19,0,14,23,56
3/10/1989,25,0,23,25,73
3/11/1989,24,0,8,23,55
3/12/1989,16,0,13,20,49
3/13/1989,19,0,17,12,48
3/14/1989,34,0,18,27,79
3/15/1989,30,0,17,21,68
3/16/1989,20,0,17,18,55
3/17/1989,19,0,22,17,58
3/18/1989,30,0,18,16,64
3/19/1989,28,0,17,23,68
3/20/1989,20,0,16,12,48
3/21/1989,29,0,15,20,64
3/22/1989,28,0,17,15,60
3/23/1989,19,0,25,28,72
3/24/1989,18,0,23,32,73
3/25/1989,19,0,26,30,75
3/26/1989,19,0,20,14,53
3/27/1989,15,0,15,12,42
3/28/1989,31,0,16,8,55
3/29/1989,25,0,24,23,72
3/30/1989,29,0,15,31,75
3/31/1989,18,0,9,6,33
4/1/1989,16,0,24,13,53
4/2/1989,21,0,22,17,60
4/3/1989,24,0,27,24,75
4/4/1989,21,0,24,24,69
4/5/1989,12,0,13,21,46
4/6/1989,19,0,11,29,59
4/7/1989,31,0,19,20,70
4/8/1989,28,0,23,9,60
4/9/1989,16,0,18,13,47
4/10/1989,20,0,12,16,48
4/11/1989,20,0,17,16,53
4/12/1989,33,0,22,38,93
4/13/1989,33,0,18,5,56
4/14/1989,21,0,25,24,70
4/15/1989,25,0,28,35,88
4/16/1989,16,0,18,20,54
4/17/1989,21,0,16,31,68
4/18/1989,24,0,20,23,67
4/19/1989,23,0,17,22,62
4/20/1989,18,0,22,35,75
4/21/1989,25,0,29,12,66
4/22/1989,25,0,14,25,64
4/23/1989,22,0,26,8,56
4/24/1989,33,0,24,26,83
4/25/1989,19,0,30,11,60
4/26/1989,26,0,24,26,76
4/27/1989,24,0,17,19,60
4/28/1989,18,0,25,27,70
4/29/1989,18,0,23,16,57
4/30/1989,29,0,15,19,63
5/1/1989,29,0,19,21,69
5/2/1989,31,0,19,11,61
5/3/1989,22,0,19,20,61
5/4/1989,26,0,12,12,50
5/5/1989,16,0,25,14,55
5/6/1989,25,0,33,14,72
5/7/1989,25,0,18,18,61
5/8/1989,25,0,16,28,69
5/9/1989,27,0,25,25,77
5/10/1989,28,0,17,5,50
5/11/1989,17,0,23,10,50
5/12/1989,28,0,27,26,81
5/13/1989,24,0,16,15,55
5/14/1989,14,0,14,5,33
5/15/1989,18,0,16,10,44
5/16/1989,24,0,24,12,60
5/17/1989,28,0,20,28,76
5/18/1989,26,0,30,13,69
5/19/1989,22,0,28,17,67
5/20/1989,26,0,19,12,57
5/21/1989,28,0,32,10,70
5/22/1989,33,0,24,27,84
5/23/1989,23,0,29,19,71
5/24/1989,29,0,30,10,69
5/25/1989,22,0,34,11,67
5/26/1989,22,0,25,31,78
5/27/1989,25,0,16,18,59
5/28/1989,24,0,17,21,62
5/29/1989,22,0,32,30,84
5/30/1989,26,0,26,20,72
5/31/1989,26,0,17,24,67
6/1/1989,17,0,24,27,68
6/2/1989,30,0,12,26,68
6/3/1989,24,0,24,31,79
6/4/1989,21,0,10,15,46
6/5/1989,17,0,26,28,71
6/6/1989,17,0,18,25,60
6/7/1989,27,0,22,26,75
6/8/1989,12,0,13,11,36
6/9/1989,26,0,14,3,43
6/10/1989,30,0,27,20,77
6/11/1989,24,0,27,13,64
6/12/1989,20,0,21,15,56
6/13/1989,26,0,18,19,63
6/14/1989,29,0,20,17,66
6/15/1989,24,0,16,11,51
6/16/1989,23,0,12,19,54
6/17/1989,23,0,20,26,69
6/18/1989,25,0,20,11,56
6/19/1989,21,0,20,15,56
6/20/1989,14,0,25,18,57
6/21/1989,23,0,17,30,70
6/22/1989,18,0,21,21,60
6/23/1989,15,0,18,18,51
6/24/1989,33,0,25,14,72
6/25/1989,17,0,18,18,53
6/26/1989,28,0,18,19,65
6/27/1989,27,0,25,9,61
6/28/1989,26,0,17,22,65
6/29/1989,23,0,17,21,61
6/30/1989,21,0,14,28,63
7/1/1989,21,0,10,24,55
7/2/1989,28,0,17,13,58
7/3/1989,22,0,18,23,63
7/4/1989,26,0,21,19,66
7/5/1989,21,0,26,28,75
7/6/1989,19,0,23,22,64
7/7/1989,20,0,16,19,55
7/8/1989,29,0,26,24,79
7/9/1989,26,0,13,11,50
7/10/1989,29,0,24,29,82
7/11/1989,14,0,14,19,47
7/12/1989,19,0,27,15,61
7/13/1989,16,0,21,15,52
7/14/1989,27,0,14,16,57
7/15/1989,19,0,22,25,66
7/16/1989,15,0,13,17,45
7/17/1989,28,0,21,6,55
7/18/1989,22,0,30,19,71
7/19/1989,23,0,26,30,79
7/20/1989,14,0,19,9,42
7/21/1989,22,0,19,26,67
7/22/1989,31,0,16,33,80
7/23/1989,32,0,12,11,55
7/24/1989,13,0,16,25,54
7/25/1989,24,0,16,23,63
7/26/1989,20,0,24,28,72
7/27/1989,23,0,15,14,52
7/28/1989,27,0,21,10,58
7/29/1989,23,0,31,6,60
7/30/1989,14,0,23,19,56
7/31/1989,22,0,14,29,65
8/1/1989,28,0,25,12,65
8/2/1989,16,0,19,20,55
8/3/1989,23,0,19,13,55
8/4/1989,24,0,23,6,53
8/5/1989,19,0,26,24,69
8/6/1989,18,0,18,28,64
8/7/1989,16,0,16,23,55
8/8/1989,29,0,12,28,69
8/9/1989,26,0,21,27,74
8/10/1989,23,0,25,32,80
8/11/1989,26,0,18,18,62
8/12/1989,21,0,23,1,45
8/13/1989,14,0,15,26,55
8/14/1989,25,0,20,16,61
8/15/1989,18,0,14,22,54
8/16/1989,24,0,21,19,64
8/17/1989,18,0,17,17,52
8/18/1989,28,0,26,11,65
8/19/1989,31,0,21,23,75
8/20/1989,23,0,25,21,69
8/21/1989,14,0,23,26,63
8/22/1989,26,0,16,18,60
8/23/1989,24,0,20,21,65
8/24/1989,15,0,20,36,71
8/25/1989,25,0,27,24,76
8/26/1989,17,0,16,15,48
8/27/1989,28,0,26,16,70
8/28/1989,20,0,26,16,62
8/29/1989,32,0,23,6,61
8/30/1989,25,0,10,24,59
8/31/1989,21,0,17,22,60
9/1/1989,19,0,20,18,57
9/2/1989,26,0,14,28,68
9/3/1989,21,0,25,17,63
9/4/1989,22,0,23,20,65
9/5/1989,21,0,26,14,61
9/6/1989,16,0,18,7,41
9/7/1989,23,0,26,22,71
9/8/1989,23,0,30,7,60
9/9/1989,22,0,18,32,72
9/10/1989,33,0,30,17,80
9/11/1989,27,0,13,29,69
9/12/1989,18,0,19,27,64
9/13/1989,29,0,18,16,63
9/14/1989,29,0,16,30,75
9/15/1989,28,0,25,22,75
9/16/1989,17,0,16,29,62
9/17/1989,28,0,26,28,82
9/18/1989,19,0,16,12,47
9/19/1989,27,0,21,14,62
9/20/1989,27,0,18,25,70
9/21/1989,33,0,20,16,69
9/22/1989,25,0,27,20,72
9/23/1989,21,0,21,13,55
9/24/1989,25,0,26,17,68
9/25/1989,21,0,20,24,65
9/26/1989,27,0,13,19,59
9/27/1989,18,0,24,13,55
9/28/1989,17,0,33,16,66
9/29/1989,24,0,28,23,75
9/30/1989,27,0,22,19,68
10/1/1989,17,0,20,23,60
10/2/1989,20,0,28,33,81
10/3/1989,24,0,29,19,72
10/4/1989,24,0,22,32,78
10/5/1989,24,0,24,21,69
10/6/1989,26,0,15,18,59
10/7/1989,13,0,19,20,52
10/8/1989,31,0,29,7,67
10/9/1989,24,0,19,25,68
10/10/1989,32,0,27,10,69
10/11/1989,23,0,19,17,59
10/12/1989,29,0,7,26,62
10/13/1989,21,0,30,26,77
10/14/1989,26,0,21,23,70
10/15/1989,29,0,12,24,65
10/16/1989,28,0,27,23,78
10/17/1989,29,0,11,24,64
10/18/1989,22,0,30,13,65
10/19/1989,25,0,20,25,70
10/20/1989,27,0,16,31,74
10/21/1989,11,0,24,18,53
10/22/1989,17,0,26,26,69
10/23/1989,23,0,22,10,55
10/24/1989,21,0,27,22,70
10/25/1989,18,0,13,16,47
10/26/1989,18,0,28,25,71
10/27/1989,21,0,22,16,59
10/28/1989,19,0,21,25,65
10/29/1989,30,0,30,35,95
10/30/1989,32,0,28,28,88
10/31/1989,24,0,14,20,58
11/1/1989,23,0,14,34,71
11/2/1989,31,0,27,18,76
11/3/1989,24,0,22,11,57
11/4/1989,27,0,19,24,70
11/5/1989,17,0,8,25,50
11/6/1989,21,0,16,27,64
11/7/1989,30,0,15,13,58
11/8/1989,20,0,21,17,58
11/9/1989,16,0,12,11,39
11/10/1989,22,0,24,29,75
11/11/1989,22,0,16,27,65
11/12/1989,28,0,18,19,65
11/13/1989,29,0,27,16,72
11/14/1989,21,0,24,9,54
11/15/1989,25,0,19,14,58
11/16/1989,34,0,22,10,66
11/17/1989,22,0,12,13,47
11/18/1989,22,0,29,21,72
11/19/1989,24,0,20,12,56
11/20/1989,29,0,30,14,73
11/21/1989,15,0,20,28,63
11/22/1989,25,0,19,24,68
11/23/1989,25,0,26,33,84
11/24/1989,27,0,15,19,61
11/25/1989,16,0,25,14,55
11/26/1989,16,0,34,21,71
11/27/1989,25,0,13,30,68
11/28/1989,18,0,27,20,65
11/29/1989,28,0,23,24,75
11/30/1989,15,0,16,21,52
12/1/1989,28,0,32,28,88
12/2/1989,18,0,20,18,56
12/3/1989,25,0,24,12,61
12/4/1989,19,0,21,17,57
12/5/1989,22,0,28,21,71
12/6/1989,17,0,11,19,47
12/7/1989,20,0,31,22,73
12/8/1989,28,0,29,19,76
12/9/1989,23,0,12,17,52
12/10/1989,26,0,20,13,59
12/11/1989,21,0,19,18,58
12/12/1989,13,0,20,17,50
12/13/1989,24,0,19,22,65
12/14/1989,28,0,17,33,78
12/15/1989,28,0,20,23,71
12/16/1989,28,0,14,22,64
12/17/1989,24,0,26,36,86
12/18/1989,29,0,24,10,63
12/19/1989,17,0,21,20,58
12/20/1989,15,0,23,21,59
12/21/1989,27,0,18,17,62
12/22/1989,16,0,30,29,75
12/23/1989,33,0,25,19,77
12/24/1989,16,0,27,17,60
12/25/1989,25,0,19,6,50
12/26/1989,22,0,15,18,55
12/27/1989,27,0,11,15,53
12/28/1989,27,0,18,10,55
12/29/1989,23,0,22,13,58
12/30/1989,17,0,33,10,60
12/31/1989,27,0,9,10,46
1/1/1990,32,0,18,17,67
1/2/1990,22,0,20,27,69
1/3/1990,21,0,18,17,56
1/4/1990,32,0,20,10,62
1/5/1990,28,0,18,29,75
1/6/1990,30,0,24,14,68
1/7/1990,26,0,29,30,85
1/8/1990,29,0,23,28,80
1/9/1990,22,0,16,23,61
1/10/1990,27,0,21,27,75
1/11/1990,23,0,21,4,48
1/12/1990,26,0,16,24,66
1/13/1990,28,0,12,17,57
1/14/1990,26,0,23,21,70
1/15/1990,27,0,33,14,74
1/16/1990,27,0,19,18,64
1/17/1990,23,0,17,17,57
1/18/1990,14,0,27,28,69
1/19/1990,26,0,17,14,57
1/20/1990,28,0,21,11,60
1/21/1990,27,0,13,29,69
1/22/1990,32,0,17,16,65
1/23/1990,18,0,12,18,48
1/24/1990,33,0,15,15,63
1/25/1990,15,0,17,13,45
1/26/1990,18,0,14,25,57
1/27/1990,26,0,23,13,62
1/28/1990,26,0,11,30,67
1/29/1990,26,0,10,17,53
1/30/1990,30,0,22,13,65
1/31/1990,22,0,24,12,58
2/1/1990,13,0,20,23,56
2/2/1990,28,0,16,13,57
2/3/1990,29,0,22,23,74
2/4/1990,23,0,20,21,64
2/5/1990,19,0,15,28,62
2/6/1990,27,0,13,16,56
2/7/1990,24,0,12,21,57
2/8/1990,18,0,19,22,59
2/9/1990,24,0,29,29,82
2/10/1990,26,0,13,19,58
2/11/1990,23,0,22,25,70
2/12/1990,17,0,21,13,51
2/13/1990,32,0,16,13,61
2/14/1990,18,0,19,15,52
2/15/1990,27,0,18,23,68
2/16/1990,30,0,24,19,73
2/17/1990,27,0,27,27,81
2/18/1990,31,0,23,23,77
2/19/1990,13,0,28,31,72
2/20/1990,24,0,28,19,71
2/21/1990,25,0,16,5,46
2/22/1990,30,0,22,12,64
2/23/1990,34,0,23,15,72
2/24/1990,21,0,18,15,54
2/25/1990,29,0,19,22,70
2/26/1990,19,0,7,28,54
2/27/1990,21,0,23,9,53
2/28/1990,28,0,25,28,81
3/1/1990,23,0,21,24,68
3/2/1990,28,0,14,30,72
3/3/1990,23,0,18,11,52
3/4/1990,27,0,21,15,63
3/5/1990,20,0,15,13,48
3/6/1990,24,0,23,21,68
3/7/1990,18,0,19,2,39
3/8/1990,28,0,26,30,84
3/9/1990,31,0,20,17,68
3/10/1990,28,0,21,26,75
3/11/1990,24,0,26,7,57
3/12/1990,26,0,18,25,69
3/13/1990,14,0,19,27,60
3/14/1990,29,0,21,18,68
3/15/1990,31,0,24,24,79
3/16/1990,14,0,17,30,61
3/17/1990,17,0,16,24,57
3/18/1990,28,0,15,25,68
3/19/1990,24,0,18,18,60
3/20/1990,23,0,21,21,65
3/21/1990,27,0,15,21,63
3/22/1990,24,0,21,28,73
3/23/1990,30,0,17,29,76
3/24/1990,22,0,10,22,54
3/25/1990,26,0,16,9,51
3/26/1990,21,0,20,25,66
3/27/1990,25,0,20,15,60
3/28/1990,20,0,30,16,66
3/29/1990,31,0,22,12,65
3/30/1990,32,0,17,16,65
3/31/1990,25,0,14,25,64
4/1/1990,23,0,21,17,61
4/2/1990,21,0,10,17,48
4/3/1990,29,0,21,19,69
4/4/1990,25,0,12,25,62
4/5/1990,11,0,17,26,54
4/6/1990,21,0,18,13,52
4/7/1990,27,0,19,23,69
4/8/1990,23,0,23,16,62
4/9/1990,25,0,21,22,68
4/10/1990,20,0,16,23,59
4/11/1990,16,0,12,12,40
4/12/1990,28,0,17,9,54
4/13/1990,27,0,12,33,72
4/14/1990,15,0,19,18,52
4/15/1990,25,0,17,14,56
4/16/1990,28,0,22,26,76
4/17/1990,13,0,21,21,55
4/18/1990,29,0,17,13,59
4/19/1990,17,0,24,27,68
4/20/1990,26,0,20,21,67
4/21/1990,14,0,16,17,47
4/22/1990,23,0,25,19,67
4/23/1990,28,0,28,17,73
4/24/1990,28,0,17,32,77
4/25/1990,12,0,22,14,48
4/26/1990,17,0,24,26,67
4/27/1990,17,0,21,7,45
4/28/1990,25,0,23,13,61
4/29/1990,20,0,21,19,60
4/30/1990,14,0,29,23,66
5/1/1990,24,0,16,21,61
5/2/1990,18,0,19,32,69
5/3/1990,22,0,19,23,64
5/4/1990,21,0,18,15,54
5/5/1990,32,0,20,20,72
5/6/1990,25,0,11,8,44
5/7/1990,25,0,11,20,56
5/8/1990,12,0,22,37,71
5/9/1990,27,0,23,11,61
5/10/1990,25,0,19,22,66
5/11/1990,17,0,22,23,62
5/12/1990,15,0,31,27,73
5/13/1990,24,0,18,20,62
5/14/1990,26,0,18,27,71
5/15/1990,20,0,16,25,61
5/16/1990,14,0,23,30,67
5/17/1990,22,0,12,5,39
5/18/1990,25,0,25,21,71
5/19/1990,27,0,24,17,68
5/20/1990,17,0,22,24,63
5/21/1990,19,0,15,23,57
5/22/1990,23,0,21,31,75
5/23/1990,33,0,21,13,67
5/24/1990,23,0,13,3,39
5/25/1990,27,0,12,26,65
5/26/1990,20,0,20,20,60
5/27/1990,32,0,10,21,63
5/28/1990,17,0,29,8,54
5/29/1990,24,0,27,19,70
5/30/1990,17,0,28,8,53
5/31/1990,28,0,16,13,57
6/1/1990,20,0,26,6,52
6/2/1990,19,0,11,13,43
6/3/1990,25,0,21,7,53
6/4/1990,18,0,24,27,69
6/5/1990,26,0,25,12,63
6/6/1990,23,0,23,14,60
6/7/1990,25,0,19,28,72
6/8/1990,19,0,18,30,67
6/9/1990,16,0,27,29,72
6/10/1990,35,0,20,17,72
6/11/1990,29,0,19,27,75
6/12/1990,29,0,9,28,66
6/13/1990,23,0,17,35,75
6/14/1990,19,0,19,12,50
6/15/1990,27,0,14,25,66
6/16/1990,22,0,18,26,66
6/17/1990,23,0,22,17,62
6/18/1990,31,0,29,32,92
6/19/1990,28,0,26,7,61
6/20/1990,14,0,21,14,49
6/21/1990,20,0,14,21,55
6/22/1990,18,0,19,13,50
6/23/1990,16,0,31,12,59
6/24/1990,28,0,24,18,70
6/25/1990,23,0,13,18,54
6/26/1990,26,0,15,23,64
6/27/1990,27,0,18,23,68
6/28/1990,32,0,22,23,77
6/29/1990,15,0,14,21,50
6/30/1990,19,0,13,10,42
7/1/1990,25,0,28,23,76
7/2/1990,29,0,20,10,59
7/3/1990,27,0,11,9,47
7/4/1990,23,0,19,9,51
7/5/1990,21,0,24,27,72
7/6/1990,29,0,16,21,66
7/7/1990,25,0,10,28,63
7/8/1990,27,0,25,25,77
7/9/1990,33,0,20,26,79
7/10/1990,22,0,13,21,56
7/11/1990,32,0,32,21,85
7/12/1990,25,0,20,6,51
7/13/1990,17,0,14,28,59
7/14/1990,21,0,11,11,43
7/15/1990,27,0,19,24,70
7/16/1990,25,0,16,11,52
7/17/1990,23,0,17,10,50
7/18/1990,32,0,15,21,68
7/19/1990,26,0,14,17,57
7/20/1990,21,0,9,12,42
7/21/1990,19,0,28,31,78
7/22/1990,22,0,17,10,49
7/23/1990,21,0,12,10,43
7/24/1990,21,0,15,18,54
7/25/1990,25,0,19,7,51
7/26/1990,14,0,24,17,55
7/27/1990,19,0,19,14,52
7/28/1990,17,0,28,25,70
7/29/1990,22,0,17,13,52
7/30/1990,28,0,26,13,67
7/31/1990,18,0,23,32,73
8/1/1990,27,0,29,30,86
8/2/1990,17,0,26,21,64
8/3/1990,31,0,23,21,75
8/4/1990,26,0,14,11,51
8/5/1990,15,0,18,23,56
8/6/1990,21,0,12,27,60
8/7/1990,25,0,17,33,75
8/8/1990,28,0,22,22,72
8/9/1990,26,0,19,18,63
8/10/1990,23,0,22,21,66
8/11/1990,28,0,20,26,74
8/12/1990,21,0,10,27,58
8/13/1990,27,0,15,28,70
8/14/1990,27,0,16,22,65
8/15/1990,26,0,24,18,68
8/16/1990,16,0,21,22,59
8/17/1990,12,0,19,19,50
8/18/1990,19,0,17,32,68
8/19/1990,26,0,18,11,55
8/20/1990,25,0,27,21,73
8/21/1990,22,0,12,36,70
8/22/1990,15,0,12,12,39
8/23/1990,25,0,29,22,76
8/24/1990,17,0,21,9,47
8/25/1990,25,0,7,14,46
8/26/1990,22,0,15,7,44
8/27/1990,14,0,16,26,56
8/28/1990,24,0,15,32,71
8/29/1990,30,0,23,22,75
8/30/1990,29,0,27,19,75
8/31/1990,24,0,27,21,72
9/1/1990,25,0,18,25,68
9/2/1990,27,0,17,12,56
9/3/1990,25,0,24,15,64
9/4/1990,24,0,21,11,56
9/5/1990,26,0,20,15,61
9/6/1990,14,0,24,16,54
9/7/1990,23,0,24,18,65
9/8/1990,24,0,15,32,71
9/9/1990,18,0,17,16,51
9/10/1990,28,0,26,15,69
9/11/1990,20,0,13,17,50
9/12/1990,24,0,25,26,75
9/13/1990,22,0,31,18,71
9/14/1990,27,0,23,22,72
9/15/1990,27,0,16,17,60
9/16/1990,19,0,15,4,38
9/17/1990,24,0,22,24,70
9/18/1990,28,0,26,20,74
9/19/1990,26,0,17,17,60
9/20/1990,30,0,15,12,57
9/21/1990,34,0,21,24,79
9/22/1990,12,0,27,16,55
9/23/1990,28,0,17,30,75
9/24/1990,27,0,24,14,65
9/25/1990,23,0,15,18,56
9/26/1990,27,0,21,20,68
9/27/1990,13,0,12,28,53
9/28/1990,24,0,21,22,67
9/29/1990,16,0,30,27,73
9/30/1990,17,0,22,19,58
10/1/1990,23,0,20,10,53
10/2/1990,18,0,19,16,53
10/3/1990,24,0,18,9,51
10/4/1990,18,0,24,23,65
10/5/1990,28,0,15,29,72
10/6/1990,24,0,23,20,67
10/7/1990,20,0,25,13,58
10/8/1990,31,0,18,28,77
10/9/1990,27,0,22,21,70
10/10/1990,21,0,15,31,67
10/11/1990,27,0,24,6,57
10/12/1990,22,0,21,14,57
10/13/1990,17,0,16,32,65
10/14/1990,17,0,18,16,51
10/15/1990,22,0,26,19,67
10/16/1990,29,0,13,19,61
10/17/1990,11,0,12,20,43
10/18/1990,26,0,26,25,77
10/19/1990,18,0,22,9,49
10/20/1990,29,0,24,20,73
10/21/1990,20,0,17,17,54
10/22/1990,21,0,21,19,61
10/23/1990,24,0,28,20,72
10/24/1990,27,0,22,22,71
10/25/1990,21,0,16,24,61
10/26/1990,19,0,13,20,52
10/27/1990,22,0,24,24,70
10/28/1990,16,0,23,22,61
10/29/1990,27,0,18,22,67
10/30/1990,20,0,22,26,68
10/31/1990,21,0,13,13,47
11/1/1990,20,0,16,24,60
11/2/1990,24,0,29,14,67
11/3/1990,17,0,20,23,60
11/4/1990,23,0,10,22,55
11/5/1990,25,0,20,18,63
11/6/1990,30,0,22,24,76
11/7/1990,18,0,22,5,45
11/8/1990,26,0,18,23,67
11/9/1990,27,0,18,37,82
11/10/1990,25,0,21,30,76
11/11/1990,29,0,17,11,57
11/12/1990,34,0,10,24,68
11/13/1990,19,0,15,33,67
11/14/1990,20,0,23,19,62
11/15/1990,30,0,26,19,75
11/16/1990,29,0,18,18,65
11/17/1990,26,0,23,17,66
11/18/1990,23,0,30,9,62
11/19/1990,27,0,19,26,72
11/20/1990,31,0,31,28,90
11/21/1990,19,0,26,7,52
11/22/1990,21,0,17,28,66
11/23/1990,20,0,15,27,62
11/24/1990,24,0,19,11,54
11/25/1990,19,0,16,18,53
11/26/1990,25,0,21,19,65
11/27/1990,18,0,20,13,51
11/28/1990,24,0,28,21,73
11/29/1990,24,0,22,19,65
11/30/1990,23,0,22,14,59
12/1/1990,22,0,19,26,67
12/2/1990,22,0,21,32,75
12/3/1990,25,0,20,6,51
12/4/1990,25,0,19,33,77
12/5/1990,25,0,15,12,52
12/6/1990,18,0,18,8,44
12/7/1990,22,0,17,10,49
12/8/1990,18,0,19,16,53
12/9/1990,20,0,22,14,56
12/10/1990,32,0,14,8,54
12/11/1990,31,0,22,26,79
12/12/1990,18,0,15,22,55
12/13/1990,22,0,26,23,71
12/14/1990,31,0,18,12,61
12/15/1990,24,0,22,33,79
12/16/1990,31,0,24,25,80
12/17/1990,24,0,26,22,72
12/18/1990,29,0,15,15,59
12/19/1990,17,0,25,25,67
12/20/1990,18,0,15,27,60
12/21/1990,30,0,28,19,77
12/22/1990,29,0,16,30,75
12/23/1990,28,0,24,23,75
12/24/1990,23,0,20,26,69
12/25/1990,26,0,12,22,60
12/26/1990,27,0,24,14,65
12/27/1990,24,0,30,21,75
12/28/1990,21,0,23,32,76
12/29/1990,30,0,22,19,71
12/30/1990,28,0,25,11,64
12/31/1990,16,0,11,16,43
1/1/1991,15,0,22,15,52
1/2/1991,18,0,24,24,66
1/3/1991,24,0,29,19,72
1/4/1991,27,0,27,14,68
1/5/1991,29,0,25,22,76
1/6/1991,15,0,10,8,33
1/7/1991,21,0,27,23,71
1/8/1991,23,0,24,12,59
1/9/1991,26,0,24,6,56
1/10/1991,23,0,14,10,47
1/11/1991,25,0,14,17,56
1/12/1991,25,0,26,16,67
1/13/1991,31,0,23,30,84
1/14/1991,14,0,16,23,53
1/15/1991,25,0,23,16,64
1/16/1991,23,0,25,14,62
1/17/1991,14,0,17,23,54
1/18/1991,21,0,20,18,59
1/19/1991,17,0,18,19,54
1/20/1991,23,0,17,9,49
1/21/1991,29,0,14,29,72
1/22/1991,20,0,15,14,49
1/23/1991,26,0,16,21,63
1/24/1991,17,0,13,11,41
1/25/1991,32,0,19,18,69
1/26/1991,25,0,27,18,70
1/27/1991,14,0,16,22,52
1/28/1991,23,0,15,18,56
1/29/1991,24,0,18,15,57
1/30/1991,21,0,30,29,80
1/31/1991,26,0,25,23,74
2/1/1991,24,0,13,18,55
2/2/1991,29,0,21,32,82
2/3/1991,25,0,29,11,65
2/4/1991,28,0,22,30,80
2/5/1991,16,0,28,20,64
2/6/1991,24,0,15,30,69
2/7/1991,22,0,22,23,67
2/8/1991,20,0,24,9,53
2/9/1991,18,0,24,5,47
2/10/1991,23,0,17,20,60
2/11/1991,11,0,30,18,59
2/12/1991,19,0,16,32,67
2/13/1991,23,0,13,21,57
2/14/1991,21,0,23,15,59
2/15/1991,20,0,25,21,66
2/16/1991,22,0,21,17,60
2/17/1991,28,0,28,28,84
2/18/1991,22,0,24,18,64
2/19/1991,23,0,20,13,56
2/20/1991,16,0,22,26,64
2/21/1991,33,0,25,11,69
2/22/1991,23,0,14,19,56
2/23/1991,29,0,27,33,89
2/24/1991,26,0,21,24,71
2/25/1991,15,0,17,29,61
2/26/1991,23,0,24,13,60
2/27/1991,20,0,22,27,69
2/28/1991,23,0,24,28,75
3/1/1991,16,0,25,27,68
3/2/1991,27,0,24,30,81
3/3/1991,20,0,24,5,49
3/4/1991,24,0,19,19,62
3/5/1991,32,0,15,26,73
3/6/1991,22,0,16,6,44
3/7/1991,13,0,18,15,46
3/8/1991,27,0,27,16,70
3/9/1991,17,0,22,23,62
3/10/1991,23,0,17,22,62
3/11/1991,22,0,23,9,54
3/12/1991,25,0,14,29,68
3/13/1991,26,0,23,23,72
3/14/1991,26,0,23,29,78
3/15/1991,18,0,22,17,57
3/16/1991,17,0,21,14,52
3/17/1991,24,0,18,22,64
3/18/1991,31,0,23,28,82
3/19/1991,22,0,19,13,54
3/20/1991,33,0,19,29,81
3/21/1991,24,0,13,24,61
3/22/1991,27,0,8,25,60
3/23/1991,23,0,26,33,82
3/24/1991,19,0,27,19,65
3/25/1991,21,0,19,21,61
3/26/1991,24,0,21,8,53
3/27/1991,28,0,27,12,67
3/28/1991,26,0,25,17,68
3/29/1991,20,0,19,12,51
3/30/1991,26,0,26,16,68
3/31/1991,22,0,30,29,81
4/1/1991,30,0,17,25,72
4/2/1991,23,0,22,33,78
4/3/1991,20,0,25,18,63
4/4/1991,27,0,19,24,70
4/5/1991,29,0,18,13,60
4/6/1991,33,0,11,27,71
4/7/1991,24,0,18,30,72
4/8/1991,33,0,9,21,63
4/9/1991,22,0,23,20,65
4/10/1991,23,0,18,17,58
4/11/1991,27,0,22,19,68
4/12/1991,32,0,21,9,62
4/13/1991,27,0,15,21,63
4/14/1991,23,0,27,20,70
4/15/1991,10,0,17,32,59
4/16/1991,33,0,27,25,85
4/17/1991,23,0,32,14,69
4/18/1991,24,0,16,19,59
4/19/1991,24,0,15,34,73
4/20/1991,34,0,23,17,74
4/21/1991,20,0,16,29,65
4/22/1991,26,0,22,24,72
4/23/1991,20,0,18,27,65
4/24/1991,26,0,24,25,75
4/25/1991,26,0,21,18,65
4/26/1991,24,0,20,23,67
4/27/1991,33,0,17,28,78
4/28/1991,30,0,12,9,51
4/29/1991,19,0,13,28,60
4/30/1991,26,0,21,24,71
5/1/1991,21,0,14,28,63
5/2/1991,19,0,23,24,66
5/3/1991,22,0,20,16,58
5/4/1991,26,0,12,10,48
5/5/1991,24,0,22,31,77
5/6/1991,19,0,21,16,56
5/7/1991,30,0,15,13,58
5/8/1991,27,0,28,21,76
5/9/1991,27,0,25,16,68
5/10/1991,24,0,16,31,71
5/11/1991,26,0,19,28,73
5/12/1991,29,0,14,23,66
5/13/1991,28,0,21,12,61
5/14/1991,30,0,21,3,54
5/15/1991,31,0,21,22,74
5/16/1991,25,0,27,17,69
5/17/1991,24,0,22,13,59
5/18/1991,26,0,31,23,80
5/19/1991,24,0,16,17,57
5/20/1991,19,0,16,19,54
5/21/1991,20,0,26,6,52
5/22/1991,29,0,27,32,88
5/23/1991,31,0,31,23,85
5/24/1991,24,0,26,13,63
5/25/1991,26,0,23,7,56
5/26/1991,25,0,18,24,67
5/27/1991,16,0,28,2,46
5/28/1991,25,0,22,14,61
5/29/1991,34,0,24,22,80
5/30/1991,23,0,17,12,52
5/31/1991,22,0,16,17,55
6/1/1991,27,0,27,16,70
6/2/1991,18,0,25,18,61
6/3/1991,19,0,19,21,59
6/4/1991,25,0,25,28,78
6/5/1991,18,0,20,12,50
6/6/1991,14,0,23,16,53
6/7/1991,20,0,22,21,63
6/8/1991,18,0,25,16,59
6/9/1991,23,0,13,25,61
6/10/1991,34,0,29,13,76
6/11/1991,22,0,26,16,64
6/12/1991,30,0,16,23,69
6/13/1991,28,0,14,6,48
6/14/1991,14,0,13,13,40
6/15/1991,29,0,17,22,68
6/16/1991,22,0,27,15,64
6/17/1991,23,0,19,11,53
6/18/1991,23,0,13,30,66
6/19/1991,25,0,28,32,85
6/20/1991,15,0,22,12,49
6/21/1991,33,0,26,21,80
6/22/1991,27,0,27,25,79
6/23/1991,28,0,17,22,67
6/24/1991,16,0,16,22,54
6/25/1991,21,0,17,24,62
6/26/1991,19,0,26,15,60
6/27/1991,26,0,14,16,56
6/28/1991,23,0,17,10,50
6/29/1991,26,0,17,15,58
6/30/1991,24,0,15,25,64
7/1/1991,18,0,30,26,74
7/2/1991,18,0,19,13,50
7/3/1991,27,0,22,16,65
7/4/1991,28,0,23,16,67
7/5/1991,34,0,28,34,96
7/6/1991,23,0,30,23,76
7/7/1991,20,0,22,21,63
7/8/1991,21,0,19,35,75
7/9/1991,22,0,20,34,76
7/10/1991,28,0,29,26,83
7/11/1991,16,0,23,12,51
7/12/1991,11,0,29,23,63
7/13/1991,22,0,13,34,69
7/14/1991,23,0,20,22,65
7/15/1991,28,0,20,18,66
7/16/1991,24,0,17,14,55
7/17/1991,30,0,16,17,63
7/18/1991,19,0,16,16,51
7/19/1991,28,0,29,6,63
7/20/1991,31,0,27,24,82
7/21/1991,23,0,21,16,60
7/22/1991,19,0,30,30,79
7/23/1991,21,0,19,23,63
7/24/1991,30,0,21,24,75
7/25/1991,22,0,20,32,74
7/26/1991,26,0,17,18,61
7/27/1991,18,0,19,22,59
7/28/1991,27,0,17,14,58
7/29/1991,20,0,17,23,60
7/30/1991,27,0,21,31,79
7/31/1991,20,0,29,28,77
8/1/1991,18,0,11,12,41
8/2/1991,29,0,18,16,63
8/3/1991,22,0,15,27,64
8/4/1991,12,0,23,23,58
8/5/1991,22,0,19,21,62
8/6/1991,20,0,21,26,67
8/7/1991,22,0,14,9,45
8/8/1991,24,0,16,20,60
8/9/1991,21,0,25,12,58
8/10/1991,23,0,23,18,64
8/11/1991,23,0,21,2,46
8/12/1991,17,0,24,21,62
8/13/1991,28,0,20,19,67
8/14/1991,18,0,16,23,57
8/15/1991,21,0,19,13,53
8/16/1991,27,0,15,30,72
8/17/1991,22,0,17,19,58
8/18/1991,21,0,12,30,63
8/19/1991,16,0,25,25,66
8/20/1991,24,0,18,20,62
8/21/1991,19,0,16,30,65
8/22/1991,23,0,14,10,47
8/23/1991,27,0,24,7,58
8/24/1991,11,0,23,35,69
8/25/1991,27,0,18,19,64
8/26/1991,22,0,20,15,57
8/27/1991,21,0,14,21,56
8/28/1991,23,0,27,21,71
8/29/1991,27,0,8,18,53
8/30/1991,19,0,15,30,64
8/31/1991,22,0,17,22,61
9/1/1991,20,0,17,25,62
9/2/1991,27,0,25,11,63
9/3/1991,26,0,27,26,79
9/4/1991,21,0,11,22,54
9/5/1991,23,0,14,23,60
9/6/1991,21,0,22,21,64
9/7/1991,13,0,27,21,61
9/8/1991,23,0,18,29,70
9/9/1991,25,0,14,15,54
9/10/1991,15,0,23,36,74
9/11/1991,19,0,22,13,54
9/12/1991,22,0,20,17,59
9/13/1991,29,0,15,16,60
9/14/1991,23,0,11,32,66
9/15/1991,14,0,26,13,53
9/16/1991,17,0,24,15,56
9/17/1991,24,0,28,15,67
9/18/1991,16,0,13,35,64
9/19/1991,20,0,20,12,52
9/20/1991,30,0,24,14,68
9/21/1991,16,0,22,25,63
9/22/1991,34,0,15,27,76
9/23/1991,31,0,19,26,76
9/24/1991,24,0,14,15,53
9/25/1991,29,0,21,21,71
9/26/1991,29,0,21,30,80
9/27/1991,18,0,18,23,59
9/28/1991,23,0,10,22,55
9/29/1991,18,0,15,17,50
9/30/1991,28,0,19,17,64
10/1/1991,18,0,22,29,69
10/2/1991,29,0,22,38,89
10/3/1991,25,0,16,23,64
10/4/1991,16,0,17,24,57
10/5/1991,19,0,18,32,69
10/6/1991,30,0,18,25,73
10/7/1991,27,0,21,16,64
10/8/1991,19,0,8,9,36
10/9/1991,21,0,23,28,72
10/10/1991,19,0,19,16,54
10/11/1991,20,0,14,18,52
10/12/1991,26,0,22,25,73
10/13/1991,29,0,26,14,69
10/14/1991,27,0,27,20,74
10/15/1991,25,0,17,23,65
10/16/1991,31,0,24,15,70
10/17/1991,27,0,17,13,57
10/18/1991,25,0,19,25,69
10/19/1991,23,0,16,11,50
10/20/1991,21,0,22,26,69
10/21/1991,19,0,20,12,51
10/22/1991,22,0,21,24,67
10/23/1991,19,0,15,21,55
10/24/1991,26,0,26,12,64
10/25/1991,16,0,25,30,71
10/26/1991,31,0,15,39,85
10/27/1991,25,0,22,19,66
10/28/1991,21,0,26,19,66
10/29/1991,20,0,29,18,67
10/30/1991,25,0,13,12,50
10/31/1991,26,0,17,10,53
11/1/1991,32,0,25,12,69
11/2/1991,17,0,15,23,55
11/3/1991,18,0,13,9,40
11/4/1991,22,0,11,25,58
11/5/1991,15,0,24,16,55
11/6/1991,26,0,18,32,76
11/7/1991,27,0,21,29,77
11/8/1991,27,0,30,15,72
11/9/1991,21,0,20,29,70
11/10/1991,30,0,13,29,72
11/11/1991,22,0,21,19,62
11/12/1991,24,0,12,18,54
11/13/1991,11,0,21,17,49
11/14/1991,16,0,17,4,37
11/15/1991,17,0,20,9,46
11/16/1991,20,0,26,21,67
11/17/1991,24,0,13,28,65
11/18/1991,28,0,20,27,75
11/19/1991,25,0,19,23,67
11/20/1991,32,0,19,25,76
11/21/1991,23,0,19,6,48
11/22/1991,22,0,26,11,59
11/23/1991,22,0,18,10,50
11/24/1991,34,0,17,9,60
11/25/1991,20,0,16,27,63
11/26/1991,18,0,14,32,64
11/27/1991,17,0,26,33,76
11/28/1991,27,0,17,31,75
11/29/1991,30,0,23,14,67
11/30/1991,21,0,14,10,45
12/1/1991,17,0,18,21,56
12/2/1991,20,0,15,22,57
12/3/1991,27,0,18,13,58
12/4/1991,26,0,15,17,58
12/5/1991,21,0,26,15,62
12/6/1991,15,0,18,22,55
12/7/1991,26,0,23,20,69
12/8/1991,23,0,20,14,57
12/9/1991,23,0,23,31,77
12/10/1991,20,0,13,23,56
12/11/1991,17,0,15,9,41
12/12/1991,31,0,20,8,59
12/13/1991,21,0,26,27,74
12/14/1991,18,0,14,24,56
12/15/1991,19,0,22,19,60
12/16/1991,22,0,26,13,61
12/17/1991,21,0,9,19,49
12/18/1991,25,0,19,12,56
12/19/1991,20,0,15,25,60
12/20/1991,23,0,12,13,48
12/21/1991,25,0,17,26,68
12/22/1991,27,0,21,20,68
12/23/1991,28,0,14,16,58
12/24/1991,20,0,13,24,57
12/25/1991,25,0,28,27,80
12/26/1991,19,0,21,20,60
12/27/1991,33,0,15,28,76
12/28/1991,24,0,15,28,67
12/29/1991,21,0,18,14,53
12/30/1991,31,0,29,29,89
12/31/1991,24,0,27,22,73
1/1/1992,21,0,22,25,68
1/2/1992,16,0,15,26,57
1/3/1992,16,0,11,16,43
1/4/1992,23,0,22,19,64
1/5/1992,24,0,10,30,64
1/6/1992,17,0,20,8,45
1/7/1992,24,0,22,19,65
1/8/1992,28,0,33,25,86
1/9/1992,13,0,14,19,46
1/10/1992,19,0,23,17,59
1/11/1992,20,0,15,6,41
1/12/1992,19,0,23,13,55
1/13/1992,19,0,13,22,54
1/14/1992,17,0,18,20,55
1/15/1992,27,0,18,27,72
1/16/1992,10,0,10,17,37
1/17/1992,18,0,15,13,46
1/18/1992,29,0,13,24,66
1/19/1992,28,0,26,22,76
1/20/1992,22,0,22,30,74
1/21/1992,33,0,14,18,65
1/22/1992,22,0,13,3,38
1/23/1992,30,0,22,17,69
1/24/1992,24,0,22,21,67
1/25/1992,27,0,15,17,59
1/26/1992,32,0,26,34,92
1/27/1992,35,0,29,18,82
1/28/1992,28,0,25,22,75
1/29/1992,17,0,15,5,37
1/30/1992,25,0,26,16,67
1/31/1992,12,0,26,35,73
2/1/1992,28,0,16,12,56
2/2/1992,27,0,20,21,68
2/3/1992,24,0,19,15,58
2/4/1992,23,0,27,16,66
2/5/1992,20,0,20,25,65
2/6/1992,20,0,12,28,60
2/7/1992,17,0,17,14,48
2/8/1992,16,0,20,31,67
2/9/1992,23,0,22,24,69
2/10/1992,21,0,16,20,57
2/11/1992,25,0,20,24,69
2/12/1992,25,0,30,24,79
2/13/1992,30,0,15,24,69
2/14/1992,24,0,15,28,67
2/15/1992,23,0,12,20,55
2/16/1992,24,0,19,25,68
2/17/1992,23,0,16,13,52
2/18/1992,29,0,23,18,70
2/19/1992,17,0,27,21,65
2/20/1992,20,0,14,29,63
2/21/1992,26,0,20,37,83
2/22/1992,14,0,26,22,62
2/23/1992,28,0,12,8,48
2/24/1992,22,0,23,20,65
2/25/1992,19,0,18,17,54
2/26/1992,30,0,8,16,54
2/27/1992,30,0,14,29,73
2/28/1992,25,0,9,24,58
2/29/1992,29,0,21,27,77
3/1/1992,17,0,25,18,60
3/2/1992,20,0,14,11,45
3/3/1992,12,0,19,27,58
3/4/1992,30,0,22,21,73
3/5/1992,23,0,26,19,68
3/6/1992,23,0,16,24,63
3/7/1992,33,0,13,24,70
3/8/1992,27,0,16,3,46
3/9/1992,26,0,16,22,64
3/10/1992,28,0,13,18,59
3/11/1992,20,0,10,23,53
3/12/1992,22,0,17,24,63
3/13/1992,17,0,16,34,67
3/14/1992,20,0,20,18,58
3/15/1992,19,0,11,21,51
3/16/1992,23,0,12,23,58
3/17/1992,24,0,23,16,63
3/18/1992,16,0,18,18,52
3/19/1992,23,0,14,15,52
3/20/1992,16,0,20,19,55
3/21/1992,21,0,23,18,62
3/22/1992,27,0,17,29,73
3/23/1992,25,0,17,23,65
3/24/1992,19,0,22,25,66
3/25/1992,18,0,14,4,36
3/26/1992,21,0,28,7,56
3/27/1992,28,0,17,37,82
3/28/1992,32,0,17,8,57
3/29/1992,20,0,28,31,79
3/30/1992,34,0,18,33,85
3/31/1992,23,0,20,9,52
4/1/1992,28,0,28,22,78
4/2/1992,20,0,13,17,50
4/3/1992,25,0,18,21,64
4/4/1992,28,0,18,21,67
4/5/1992,25,0,17,18,60
4/6/1992,25,0,15,14,54
4/7/1992,20,0,13,12,45
4/8/1992,34,0,14,12,60
4/9/1992,23,0,25,14,62
4/10/1992,17,0,16,18,51
4/11/1992,18,0,18,20,56
4/12/1992,30,0,25,29,84
4/13/1992,25,0,19,34,78
4/14/1992,28,0,18,17,63
4/15/1992,23,0,12,15,50
4/16/1992,21,0,25,10,56
4/17/1992,15,0,15,14,44
4/18/1992,31,0,25,33,89
4/19/1992,21,0,10,17,48
4/20/1992,28,0,19,11,58
4/21/1992,24,0,19,20,63
4/22/1992,25,0,17,28,70
4/23/1992,17,0,20,21,58
4/24/1992,31,0,17,18,66
4/25/1992,30,0,11,25,66
4/26/1992,21,0,17,23,61
4/27/1992,25,0,14,19,58
4/28/1992,27,0,17,17,61
4/29/1992,24,0,15,24,63
4/30/1992,23,0,12,23,58
5/1/1992,21,0,21,22,64
5/2/1992,18,0,15,26,59
5/3/1992,22,0,17,22,61
5/4/1992,25,0,15,23,63
5/5/1992,15,0,14,23,52
5/6/1992,27,0,24,19,70
5/7/1992,22,0,28,17,67
5/8/1992,14,0,18,9,41
5/9/1992,25,0,27,15,67
5/10/1992,20,0,20,29,69
5/11/1992,29,0,20,25,74
5/12/1992,21,0,18,17,56
5/13/1992,32,0,14,30,76
5/14/1992,18,0,7,18,43
5/15/1992,21,0,20,27,68
5/16/1992,34,0,26,15,75
5/17/1992,27,0,29,31,87
5/18/1992,17,0,27,15,59
5/19/1992,26,0,13,7,46
5/20/1992,23,0,16,13,52
5/21/1992,26,0,25,22,73
5/22/1992,32,0,27,8,67
5/23/1992,22,0,16,34,72
5/24/1992,27,0,14,7,48
5/25/1992,20,0,34,30,84
5/26/1992,33,0,24,17,74
5/27/1992,22,0,15,17,54
5/28/1992,25,0,18,19,62
5/29/1992,25,0,12,29,66
5/30/1992,24,0,29,25,78
5/31/1992,28,0,25,15,68
6/1/1992,22,0,19,26,67
6/2/1992,24,0,22,24,70
6/3/1992,19,0,28,24,71
6/4/1992,22,0,17,22,61
6/5/1992,24,0,13,11,48
6/6/1992,26,0,17,18,61
6/7/1992,29,0,14,20,63
6/8/1992,24,0,28,31,83
6/9/1992,24,0,21,35,80
6/10/1992,26,0,12,8,46
6/11/1992,19,0,24,19,62
6/12/1992,27,0,26,19,72
6/13/1992,24,0,12,18,54
6/14/1992,23,0,22,13,58
6/15/1992,16,0,23,22,61
6/16/1992,27,0,30,22,79
6/17/1992,29,0,24,23,76
6/18/1992,22,0,23,16,61
6/19/1992,22,0,22,21,65
6/20/1992,18,0,25,14,57
6/21/1992,13,0,12,21,46
6/22/1992,24,0,14,15,53
6/23/1992,26,0,29,20,75
6/24/1992,27,0,22,18,67
6/25/1992,19,0,18,27,64
6/26/1992,24,0,20,30,74
6/27/1992,23,0,22,20,65
6/28/1992,33,0,17,35,85
6/29/1992,26,0,30,27,83
6/30/1992,32,0,18,19,69
7/1/1992,26,0,23,22,71
7/2/1992,21,0,18,15,54
7/3/1992,28,0,13,27,68
7/4/1992,23,0,25,25,73
7/5/1992,23,0,15,14,52
7/6/1992,26,0,21,16,63
7/7/1992,25,0,15,10,50
7/8/1992,31,0,22,22,75
7/9/1992,12,0,21,20,53
7/10/1992,26,0,17,21,64
7/11/1992,32,0,16,8,56
7/12/1992,27,0,27,25,79
7/13/1992,13,0,7,22,42
7/14/1992,16,0,14,21,51
7/15/1992,23,0,11,30,64
7/16/1992,25,0,22,7,54
7/17/1992,25,0,19,19,63
7/18/1992,24,0,20,10,54
7/19/1992,21,0,15,21,57
7/20/1992,24,0,8,16,48
7/21/1992,14,0,22,6,42
7/22/1992,29,0,19,17,65
7/23/1992,13,0,28,20,61
7/24/1992,17,0,18,8,43
7/25/1992,27,0,25,20,72
7/26/1992,23,0,24,15,62
7/27/1992,20,0,21,30,71
7/28/1992,22,0,26,5,53
7/29/1992,28,0,22,19,69
7/30/1992,31,0,25,26,82
7/31/1992,16,0,30,18,64
8/1/1992,22,0,17,10,49
8/2/1992,24,0,29,3,56
8/3/1992,10,0,25,15,50
8/4/1992,16,0,22,18,56
8/5/1992,25,0,23,26,74
8/6/1992,28,0,22,23,73
8/7/1992,18,0,8,20,46
8/8/1992,24,0,16,36,76
8/9/1992,24,0,24,15,63
8/10/1992,29,0,30,15,74
8/11/1992,16,0,20,20,56
8/12/1992,17,0,9,15,41
8/13/1992,23,0,9,15,47
8/14/1992,28,0,25,17,70
8/15/1992,23,0,11,25,59
8/16/1992,26,0,20,14,60
8/17/1992,19,0,18,30,67
8/18/1992,27,0,20,21,68
8/19/1992,18,0,24,24,66
8/20/1992,20,0,24,35,79
8/21/1992,29,0,21,24,74
8/22/1992,25,0,29,22,76
8/23/1992,22,0,7,19,48
8/24/1992,24,0,25,25,74
8/25/1992,19,0,22,19,60
8/26/1992,19,0,14,15,48
8/27/1992,19,0,22,18,59
8/28/1992,23,0,22,25,70
8/29/1992,16,0,23,26,65
8/30/1992,14,0,16,17,47
8/31/1992,27,0,10,24,61
9/1/1992,22,0,31,33,86
9/2/1992,16,0,19,29,64
9/3/1992,23,0,15,15,53
9/4/1992,23,0,19,32,74
9/5/1992,23,0,19,18,60
9/6/1992,20,0,25,27,72
9/7/1992,30,0,14,27,71
9/8/1992,28,0,14,29,71
9/9/1992,23,0,31,12,66
9/10/1992,22,0,19,14,55
9/11/1992,18,0,13,7,38
9/12/1992,15,0,30,25,70
9/13/1992,19,0,7,21,47
9/14/1992,15,0,22,25,62
9/15/1992,15,0,20,11,46
9/16/1992,14,0,16,29,59
9/17/1992,25,0,20,21,66
9/18/1992,25,0,17,6,48
9/19/1992,21,0,26,15,62
9/20/1992,15,0,22,15,52
9/21/1992,29,0,19,21,69
9/22/1992,22,0,28,24,74
9/23/1992,20,0,18,13,51
9/24/1992,28,0,23,19,70
9/25/1992,14,0,27,35,76
9/26/1992,26,0,15,14,55
9/27/1992,27,0,19,16,62
9/28/1992,22,0,14,14,50
9/29/1992,22,0,18,21,61
9/30/1992,25,0,20,3,48
10/1/1992,30,0,14,31,75
10/2/1992,24,0,15,23,62
10/3/1992,26,0,25,26,77
10/4/1992,25,0,18,9,52
10/5/1992,25,0,25,18,68
10/6/1992,33,0,26,19,78
10/7/1992,22,0,28,29,79
10/8/1992,26,0,31,29,86
10/9/1992,18,0,23,31,72
10/10/1992,20,0,17,26,63
10/11/1992,26,0,18,27,71
10/12/1992,26,0,22,14,62
10/13/1992,22,0,19,23,64
10/14/1992,19,0,22,12,53
10/15/1992,21,0,15,28,64
10/16/1992,17,0,20,19,56
10/17/1992,31,0,15,25,71
10/18/1992,22,0,29,29,80
10/19/1992,25,0,24,14,63
10/20/1992,30,0,26,17,73
10/21/1992,22,0,34,26,82
10/22/1992,26,0,15,30,71
10/23/1992,21,0,14,16,51
10/24/1992,20,0,21,6,47
10/25/1992,27,0,24,18,69
10/26/1992,27,0,20,21,68
10/27/1992,17,0,21,31,69
10/28/1992,24,0,16,30,70
10/29/1992,25,0,19,24,68
10/30/1992,24,0,33,21,78
10/31/1992,20,0,19,17,56
11/1/1992,11,0,30,15,56
11/2/1992,22,0,28,31,81
11/3/1992,27,0,28,9,64
11/4/1992,17,0,16,7,40
11/5/1992,24,0,28,17,69
11/6/1992,16,0,15,13,44
11/7/1992,28,0,19,21,68
11/8/1992,19,0,14,19,52
11/9/1992,20,0,13,18,51
11/10/1992,27,0,15,14,56
11/11/1992,14,0,22,28,64
11/12/1992,23,0,15,17,55
11/13/1992,18,0,21,15,54
11/14/1992,29,0,23,29,81
11/15/1992,20,0,17,15,52
11/16/1992,23,0,19,21,63
11/17/1992,22,0,21,29,72
11/18/1992,21,0,30,13,64
11/19/1992,17,0,14,26,57
11/20/1992,21,0,24,15,60
11/21/1992,20,0,10,22,52
11/22/1992,22,0,10,9,41
11/23/1992,19,0,13,28,60
11/24/1992,27,0,10,26,63
11/25/1992,25,0,28,19,72
11/26/1992,21,0,27,12,60
11/27/1992,24,0,29,27,80
11/28/1992,23,0,23,26,72
11/29/1992,25,0,25,17,67
11/30/1992,17,0,18,17,52
12/1/1992,17,0,21,22,60
12/2/1992,23,0,22,27,72
12/3/1992,23,0,16,22,61
12/4/1992,19,0,19,6,44
12/5/1992,21,0,18,30,69
12/6/1992,23,0,27,29,79
12/7/1992,24,0,16,11,51
12/8/1992,27,0,14,30,71
12/9/1992,16,0,22,27,65
12/10/1992,31,0,21,15,67
12/11/1992,24,0,18,29,71
12/12/1992,20,0,23,31,74
12/13/1992,12,0,19,13,44
12/14/1992,29,0,10,30,69
12/15/1992,28,0,15,25,68
12/16/1992,24,0,19,33,76
12/17/1992,20,0,18,26,64
12/18/1992,34,0,19,21,74
12/19/1992,20,0,12,15,47
12/20/1992,20,0,19,18,57
12/21/1992,25,0,16,23,64
12/22/1992,23,0,18,12,53
12/23/1992,19,0,14,30,63
12/24/1992,20,0,18,16,54
12/25/1992,26,0,23,29,78
12/26/1992,19,0,17,16,52
12/27/1992,27,0,22,28,77
12/28/1992,21,0,17,15,53
12/29/1992,17,0,17,28,62
12/30/1992,25,0,19,25,69
12/31/1992,24,0,19,23,66
1/1/1993,26,0,13,18,57
1/2/1993,26,0,21,16,63
1/3/1993,25,0,24,19,68
1/4/1993,25,0,18,21,64
1/5/1993,18,0,16,21,55
1/6/1993,20,0,27,8,55
1/7/1993,27,0,33,22,82
1/8/1993,27,0,17,27,71
1/9/1993,23,0,28,18,69
1/10/1993,24,0,31,20,75
1/11/1993,32,0,11,28,71
1/12/1993,10,0,9,14,33
1/13/1993,17,0,33,15,65
1/14/1993,33,0,10,17,60
1/15/1993,19,0,21,23,63
1/16/1993,27,0,14,28,69
1/17/1993,21,0,19,33,73
1/18/1993,16,0,14,27,57
1/19/1993,17,0,22,27,66
1/20/1993,29,0,11,35,75
1/21/1993,23,0,12,14,49
1/22/1993,31,0,19,19,69
1/23/1993,27,0,14,29,70
1/24/1993,30,0,23,18,71
1/25/1993,29,0,21,16,66
1/26/1993,27,0,15,25,67
1/27/1993,21,0,23,21,65
1/28/1993,20,0,24,20,64
1/29/1993,14,0,24,17,55
1/30/1993,28,0,16,22,66
1/31/1993,28,0,27,31,86
2/1/1993,16,0,26,24,66
2/2/1993,28,0,20,17,65
2/3/1993,28,0,20,31,79
2/4/1993,30,0,25,29,84
2/5/1993,29,0,18,30,77
2/6/1993,25,0,27,20,72
2/7/1993,30,0,10,11,51
2/8/1993,26,0,19,18,63
2/9/1993,26,0,23,18,67
2/10/1993,22,0,15,11,48
2/11/1993,30,0,18,19,67
2/12/1993,15,0,21,29,65
2/13/1993,23,0,27,21,71
2/14/1993,23,0,19,26,68
2/15/1993,17,0,27,16,60
2/16/1993,25,0,23,25,73
2/17/1993,26,0,13,20,59
2/18/1993,27,0,16,20,63
2/19/1993,28,0,33,12,73
2/20/1993,29,0,17,13,59
2/21/1993,30,0,17,27,74
2/22/1993,15,0,25,22,62
2/23/1993,16,0,25,17,58
2/24/1993,20,0,28,10,58
2/25/1993,26,0,22,23,71
2/26/1993,21,0,20,10,51
2/27/1993,23,0,16,25,64
2/28/1993,18,0,18,32,68
3/1/1993,26,0,23,6,55
3/2/1993,20,0,16,17,53
3/3/1993,26,0,18,23,67
3/4/1993,22,0,23,33,78
3/5/1993,17,0,14,18,49
3/6/1993,28,0,25,19,72
3/7/1993,24,0,26,4,54
3/8/1993,27,0,18,24,69
3/9/1993,13,0,21,26,60
3/10/1993,21,0,17,28,66
3/11/1993,32,0,16,20,68
3/12/1993,29,0,24,33,86
3/13/1993,29,0,23,18,70
3/14/1993,16,0,11,14,41
3/15/1993,21,0,25,30,76
3/16/1993,28,0,17,32,77
3/17/1993,25,0,15,19,59
3/18/1993,29,0,28,23,80
3/19/1993,14,0,10,9,33
3/20/1993,21,0,16,16,53
3/21/1993,32,0,16,16,64
3/22/1993,27,0,22,25,74
3/23/1993,21,0,31,11,63
3/24/1993,24,0,15,31,70
3/25/1993,25,0,11,28,64
3/26/1993,29,0,15,16,60
3/27/1993,24,0,19,8,51
3/28/1993,28,0,26,4,58
3/29/1993,30,0,29,10,69
3/30/1993,25,0,19,14,58
3/31/1993,25,0,21,19,65
4/1/1993,24,0,29,15,68
4/2/1993,19,0,14,22,55
4/3/1993,19,0,17,25,61
4/4/1993,22,0,30,13,65
4/5/1993,27,0,23,25,75
4/6/1993,29,0,21,29,79
4/7/1993,10,0,19,18,47
4/8/1993,19,0,17,18,54
4/9/1993,22,0,20,12,54
4/10/1993,23,0,15,7,45
4/11/1993,23,0,17,22,62
4/12/1993,25,0,17,23,65
4/13/1993,25,0,14,1,40
4/14/1993,16,0,26,18,60
4/15/1993,33,0,22,16,71
4/16/1993,20,0,23,26,69
4/17/1993,28,0,22,16,66
4/18/1993,21,0,21,30,72
4/19/1993,30,0,13,19,62
4/20/1993,34,0,19,29,82
4/21/1993,32,0,9,14,55
4/22/1993,18,0,28,18,64
4/23/1993,26,0,25,13,64
4/24/1993,29,0,17,6,52
4/25/1993,19,0,15,26,60
4/26/1993,28,0,16,16,60
4/27/1993,19,0,18,23,60
4/28/1993,23,0,24,29,76
4/29/1993,15,0,20,29,64
4/30/1993,13,0,17,23,53
5/1/1993,19,0,23,11,53
5/2/1993,23,0,29,23,75
5/3/1993,18,0,29,26,73
5/4/1993,16,0,24,23,63
5/5/1993,20,0,17,16,53
5/6/1993,27,0,10,20,57
5/7/1993,27,0,25,20,72
5/8/1993,25,0,18,19,62
5/9/1993,30,0,15,6,51
5/10/1993,25,0,18,23,66
5/11/1993,26,0,25,16,67
5/12/1993,21,0,21,13,55
5/13/1993,20,0,10,6,36
5/14/1993,17,0,31,11,59
5/15/1993,22,0,25,17,64
5/16/1993,23,0,20,15,58
5/17/1993,29,0,23,15,67
5/18/1993,26,0,17,14,57
5/19/1993,23,0,22,32,77
5/20/1993,22,0,21,32,75
5/21/1993,21,0,27,23,71
5/22/1993,24,0,16,25,65
5/23/1993,25,0,28,17,70
5/24/1993,22,0,10,19,51
5/25/1993,27,0,8,32,67
5/26/1993,28,0,14,37,79
5/27/1993,26,0,23,30,79
5/28/1993,19,0,13,32,64
5/29/1993,21,0,24,12,57
5/30/1993,28,0,25,25,78
5/31/1993,23,0,14,9,46
6/1/1993,18,0,29,20,67
6/2/1993,17,0,30,8,55
6/3/1993,19,0,12,37,68
6/4/1993,18,0,24,18,60
6/5/1993,14,0,17,16,47
6/6/1993,23,0,12,24,59
6/7/1993,19,0,19,19,57
6/8/1993,25,0,19,26,70
6/9/1993,25,0,14,34,73
6/10/1993,22,0,19,34,75
6/11/1993,25,0,31,5,61
6/12/1993,31,0,19,6,56
6/13/1993,24,0,18,26,68
6/14/1993,21,0,11,14,46
6/15/1993,21,0,20,27,68
6/16/1993,26,0,18,14,58
6/17/1993,27,0,28,24,79
6/18/1993,22,0,18,10,50
6/19/1993,31,0,20,21,72
6/20/1993,17,0,17,22,56
6/21/1993,23,0,10,9,42
6/22/1993,21,0,16,33,70
6/23/1993,22,0,22,15,59
6/24/1993,15,0,19,19,53
6/25/1993,28,0,14,14,56
6/26/1993,30,0,9,27,66
6/27/1993,31,0,13,23,67
6/28/1993,26,0,21,24,71
6/29/1993,27,0,19,27,73
6/30/1993,23,0,12,4,39
7/1/1993,26,0,16,19,61
7/2/1993,24,0,12,22,58
7/3/1993,26,0,29,35,90
7/4/1993,19,0,11,23,53
7/5/1993,23,0,17,25,65
7/6/1993,24,0,24,32,80
7/7/1993,26,0,25,20,71
7/8/1993,21,0,15,27,63
7/9/1993,26,0,24,16,66
7/10/1993,24,0,19,14,57
7/11/1993,31,0,9,23,63
7/12/1993,22,0,24,19,65
7/13/1993,24,0,22,16,62
7/14/1993,34,0,23,19,76
7/15/1993,29,0,16,28,73
7/16/1993,23,0,12,19,54
7/17/1993,23,0,23,27,73
7/18/1993,28,0,22,10,60
7/19/1993,26,0,23,17,66
7/20/1993,24,0,14,13,51
7/21/1993,19,0,12,9,40
7/22/1993,17,0,20,17,54
7/23/1993,26,0,18,34,78
7/24/1993,16,0,15,22,53
7/25/1993,23,0,24,15,62
7/26/1993,23,0,23,25,71
7/27/1993,14,0,20,26,60
7/28/1993,16,0,14,13,43
7/29/1993,20,0,18,18,56
7/30/1993,27,0,32,22,81
7/31/1993,16,0,17,27,60
8/1/1993,22,0,15,19,56
8/2/1993,15,0,21,19,55
8/3/1993,27,0,8,21,56
8/4/1993,18,0,12,20,50
8/5/1993,22,0,26,16,64
8/6/1993,21,0,27,10,58
8/7/1993,25,0,16,23,64
8/8/1993,21,0,21,26,68
8/9/1993,19,0,17,19,55
8/10/1993,19,0,17,28,64
8/11/1993,12,0,27,19,58
8/12/1993,21,0,18,28,67
8/13/1993,25,0,22,24,71
8/14/1993,19,0,19,37,75
8/15/1993,27,0,27,20,74
8/16/1993,19,0,27,31,77
8/17/1993,15,0,25,17,57
8/18/1993,18,0,17,34,69
8/19/1993,22,0,17,5,44
8/20/1993,19,0,20,12,51
8/21/1993,19,0,17,18,54
8/22/1993,16,0,21,26,63
8/23/1993,26,0,20,27,73
8/24/1993,18,0,15,21,54
8/25/1993,28,0,26,13,67
8/26/1993,25,0,17,14,56
8/27/1993,16,0,27,14,57
8/28/1993,24,0,15,23,62
8/29/1993,25,0,28,23,76
8/30/1993,31,0,25,32,88
8/31/1993,19,0,13,22,54
9/1/1993,15,0,23,24,62
9/2/1993,19,0,16,10,45
9/3/1993,21,0,28,15,64
9/4/1993,17,0,24,13,54
9/5/1993,19,0,24,17,60
9/6/1993,27,0,19,12,58
9/7/1993,25,0,18,18,61
9/8/1993,19,0,16,14,49
9/9/1993,18,0,22,3,43
9/10/1993,24,0,15,17,56
9/11/1993,20,0,23,21,64
9/12/1993,26,0,21,24,71
9/13/1993,25,0,20,20,65
9/14/1993,29,0,24,9,62
9/15/1993,19,0,24,16,59
9/16/1993,24,0,12,35,71
9/17/1993,19,0,27,14,60
9/18/1993,34,0,22,24,80
9/19/1993,24,0,18,8,50
9/20/1993,16,0,26,23,65
9/21/1993,25,0,32,15,72
9/22/1993,24,0,27,17,68
9/23/1993,30,0,24,24,78
9/24/1993,23,0,17,23,63
9/25/1993,25,0,23,18,66
9/26/1993,19,0,17,20,56
9/27/1993,16,0,20,22,58
9/28/1993,24,0,20,10,54
9/29/1993,19,0,17,19,55
9/30/1993,26,0,19,16,61
10/1/1993,31,0,13,16,60
10/2/1993,28,0,21,15,64
10/3/1993,19,0,21,26,66
10/4/1993,23,0,27,31,81
10/5/1993,27,0,27,25,79
10/6/1993,14,0,18,13,45
10/7/1993,28,0,24,13,65
10/8/1993,28,0,14,18,60
10/9/1993,29,0,16,17,62
10/10/1993,21,0,24,25,70
10/11/1993,26,0,8,31,65
10/12/1993,20,0,7,24,51
10/13/1993,27,0,9,27,63
10/14/1993,24,0,15,15,54
10/15/1993,21,0,30,13,64
10/16/1993,20,0,19,11,50
10/17/1993,28,0,22,2,52
10/18/1993,19,0,32,21,72
10/19/1993,25,0,25,22,72
10/20/1993,15,0,11,25,51
10/21/1993,18,0,16,26,60
10/22/1993,22,0,19,21,62
10/23/1993,26,0,19,22,67
10/24/1993,31,0,12,16,59
10/25/1993,32,0,24,26,82
10/26/1993,32,0,24,7,63
10/27/1993,28,0,16,19,63
10/28/1993,21,0,19,30,70
10/29/1993,21,0,25,16,62
10/30/1993,24,0,16,17,57
10/31/1993,26,0,23,12,61
11/1/1993,25,0,23,18,66
11/2/1993,19,0,18,15,52
11/3/1993,25,0,10,27,62
11/4/1993,19,0,16,30,65
11/5/1993,33,0,27,22,82
11/6/1993,17,0,24,15,56
11/7/1993,22,0,14,19,55
11/8/1993,22,0,23,20,65
11/9/1993,26,0,17,29,72
11/10/1993,22,0,12,24,58
11/11/1993,19,0,18,15,52
11/12/1993,24,0,27,9,60
11/13/1993,19,0,19,26,64
11/14/1993,24,0,24,10,58
11/15/1993,32,0,14,17,63
11/16/1993,22,0,18,32,72
11/17/1993,32,0,17,14,63
11/18/1993,25,0,25,35,85
11/19/1993,29,0,19,32,80
11/20/1993,31,0,28,9,68
11/21/1993,24,0,23,15,62
11/22/1993,24,0,18,13,55
11/23/1993,22,0,14,15,51
11/24/1993,21,0,8,29,58
11/25/1993,30,0,13,17,60
11/26/1993,24,0,24,17,65
11/27/1993,19,0,24,34,77
11/28/1993,20,0,24,15,59
11/29/1993,27,0,20,16,63
11/30/1993,23,0,24,20,67
12/1/1993,22,0,23,28,73
12/2/1993,17,0,24,25,66
12/3/1993,25,0,19,25,69
12/4/1993,22,0,21,26,69
12/5/1993,29,0,18,10,57
12/6/1993,16,0,18,25,59
12/7/1993,30,0,21,18,69
12/8/1993,19,0,12,20,51
12/9/1993,30,0,25,35,90
12/10/1993,35,0,13,26,74
12/11/1993,23,0,20,26,69
12/12/1993,24,0,14,15,53
12/13/1993,15,0,23,20,58
12/14/1993,24,0,16,22,62
12/15/1993,20,0,16,7,43
12/16/1993,22,0,11,10,43
12/17/1993,26,0,13,8,47
12/18/1993,33,0,21,11,65
12/19/1993,19,0,14,18,51
12/20/1993,21,0,19,4,44
12/21/1993,21,0,16,24,61
12/22/1993,22,0,14,23,59
12/23/1993,19,0,29,28,76
12/24/1993,23,0,21,10,54
12/25/1993,21,0,25,16,62
12/26/1993,28,0,22,17,67
12/27/1993,13,0,12,12,37
12/28/1993,22,0,16,13,51
12/29/1993,30,0,14,23,67
12/30/1993,31,0,22,17,70
12/31/1993,20,0,24,17,61
1/1/1994,23,0,13,18,54
1/2/1994,23,0,17,28,68
1/3/1994,29,0,13,32,74
1/4/1994,21,0,15,9,45
1/5/1994,24,0,17,22,63
1/6/1994,18,0,17,13,48
1/7/1994,32,0,21,21,74
1/8/1994,30,0,22,10,62
1/9/1994,23,0,24,33,80
1/10/1994,17,0,21,24,62
1/11/1994,21,0,16,14,51
1/12/1994,17,0,14,31,62
1/13/1994,13,0,25,27,65
1/14/1994,21,0,15,31,67
1/15/1994,33,0,25,15,73
1/16/1994,29,0,28,12,69
1/17/1994,25,0,17,24,66
1/18/1994,19,0,18,15,52
1/19/1994,26,0,18,21,65
1/20/1994,29,0,22,23,74
1/21/1994,22,0,21,34,77
1/22/1994,26,0,23,20,69
1/23/1994,17,0,26,33,76
1/24/1994,13,0,13,26,52
1/25/1994,32,0,27,17,76
1/26/1994,17,0,15,22,54
1/27/1994,22,0,28,21,71
1/28/1994,29,0,10,26,65
1/29/1994,25,0,29,17,71
1/30/1994,25,0,21,26,72
1/31/1994,20,0,25,10,55
2/1/1994,24,0,16,10,50
2/2/1994,24,0,19,12,55
2/3/1994,17,0,15,7,39
2/4/1994,26,0,25,29,80
2/5/1994,32,0,11,12,55
2/6/1994,24,0,29,36,89
2/7/1994,17,0,18,18,53
2/8/1994,21,0,21,16,58
2/9/1994,24,0,27,20,71
2/10/1994,24,0,25,23,72
2/11/1994,31,0,24,13,68
2/12/1994,22,0,27,20,69
2/13/1994,31,0,23,13,67
2/14/1994,23,0,27,24,74
2/15/1994,14,0,24,28,66
2/16/1994,31,0,13,24,68
2/17/1994,25,0,27,15,67
2/18/1994,27,0,17,26,70
2/19/1994,26,0,12,20,58
2/20/1994,18,0,15,24,57
2/21/1994,28,0,16,22,66
2/22/1994,23,0,19,20,62
2/23/1994,25,0,20,21,66
2/24/1994,28,0,30,37,95
2/25/1994,21,0,18,23,62
2/26/1994,26,0,14,28,68
2/27/1994,23,0,26,21,70
2/28/1994,27,0,20,12,59
3/1/1994,15,0,27,29,71
3/2/1994,26,0,26,25,77
3/3/1994,24,0,23,15,62
3/4/1994,24,0,14,31,69
3/5/1994,26,0,17,33,76
3/6/1994,20,0,16,22,58
3/7/1994,28,0,22,21,71
3/8/1994,23,0,25,22,70
3/9/1994,16,0,20,11,47
3/10/1994,17,0,16,27,60
3/11/1994,25,0,18,19,62
3/12/1994,19,0,19,18,56
3/13/1994,32,0,26,23,81
3/14/1994,22,0,24,25,71
3/15/1994,24,0,19,24,67
3/16/1994,17,0,21,25,63
3/17/1994,21,0,24,11,56
3/18/1994,17,0,26,23,66
3/19/1994,19,0,23,28,70
3/20/1994,23,0,25,27,75
3/21/1994,30,0,11,15,56
3/22/1994,20,0,26,14,60
3/23/1994,23,0,13,21,57
3/24/1994,19,0,25,19,63
3/25/1994,21,0,12,24,57
3/26/1994,23,0,17,22,62
3/27/1994,26,0,15,17,58
3/28/1994,31,0,13,33,77
3/29/1994,23,0,16,22,61
3/30/1994,22,0,14,31,67
3/31/1994,25,0,20,34,79
4/1/1994,18,0,28,31,77
4/2/1994,15,0,21,21,57
4/3/1994,22,0,24,17,63
4/4/1994,23,0,14,15,52
4/5/1994,29,0,29,23,81
4/6/1994,16,0,14,12,42
4/7/1994,25,0,21,13,59
4/8/1994,15,0,24,23,62
4/9/1994,30,0,24,24,78
4/10/1994,22,0,15,25,62
4/11/1994,33,0,14,23,70
4/12/1994,23,0,20,29,72
4/13/1994,23,0,22,24,69
4/14/1994,23,0,28,16,67
4/15/1994,24,0,18,9,51
4/16/1994,19,0,28,21,68
4/17/1994,24,0,21,15,60
4/18/1994,20,0,18,23,61
4/19/1994,19,0,21,33,73
4/20/1994,17,0,15,35,67
4/21/1994,28,0,26,9,63
4/22/1994,24,0,27,29,80
4/23/1994,18,0,23,27,68
4/24/1994,19,0,24,24,67
4/25/1994,35,0,22,19,76
4/26/1994,21,0,24,20,65
4/27/1994,28,0,27,28,83
4/28/1994,22,0,31,26,79
4/29/1994,29,0,14,16,59
4/30/1994,21,0,24,11,56
5/1/1994,21,0,25,19,65
5/2/1994,24,0,16,24,64
5/3/1994,29,0,19,24,72
5/4/1994,24,0,28,24,76
5/5/1994,10,0,19,12,41
5/6/1994,23,0,29,11,63
5/7/1994,21,0,26,19,66
5/8/1994,24,0,19,31,74
5/9/1994,15,0,26,23,64
5/10/1994,25,0,12,36,73
5/11/1994,19,0,15,23,57
5/12/1994,30,0,17,12,59
5/13/1994,26,0,18,15,59
5/14/1994,24,0,10,27,61
5/15/1994,24,0,12,25,61
5/16/1994,19,0,16,8,43
5/17/1994,17,0,26,33,76
5/18/1994,32,0,28,21,81
5/19/1994,25,0,20,20,65
5/20/1994,24,0,16,22,62
5/21/1994,21,0,14,22,57
5/22/1994,31,0,26,2,59
5/23/1994,25,0,24,27,76
5/24/1994,13,0,21,21,55
5/25/1994,23,0,23,31,77
5/26/1994,21,0,13,15,49
5/27/1994,16,0,14,21,51
5/28/1994,23,0,16,27,66
5/29/1994,24,0,28,17,69
5/30/1994,20,0,23,21,64
5/31/1994,19,0,19,18,56
6/1/1994,18,0,19,24,61
6/2/1994,16,0,18,16,50
6/3/1994,30,0,20,16,66
6/4/1994,25,0,28,23,76
6/5/1994,28,0,21,15,64
6/6/1994,29,0,30,11,70
6/7/1994,21,0,16,37,74
6/8/1994,21,0,28,15,64
6/9/1994,24,0,22,23,69
6/10/1994,23,0,24,13,60
6/11/1994,28,0,21,25,74
6/12/1994,23,0,18,35,76
6/13/1994,12,0,16,27,55
6/14/1994,24,0,7,17,48
6/15/1994,19,0,18,27,64
6/16/1994,23,0,21,28,72
6/17/1994,27,0,22,11,60
6/18/1994,20,0,25,30,75
6/19/1994,27,0,21,15,63
6/20/1994,18,0,26,13,57
6/21/1994,22,0,23,22,67
6/22/1994,25,0,17,23,65
6/23/1994,22,0,30,25,77
6/24/1994,28,0,27,28,83
6/25/1994,21,0,16,25,62
6/26/1994,17,0,25,20,62
6/27/1994,28,0,11,19,58
6/28/1994,16,0,17,23,56
6/29/1994,23,0,21,24,68
6/30/1994,27,0,23,11,61
7/1/1994,29,0,25,24,78
7/2/1994,25,0,15,32,72
7/3/1994,13,0,21,31,65
7/4/1994,30,0,16,21,67
7/5/1994,27,0,22,26,75
7/6/1994,27,0,9,16,52
7/7/1994,34,0,17,2,53
7/8/1994,17,0,16,10,43
7/9/1994,16,0,19,12,47
7/10/1994,29,0,12,14,55
7/11/1994,12,0,17,25,54
7/12/1994,23,0,12,27,62
7/13/1994,20,0,22,26,68
7/14/1994,23,0,23,14,60
7/15/1994,22,0,21,29,72
7/16/1994,24,0,22,22,68
7/17/1994,17,0,8,13,38
7/18/1994,17,0,17,14,48
7/19/1994,28,0,23,19,70
7/20/1994,22,0,21,24,67
7/21/1994,19,0,18,20,57
7/22/1994,24,0,14,23,61
7/23/1994,18,0,16,8,42
7/24/1994,22,0,19,17,58
7/25/1994,27,0,15,24,66
7/26/1994,20,0,22,20,62
7/27/1994,17,0,24,20,61
7/28/1994,32,0,16,12,60
7/29/1994,24,0,24,29,77
7/30/1994,23,0,17,20,60
7/31/1994,17,0,28,19,64
8/1/1994,19,0,27,15,61
8/2/1994,27,0,8,27,62
8/3/1994,29,0,27,31,87
8/4/1994,27,0,24,18,69
8/5/1994,29,0,26,25,80
8/6/1994,23,0,17,12,52
8/7/1994,29,0,15,28,72
8/8/1994,24,0,26,20,70
8/9/1994,24,0,19,29,72
8/10/1994,22,0,20,23,65
8/11/1994,27,0,12,24,63
8/12/1994,17,0,19,22,58
8/13/1994,27,0,30,19,76
8/14/1994,22,0,25,13,60
8/15/1994,25,0,22,15,62
8/16/1994,25,0,28,12,65
8/17/1994,25,0,19,10,54
8/18/1994,21,0,24,12,57
8/19/1994,27,0,21,14,62
8/20/1994,23,0,28,5,56
8/21/1994,22,0,24,18,64
8/22/1994,13,0,22,13,48
8/23/1994,18,0,24,13,55
8/24/1994,20,0,13,35,68
8/25/1994,25,0,18,24,67
8/26/1994,30,0,20,19,69
8/27/1994,24,0,20,8,52
8/28/1994,28,0,16,20,64
8/29/1994,15,0,19,19,53
8/30/1994,20,0,24,15,59
8/31/1994,20,0,23,15,58
9/1/1994,24,0,28,20,72
9/2/1994,28,0,10,8,46
9/3/1994,29,0,17,23,69
9/4/1994,17,0,11,33,61
9/5/1994,17,0,17,21,55
9/6/1994,22,0,16,14,52
9/7/1994,18,0,27,22,67
9/8/1994,29,0,23,14,66
9/9/1994,24,0,16,11,51
9/10/1994,24,0,9,20,53
9/11/1994,19,0,23,22,64
9/12/1994,23,0,16,26,65
9/13/1994,27,0,30,23,80
9/14/1994,28,0,17,16,61
9/15/1994,17,0,10,19,46
9/16/1994,24,0,15,21,60
9/17/1994,26,0,13,26,65
9/18/1994,16,0,20,10,46
9/19/1994,25,0,16,15,56
9/20/1994,17,0,17,9,43
9/21/1994,30,0,17,27,74
9/22/1994,23,0,20,27,70
9/23/1994,14,0,13,12,39
9/24/1994,26,0,9,21,56
9/25/1994,26,0,13,22,61
9/26/1994,25,0,27,26,78
9/27/1994,25,0,20,18,63
9/28/1994,23,0,25,14,62
9/29/1994,30,0,27,21,78
9/30/1994,13,0,15,22,50
10/1/1994,18,0,13,12,43
10/2/1994,26,0,31,9,66
10/3/1994,21,0,31,27,79
10/4/1994,22,0,16,28,66
10/5/1994,25,0,18,33,76
10/6/1994,25,0,17,21,63
10/7/1994,22,0,12,27,61
10/8/1994,18,0,24,29,71
10/9/1994,28,0,13,13,54
10/10/1994,26,0,27,9,62
10/11/1994,18,0,22,19,59
10/12/1994,28,0,14,17,59
10/13/1994,16,0,13,22,51
10/14/1994,31,0,30,23,84
10/15/1994,20,0,18,29,67
10/16/1994,23,0,27,10,60
10/17/1994,20,0,14,12,46
10/18/1994,21,0,12,32,65
10/19/1994,30,0,17,24,71
10/20/1994,19,0,7,17,43
10/21/1994,29,0,18,14,61
10/22/1994,20,0,12,17,49
10/23/1994,27,0,23,8,58
10/24/1994,14,0,20,11,45
10/25/1994,13,0,11,13,37
10/26/1994,24,0,11,13,48
10/27/1994,20,0,19,8,47
10/28/1994,15,0,23,21,59
10/29/1994,25,0,22,10,57
10/30/1994,20,0,24,15,59
10/31/1994,24,0,21,17,62
11/1/1994,19,0,21,16,56
11/2/1994,20,0,23,2,45
11/3/1994,22,0,27,25,74
11/4/1994,24,0,23,13,60
11/5/1994,18,0,24,35,77
11/6/1994,19,0,17,20,56
11/7/1994,19,0,14,32,65
11/8/1994,15,0,15,12,42
11/9/1994,15,0,18,18,51
11/10/1994,26,0,25,23,74
11/11/1994,17,0,27,16,60
11/12/1994,25,0,25,20,70
11/13/1994,23,0,21,17,61
11/14/1994,28,0,22,27,77
11/15/1994,27,0,15,22,64
11/16/1994,15,0,26,16,57
11/17/1994,20,0,20,32,72
11/18/1994,21,0,18,15,54
11/19/1994,20,0,28,23,71
11/20/1994,26,0,15,24,65
11/21/1994,23,0,28,21,72
11/22/1994,16,0,19,20,55
11/23/1994,28,0,18,25,71
11/24/1994,31,0,23,22,76
11/25/1994,21,0,24,13,58
11/26/1994,25,0,24,6,55
11/27/1994,28,0,26,12,66
11/28/1994,24,0,22,31,77
11/29/1994,22,0,23,27,72
11/30/1994,26,0,25,32,83
12/1/1994,17,0,30,25,72
12/2/1994,27,0,30,35,92
12/3/1994,17,0,24,29,70
12/4/1994,25,0,16,15,56
12/5/1994,26,0,24,13,63
12/6/1994,20,0,13,13,46
12/7/1994,26,0,21,15,62
12/8/1994,17,0,21,19,57
12/9/1994,26,0,25,31,82
12/10/1994,32,0,14,26,72
12/11/1994,22,0,26,18,66
12/12/1994,20,0,24,24,68
12/13/1994,32,0,19,30,81
12/14/1994,24,0,20,19,63
12/15/1994,32,0,17,13,62
12/16/1994,22,0,16,22,60
12/17/1994,22,0,26,29,77
12/18/1994,17,0,18,21,56
12/19/1994,30,0,27,22,79
12/20/1994,24,0,22,25,71
12/21/1994,21,0,13,14,48
12/22/1994,20,0,28,20,68
12/23/1994,26,0,16,11,53
12/24/1994,27,0,16,11,54
12/25/1994,27,0,21,10,58
12/26/1994,21,0,14,26,61
12/27/1994,26,0,12,20,58
12/28/1994,28,0,17,30,75
12/29/1994,24,0,21,21,66
12/30/1994,18,0,31,25,74
12/31/1994,27,0,25,19,71
1/1/1995,25,0,22,26,73
1/2/1995,26,0,14,19,59
1/3/1995,31,0,15,21,67
1/4/1995,24,0,16,16,56
1/5/1995,20,0,21,22,63
1/6/1995,23,0,24,18,65
1/7/1995,24,0,20,19,63
1/8/1995,22,0,27,32,81
1/9/1995,25,0,24,18,67
1/10/1995,18,0,14,17,49
1/11/1995,22,0,17,21,60
1/12/1995,25,0,11,12,48
1/13/1995,18,0,19,22,59
1/14/1995,26,0,24,29,79
1/15/1995,23,0,12,23,58
1/16/1995,28,0,20,19,67
1/17/1995,27,0,19,31,77
1/18/1995,26,0,28,8,62
1/19/1995,21,0,23,28,72
1/20/1995,24,0,9,15,48
1/21/1995,30,0,27,20,77
1/22/1995,26,0,14,28,68
1/23/1995,24,0,15,20,59
1/24/1995,25,0,12,15,52
1/25/1995,21,0,16,19,56
1/26/1995,24,0,26,24,74
1/27/1995,20,0,29,17,66
1/28/1995,34,0,23,24,81
1/29/1995,23,0,27,17,67
1/30/1995,23,0,23,6,52
1/31/1995,25,0,17,11,53
2/1/1995,23,0,20,22,65
2/2/1995,16,0,23,27,66
2/3/1995,28,0,12,30,70
2/4/1995,27,0,17,11,55
2/5/1995,22,0,21,18,61
2/6/1995,20,0,25,10,55
2/7/1995,17,0,24,20,61
2/8/1995,15,0,20,28,63
2/9/1995,12,0,20,12,44
2/10/1995,29,0,12,30,71
2/11/1995,25,0,18,12,55
2/12/1995,12,0,25,15,52
2/13/1995,17,0,24,29,70
2/14/1995,22,0,17,30,69
2/15/1995,20,0,15,24,59
2/16/1995,25,0,21,2,48
2/17/1995,18,0,27,22,67
2/18/1995,18,0,8,17,43
2/19/1995,19,0,20,29,68
2/20/1995,25,0,14,14,53
2/21/1995,29,0,17,25,71
2/22/1995,20,0,29,15,64
2/23/1995,21,0,19,27,67
2/24/1995,29,0,18,38,85
2/25/1995,17,0,25,24,66
2/26/1995,15,0,24,3,42
2/27/1995,26,0,17,21,64
2/28/1995,23,0,20,28,71
3/1/1995,25,0,22,20,67
3/2/1995,22,0,20,7,49
3/3/1995,20,0,20,24,64
3/4/1995,19,0,15,21,55
3/5/1995,22,0,28,16,66
3/6/1995,28,0,21,14,63
3/7/1995,25,0,11,10,46
3/8/1995,28,0,19,7,54
3/9/1995,25,0,12,16,53
3/10/1995,26,0,16,31,73
3/11/1995,25,0,19,24,68
3/12/1995,25,0,21,23,69
3/13/1995,26,0,12,28,66
3/14/1995,25,0,17,12,54
3/15/1995,30,0,28,17,75
3/16/1995,31,0,14,27,72
3/17/1995,22,0,18,18,58
3/18/1995,23,0,21,15,59
3/19/1995,23,0,26,15,64
3/20/1995,28,0,19,17,64
3/21/1995,23,0,15,17,55
3/22/1995,24,0,26,22,72
3/23/1995,18,0,22,35,75
3/24/1995,23,0,18,21,62
3/25/1995,19,0,18,23,60
3/26/1995,28,0,24,10,62
3/27/1995,29,0,15,27,71
3/28/1995,23,0,17,13,53
3/29/1995,19,0,14,18,51
3/30/1995,29,0,32,24,85
3/31/1995,21,0,22,23,66
4/1/1995,26,0,25,18,69
4/2/1995,19,0,20,19,58
4/3/1995,21,0,26,20,67
4/4/1995,27,0,24,9,60
4/5/1995,29,0,22,23,74
4/6/1995,26,0,23,29,78
4/7/1995,23,0,16,26,65
4/8/1995,16,0,19,26,61
4/9/1995,26,0,12,24,62
4/10/1995,24,0,16,13,53
4/11/1995,20,0,16,24,60
4/12/1995,20,0,27,15,62
4/13/1995,22,0,12,16,50
4/14/1995,25,0,21,24,70
4/15/1995,17,0,22,24,63
4/16/1995,24,0,21,29,74
4/17/1995,18,0,13,23,54
4/18/1995,25,0,28,21,74
4/19/1995,25,0,11,19,55
4/20/1995,23,0,29,6,58
4/21/1995,24,0,13,21,58
4/22/1995,34,0,15,19,68
4/23/1995,24,0,16,22,62
4/24/1995,28,0,24,24,76
4/25/1995,20,0,20,15,55
4/26/1995,22,0,11,30,63
4/27/1995,30,0,18,22,70
4/28/1995,26,0,30,22,78
4/29/1995,30,0,18,14,62
4/30/1995,22,0,13,20,55
5/1/1995,22,0,19,30,71
5/2/1995,21,0,24,18,63
5/3/1995,24,0,14,30,68
5/4/1995,25,0,13,14,52
5/5/1995,14,0,25,18,57
5/6/1995,29,0,15,20,64
5/7/1995,22,0,16,26,64
5/8/1995,28,0,24,19,71
5/9/1995,18,0,18,28,64
5/10/1995,18,0,22,30,70
5/11/1995,28,0,20,19,67
5/12/1995,18,0,15,17,50
5/13/1995,29,0,28,22,79
5/14/1995,25,0,22,19,66
5/15/1995,17,0,17,15,49
5/16/1995,19,0,14,11,44
5/17/1995,27,0,23,35,85
5/18/1995,22,0,21,18,61
5/19/1995,26,0,11,29,66
5/20/1995,25,0,7,32,64
5/21/1995,24,0,16,16,56
5/22/1995,13,0,26,6,45
5/23/1995,27,0,19,19,65
5/24/1995,13,0,23,21,57
5/25/1995,25,0,22,16,63
5/26/1995,25,0,13,20,58
5/27/1995,29,0,11,26,66
5/28/1995,27,0,32,22,81
5/29/1995,31,0,25,15,71
5/30/1995,27,0,14,20,61
5/31/1995,24,0,18,22,64
6/1/1995,32,0,19,14,65
6/2/1995,33,0,27,26,86
6/3/1995,23,0,26,18,67
6/4/1995,31,0,31,20,82
6/5/1995,18,0,24,36,78
6/6/1995,26,0,24,17,67
6/7/1995,18,0,11,25,54
6/8/1995,20,0,20,17,57
6/9/1995,26,0,19,19,64
6/10/1995,23,0,20,20,63
6/11/1995,16,0,17,10,43
6/12/1995,21,0,21,25,67
6/13/1995,17,0,19,18,54
6/14/1995,18,0,19,16,53
6/15/1995,31,0,23,7,61
6/16/1995,17,0,20,31,68
6/17/1995,22,0,19,6,47
6/18/1995,17,0,15,24,56
6/19/1995,12,0,21,28,61
6/20/1995,18,0,28,25,71
6/21/1995,22,0,20,26,68
6/22/1995,26,0,20,16,62
6/23/1995,22,0,28,30,80
6/24/1995,16,0,21,23,60
6/25/1995,26,0,21,32,79
6/26/1995,20,0,17,17,54
6/27/1995,31,0,22,10,63
6/28/1995,25,0,29,16,70
6/29/1995,20,0,30,22,72
6/30/1995,31,0,28,28,87
7/1/1995,15,0,32,27,74
7/2/1995,19,0,15,28,62
7/3/1995,28,0,23,20,71
7/4/1995,20,0,11,21,52
7/5/1995,23,0,23,23,69
7/6/1995,31,0,12,24,67
7/7/1995,26,0,13,17,56
7/8/1995,15,0,17,22,54
7/9/1995,21,0,18,23,62
7/10/1995,22,0,24,28,74
7/11/1995,32,0,22,20,74
7/12/1995,31,0,22,15,68
7/13/1995,26,0,19,12,57
7/14/1995,26,0,17,16,59
7/15/1995,18,0,15,18,51
7/16/1995,34,0,26,13,73
7/17/1995,24,0,23,22,69
7/18/1995,22,0,18,29,69
7/19/1995,22,0,21,11,54
7/20/1995,31,0,26,20,77
7/21/1995,23,0,10,5,38
7/22/1995,26,0,17,33,76
7/23/1995,25,0,27,18,70
7/24/1995,13,0,21,17,51
7/25/1995,25,0,24,20,69
7/26/1995,16,0,23,14,53
7/27/1995,25,0,29,20,74
7/28/1995,31,0,12,23,66
7/29/1995,24,0,22,32,78
7/30/1995,23,0,11,11,45
7/31/1995,17,0,20,6,43
8/1/1995,31,0,16,17,64
8/2/1995,27,0,20,20,67
8/3/1995,26,0,18,14,58
8/4/1995,14,0,26,23,63
8/5/1995,25,0,29,7,61
8/6/1995,31,0,19,19,69
8/7/1995,15,0,22,24,61
8/8/1995,26,0,10,18,54
8/9/1995,26,0,18,20,64
8/10/1995,21,0,26,19,66
8/11/1995,13,0,23,20,56
8/12/1995,24,0,15,8,47
8/13/1995,33,0,25,10,68
8/14/1995,23,0,17,14,54
8/15/1995,18,0,9,21,48
8/16/1995,22,0,27,20,69
8/17/1995,20,0,27,20,67
8/18/1995,29,0,18,15,62
8/19/1995,15,0,15,19,49
8/20/1995,18,0,8,14,40
8/21/1995,27,0,27,33,87
8/22/1995,30,0,17,12,59
8/23/1995,25,0,24,23,72
8/24/1995,24,0,8,19,51
8/25/1995,25,0,25,16,66
8/26/1995,26,0,26,7,59
8/27/1995,29,0,32,13,74
8/28/1995,22,0,23,19,64
8/29/1995,31,0,25,21,77
8/30/1995,23,0,17,12,52
8/31/1995,22,0,15,31,68
9/1/1995,23,0,14,29,66
9/2/1995,17,0,14,25,56
9/3/1995,29,0,21,21,71
9/4/1995,18,0,15,19,52
9/5/1995,23,0,19,18,60
9/6/1995,26,0,28,23,77
9/7/1995,24,0,21,24,69
9/8/1995,22,0,22,10,54
9/9/1995,19,0,29,14,62
9/10/1995,31,0,14,22,67
9/11/1995,15,0,15,31,61
9/12/1995,13,0,23,23,59
9/13/1995,17,0,24,25,66
9/14/1995,24,0,24,18,66
9/15/1995,23,0,23,27,73
9/16/1995,21,0,16,18,55
9/17/1995,13,0,19,24,56
9/18/1995,15,0,18,22,55
9/19/1995,30,0,15,32,77
9/20/1995,20,0,26,19,65
9/21/1995,26,0,20,22,68
9/22/1995,27,0,21,15,63
9/23/1995,20,0,18,16,54
9/24/1995,12,0,14,18,44
9/25/1995,26,0,16,16,58
9/26/1995,22,0,26,20,68
9/27/1995,14,0,16,24,54
9/28/1995,19,0,15,22,56
9/29/1995,17,0,20,33,70
9/30/1995,21,0,21,18,60
10/1/1995,17,0,23,23,63
10/2/1995,18,0,21,23,62
10/3/1995,25,0,24,27,76
10/4/1995,23,0,21,14,58
10/5/1995,21,0,22,18,61
10/6/1995,21,0,22,18,61
10/7/1995,20,0,29,18,67
10/8/1995,21,0,28,23,72
10/9/1995,17,0,22,13,52
10/10/1995,25,0,22,14,61
10/11/1995,20,0,20,24,64
10/12/1995,17,0,22,9,48
10/13/1995,22,0,33,14,69
10/14/1995,16,0,22,16,54
10/15/1995,19,0,22,21,62
10/16/1995,24,0,15,14,53
10/17/1995,25,0,24,24,73
10/18/1995,31,0,18,21,70
10/19/1995,21,0,17,18,56
10/20/1995,23,0,21,23,67
10/21/1995,25,0,14,17,56
10/22/1995,15,0,31,23,69
10/23/1995,30,0,26,31,87
10/24/1995,33,0,23,29,85
10/25/1995,25,0,21,18,64
10/26/1995,25,0,24,4,53
10/27/1995,24,0,23,24,71
10/28/1995,23,0,22,28,73
10/29/1995,22,0,20,29,71
10/30/1995,18,0,22,30,70
10/31/1995,21,0,20,18,59
11/1/1995,25,0,14,12,51
11/2/1995,24,0,12,23,59
11/3/1995,15,0,15,31,61
11/4/1995,13,0,29,28,70
11/5/1995,16,0,31,16,63
11/6/1995,24,0,15,13,52
11/7/1995,22,0,11,25,58
11/8/1995,22,0,30,34,86
11/9/1995,32,0,15,27,74
11/10/1995,33,0,24,22,79
11/11/1995,29,0,20,28,77
11/12/1995,25,0,19,28,72
11/13/1995,27,0,31,18,76
11/14/1995,25,0,24,12,61
11/15/1995,26,0,17,8,51
11/16/1995,30,0,18,11,59
11/17/1995,25,0,20,16,61
11/18/1995,26,0,17,16,59
11/19/1995,24,0,19,21,64
11/20/1995,17,0,18,20,55
11/21/1995,30,0,24,29,83
11/22/1995,21,0,18,14,53
11/23/1995,16,0,16,17,49
11/24/1995,18,0,24,19,61
11/25/1995,16,0,23,6,45
11/26/1995,18,0,13,35,66
11/27/1995,25,0,28,15,68
11/28/1995,18,0,20,15,53
11/29/1995,31,0,13,12,56
11/30/1995,19,0,16,21,56
12/1/1995,19,0,20,15,54
12/2/1995,23,0,24,15,62
12/3/1995,29,0,24,18,71
12/4/1995,15,0,22,14,51
12/5/1995,23,0,19,36,78
12/6/1995,19,0,30,17,66
12/7/1995,24,0,24,18,66
12/8/1995,25,0,16,23,64
12/9/1995,27,0,26,21,74
12/10/1995,15,0,27,21,63
12/11/1995,23,0,19,11,53
12/12/1995,18,0,29,22,69
12/13/1995,20,0,16,19,55
12/14/1995,23,0,20,7,50
12/15/1995,29,0,21,19,69
12/16/1995,20,0,18,32,70
12/17/1995,29,0,21,6,56
12/18/1995,26,0,19,24,69
12/19/1995,22,0,14,22,58
12/20/1995,15,0,19,22,56
12/21/1995,22,0,17,7,46
12/22/1995,19,0,26,17,62
12/23/1995,18,0,26,15,59
12/24/1995,18,0,16,19,53
12/25/1995,17,0,23,18,58
12/26/1995,23,0,10,10,43
12/27/1995,26,0,24,17,67
12/28/1995,21,0,19,31,71
12/29/1995,29,0,19,21,69
12/30/1995,18,0,15,17,50
12/31/1995,30,0,21,18,69
1/1/1996,25,0,14,10,49
1/2/1996,15,0,8,28,51
1/3/1996,18,0,26,11,55
1/4/1996,21,0,17,22,60
1/5/1996,18,0,25,22,65
1/6/1996,29,0,24,40,93
1/7/1996,23,0,32,20,75
1/8/1996,26,0,22,20,68
1/9/1996,27,0,22,27,76
1/10/1996,16,0,16,23,55
1/11/1996,22,0,28,11,61
1/12/1996,23,0,25,17,65
1/13/1996,23,0,17,9,49
1/14/1996,26,0,29,19,74
1/15/1996,26,0,23,33,82
1/16/1996,22,0,19,10,51
1/17/1996,22,0,26,20,68
1/18/1996,22,0,23,22,67
1/19/1996,23,0,14,22,59
1/20/1996,20,0,27,18,65
1/21/1996,31,0,16,8,55
1/22/1996,22,0,19,27,68
1/23/1996,26,0,27,15,68
1/24/1996,33,0,9,24,66
1/25/1996,23,0,30,12,65
1/26/1996,16,0,17,19,52
1/27/1996,19,0,24,26,69
1/28/1996,21,0,21,16,58
1/29/1996,20,0,12,18,50
1/30/1996,24,0,17,23,64
1/31/1996,26,0,9,25,60
2/1/1996,31,0,22,14,67
2/2/1996,26,0,20,16,62
2/3/1996,15,0,9,25,49
2/4/1996,32,0,15,25,72
2/5/1996,20,0,11,25,56
2/6/1996,18,0,20,19,57
2/7/1996,18,0,12,13,43
2/8/1996,23,0,24,25,72
2/9/1996,16,0,13,12,41
2/10/1996,18,0,9,25,52
2/11/1996,21,0,23,14,58
2/12/1996,13,0,26,22,61
2/13/1996,21,0,21,23,65
2/14/1996,19,0,18,19,56
2/15/1996,17,0,15,13,45
2/16/1996,27,0,17,1,45
2/17/1996,28,0,15,13,56
2/18/1996,24,0,21,10,55
2/19/1996,24,0,17,3,44
2/20/1996,16,0,26,34,76
2/21/1996,19,0,18,29,66
2/22/1996,23,0,21,15,59
2/23/1996,23,0,19,30,72
2/24/1996,27,0,14,31,72
2/25/1996,28,0,29,12,69
2/26/1996,28,0,28,20,76
2/27/1996,19,0,24,16,59
2/28/1996,21,0,19,28,68
2/29/1996,22,0,20,24,66
3/1/1996,20,0,25,21,66
3/2/1996,17,0,23,18,58
3/3/1996,24,0,29,14,67
3/4/1996,25,0,20,7,52
3/5/1996,13,0,21,9,43
3/6/1996,24,0,19,20,63
3/7/1996,28,0,27,16,71
3/8/1996,21,0,28,18,67
3/9/1996,15,0,13,9,37
3/10/1996,23,0,18,16,57
3/11/1996,22,0,15,19,56
3/12/1996,23,0,13,36,72
3/13/1996,28,0,14,19,61
3/14/1996,21,0,23,20,64
3/15/1996,17,0,20,22,59
3/16/1996,22,0,28,19,69
3/17/1996,19,0,23,22,64
3/18/1996,23,0,16,17,56
3/19/1996,31,0,13,32,76
3/20/1996,17,0,17,21,55
3/21/1996,19,0,24,34,77
3/22/1996,21,0,19,19,59
3/23/1996,21,0,13,17,51
3/24/1996,28,0,16,18,62
3/25/1996,23,0,21,25,69
3/26/1996,23,0,23,10,56
3/27/1996,20,0,15,20,55
3/28/1996,27,0,28,16,71
3/29/1996,25,0,27,8,60
3/30/1996,29,0,21,21,71
3/31/1996,28,0,19,18,65
4/1/1996,23,0,15,10,48
4/2/1996,25,0,21,12,58
4/3/1996,28,0,18,26,72
4/4/1996,26,0,17,14,57
4/5/1996,28,0,20,21,69
4/6/1996,35,0,30,26,91
4/7/1996,23,0,29,23,75
4/8/1996,26,0,30,26,82
4/9/1996,26,0,19,19,64
4/10/1996,16,0,17,28,61
4/11/1996,19,0,17,22,58
4/12/1996,20,0,26,12,58
4/13/1996,27,0,20,15,62
4/14/1996,20,0,16,12,48
4/15/1996,22,0,15,21,58
4/16/1996,14,0,27,11,52
4/17/1996,28,0,27,21,76
4/18/1996,22,0,14,25,61
4/19/1996,17,0,23,24,64
4/20/1996,20,0,29,19,68
4/21/1996,29,0,16,31,76
4/22/1996,28,0,15,18,61
4/23/1996,22,0,23,15,60
4/24/1996,29,0,28,31,88
4/25/1996,23,0,20,22,65
4/26/1996,27,0,21,7,55
4/27/1996,32,0,15,12,59
4/28/1996,22,0,23,21,66
4/29/1996,21,0,13,17,51
4/30/1996,18,0,21,12,51
5/1/1996,23,0,20,11,54
5/2/1996,26,0,19,12,57
5/3/1996,30,0,29,16,75
5/4/1996,13,0,16,21,50
5/5/1996,20,0,26,9,55
5/6/1996,18,0,24,15,57
5/7/1996,17,0,19,12,48
5/8/1996,18,0,14,15,47
5/9/1996,23,0,17,21,61
5/10/1996,17,0,21,19,57
5/11/1996,33,0,22,17,72
5/12/1996,28,0,12,29,69
5/13/1996,24,0,24,24,72
5/14/1996,21,0,20,32,73
5/15/1996,24,0,24,32,80
5/16/1996,21,0,19,22,62
5/17/1996,22,0,17,6,45
5/18/1996,28,0,26,22,76
5/19/1996,24,0,11,17,52
5/20/1996,23,0,14,28,65
5/21/1996,28,0,13,8,49
5/22/1996,25,0,27,8,60
5/23/1996,34,0,16,20,70
5/24/1996,18,0,23,22,63
5/25/1996,22,0,20,18,60
5/26/1996,15,0,19,16,50
5/27/1996,30,0,25,26,81
5/28/1996,31,0,17,11,59
5/29/1996,17,0,21,14,52
5/30/1996,21,0,22,12,55
5/31/1996,19,0,28,21,68
6/1/1996,25,0,29,27,81
6/2/1996,27,0,17,21,65
6/3/1996,23,0,29,21,73
6/4/1996,26,0,27,18,71
6/5/1996,19,0,25,9,53
6/6/1996,29,0,23,9,61
6/7/1996,30,0,13,13,56
6/8/1996,19,0,19,27,65
6/9/1996,26,0,22,19,67
6/10/1996,26,0,24,7,57
6/11/1996,27,0,25,18,70
6/12/1996,32,0,21,28,81
6/13/1996,29,0,17,24,70
6/14/1996,16,0,22,17,55
6/15/1996,25,0,21,28,74
6/16/1996,25,0,23,22,70
6/17/1996,24,0,26,28,78
6/18/1996,18,0,11,22,51
6/19/1996,23,0,23,25,71
6/20/1996,14,0,29,12,55
6/21/1996,22,0,21,23,66
6/22/1996,19,0,24,16,59
6/23/1996,30,0,28,19,77
6/24/1996,22,0,19,10,51
6/25/1996,19,0,11,24,54
6/26/1996,14,0,21,18,53
6/27/1996,25,0,26,13,64
6/28/1996,19,0,22,25,66
6/29/1996,18,0,28,5,51
6/30/1996,19,0,13,25,57
7/1/1996,18,0,17,12,47
7/2/1996,17,0,16,17,50
7/3/1996,18,0,18,27,63
7/4/1996,22,0,23,31,76
7/5/1996,21,0,17,23,61
7/6/1996,31,0,24,21,76
7/7/1996,25,0,17,21,63
7/8/1996,25,0,17,22,64
7/9/1996,35,0,20,10,65
7/10/1996,20,0,17,20,57
7/11/1996,17,0,16,22,55
7/12/1996,21,0,26,27,74
7/13/1996,11,0,27,24,62
7/14/1996,25,0,24,7,56
7/15/1996,27,0,24,13,64
7/16/1996,21,0,16,18,55
7/17/1996,25,0,19,11,55
7/18/1996,13,0,18,17,48
7/19/1996,28,0,24,11,63
7/20/1996,21,0,21,25,67
7/21/1996,19,0,17,20,56
7/22/1996,24,0,26,21,71
7/23/1996,27,0,15,21,63
7/24/1996,29,0,13,17,59
7/25/1996,23,0,26,22,71
7/26/1996,19,0,20,11,50
7/27/1996,24,0,30,22,76
7/28/1996,29,0,19,14,62
7/29/1996,21,0,15,13,49
7/30/1996,22,0,15,12,49
7/31/1996,17,0,10,20,47
8/1/1996,25,0,11,19,55
8/2/1996,23,0,26,25,74
8/3/1996,15,0,17,7,39
8/4/1996,12,0,27,22,61
8/5/1996,21,0,27,9,57
8/6/1996,20,0,23,9,52
8/7/1996,28,0,18,17,63
8/8/1996,33,0,28,36,97
8/9/1996,23,0,18,26,67
8/10/1996,26,0,19,12,57
8/11/1996,24,0,18,27,69
8/12/1996,27,0,17,21,65
8/13/1996,15,0,19,26,60
8/14/1996,32,0,22,12,66
8/15/1996,21,0,31,25,77
8/16/1996,31,0,17,27,75
8/17/1996,17,0,14,18,49
8/18/1996,24,0,23,29,76
8/19/1996,32,0,23,9,64
8/20/1996,17,0,23,15,55
8/21/1996,19,0,18,14,51
8/22/1996,27,0,14,35,76
8/23/1996,34,0,19,27,80
8/24/1996,17,0,19,16,52
8/25/1996,23,0,13,21,57
8/26/1996,13,0,25,15,53
8/27/1996,25,0,25,11,61
8/28/1996,29,0,18,21,68
8/29/1996,28,0,30,14,72
8/30/1996,22,0,22,22,66
8/31/1996,32,0,23,25,80
9/1/1996,28,0,9,20,57
9/2/1996,26,0,27,30,83
9/3/1996,32,0,22,25,79
9/4/1996,28,0,20,17,65
9/5/1996,18,0,16,18,52
9/6/1996,19,0,13,16,48
9/7/1996,24,0,20,28,72
9/8/1996,24,0,19,19,62
9/9/1996,15,0,19,15,49
9/10/1996,26,0,17,19,62
9/11/1996,24,0,17,30,71
9/12/1996,21,0,20,17,58
9/13/1996,27,0,20,13,60
9/14/1996,26,0,22,15,63
9/15/1996,14,0,20,16,50
9/16/1996,21,0,19,23,63
9/17/1996,33,0,11,25,69
9/18/1996,17,0,17,22,56
9/19/1996,20,0,14,23,57
9/20/1996,31,0,27,26,84
9/21/1996,22,0,23,15,60
9/22/1996,19,0,25,17,61
9/23/1996,13,0,22,23,58
9/24/1996,31,0,22,15,68
9/25/1996,23,0,7,25,55
9/26/1996,21,0,15,29,65
9/27/1996,26,0,27,14,67
9/28/1996,25,0,22,25,72
9/29/1996,30,0,29,7,66
9/30/1996,16,0,28,11,55
10/1/1996,17,0,20,21,58
10/2/1996,35,0,29,24,88
10/3/1996,22,0,11,35,68
10/4/1996,28,0,21,19,68
10/5/1996,26,0,27,29,82
10/6/1996,29,0,22,9,60
10/7/1996,19,0,22,19,60
10/8/1996,18,0,22,19,59
10/9/1996,17,0,34,26,77
10/10/1996,16,0,22,31,69
10/11/1996,28,0,19,10,57
10/12/1996,25,0,21,9,55
10/13/1996,21,0,25,9,55
10/14/1996,31,0,22,11,64
10/15/1996,19,0,14,31,64
10/16/1996,17,0,29,15,61
10/17/1996,24,0,16,20,60
10/18/1996,25,0,26,17,68
10/19/1996,24,0,23,16,63
10/20/1996,19,0,22,8,49
10/21/1996,22,0,23,12,57
10/22/1996,29,0,25,8,62
10/23/1996,19,0,24,8,51
10/24/1996,24,0,13,23,60
10/25/1996,30,0,21,13,64
10/26/1996,35,0,17,18,70
10/27/1996,19,0,14,15,48
10/28/1996,17,0,29,25,71
10/29/1996,24,0,22,12,58
10/30/1996,27,0,24,14,65
10/31/1996,22,0,19,24,65
11/1/1996,21,0,15,23,59
11/2/1996,17,0,31,17,65
11/3/1996,22,0,15,5,42
11/4/1996,13,0,16,26,55
11/5/1996,30,0,21,26,77
11/6/1996,29,0,25,16,70
11/7/1996,15,0,27,22,64
11/8/1996,11,0,31,3,45
11/9/1996,14,0,22,0,36
11/10/1996,17,0,21,5,43
11/11/1996,22,0,13,4,39
11/12/1996,25,0,18,22,65
11/13/1996,25,0,16,16,57
11/14/1996,27,0,17,29,73
11/15/1996,17,0,27,28,72
11/16/1996,30,0,23,28,81
11/17/1996,18,0,13,20,51
11/18/1996,17,0,24,16,57
11/19/1996,30,0,21,31,82
11/20/1996,29,0,12,18,59
11/21/1996,20,0,23,12,55
11/22/1996,19,0,28,28,75
11/23/1996,25,0,28,29,82
11/24/1996,28,0,19,25,72
11/25/1996,20,0,11,27,58
11/26/1996,13,0,21,15,49
11/27/1996,22,0,23,12,57
11/28/1996,16,0,27,12,55
11/29/1996,18,0,15,25,58
11/30/1996,31,0,18,11,60
12/1/1996,18,0,23,16,57
12/2/1996,25,0,27,15,67
12/3/1996,24,0,24,12,60
12/4/1996,14,0,10,11,35
12/5/1996,24,0,14,22,60
12/6/1996,17,0,19,20,56
12/7/1996,13,0,25,7,45
12/8/1996,28,0,17,20,65
12/9/1996,29,0,19,20,68
12/10/1996,20,0,25,35,80
12/11/1996,23,0,20,31,74
12/12/1996,11,0,19,23,53
12/13/1996,22,0,22,3,47
12/14/1996,17,0,11,32,60
12/15/1996,25,0,14,24,63
12/16/1996,19,0,17,20,56
12/17/1996,17,0,17,24,58
12/18/1996,18,0,14,25,57
12/19/1996,24,0,22,20,66
12/20/1996,27,0,15,18,60
12/21/1996,30,0,18,20,68
12/22/1996,22,0,27,25,74
12/23/1996,22,0,24,31,77
12/24/1996,18,0,25,16,59
12/25/1996,18,0,15,26,59
12/26/1996,32,0,20,26,78
12/27/1996,19,0,16,21,56
12/28/1996,18,0,11,12,41
12/29/1996,31,0,14,20,65
12/30/1996,25,0,16,29,70
12/31/1996,24,0,22,29,75
1/1/1997,17,0,17,24,58
1/2/1997,20,0,22,25,67
1/3/1997,15,0,21,3,39
1/4/1997,25,0,23,31,79
1/5/1997,18,0,22,20,60
1/6/1997,21,0,18,26,65
1/7/1997,16,0,27,29,72
1/8/1997,27,0,20,24,71
1/9/1997,26,0,20,25,71
1/10/1997,25,0,27,19,71
1/11/1997,30,0,27,6,63
1/12/1997,24,0,12,23,59
1/13/1997,29,0,21,18,68
1/14/1997,17,0,25,24,66
1/15/1997,28,0,9,11,48
1/16/1997,31,0,17,9,57
1/17/1997,25,0,25,26,76
1/18/1997,10,0,17,13,40
1/19/1997,31,0,32,22,85
1/20/1997,26,0,17,17,60
1/21/1997,29,0,27,16,72
1/22/1997,31,0,17,11,59
1/23/1997,27,0,14,32,73
1/24/1997,16,0,28,16,60
1/25/1997,21,0,23,25,69
1/26/1997,26,0,26,27,79
1/27/1997,20,0,15,9,44
1/28/1997,26,0,20,31,77
1/29/1997,22,0,21,28,71
1/30/1997,21,0,15,20,56
1/31/1997,17,0,11,16,44
2/1/1997,21,0,23,20,64
2/2/1997,19,0,13,24,56
2/3/1997,22,0,14,30,66
2/4/1997,26,0,24,27,77
2/5/1997,27,0,15,14,56
2/6/1997,22,0,29,27,78
2/7/1997,16,0,10,14,40
2/8/1997,26,0,12,24,62
2/9/1997,16,0,22,31,69
2/10/1997,35,0,17,27,79
2/11/1997,23,0,23,23,69
2/12/1997,18,0,12,21,51
2/13/1997,19,0,11,27,57
2/14/1997,13,0,21,31,65
2/15/1997,21,0,16,12,49
2/16/1997,34,0,19,31,84
2/17/1997,17,0,20,31,68
2/18/1997,29,0,24,25,78
2/19/1997,23,0,12,28,63
2/20/1997,29,0,23,34,86
2/21/1997,21,0,10,15,46
2/22/1997,29,0,21,4,54
2/23/1997,27,0,21,21,69
2/24/1997,20,0,23,23,66
2/25/1997,26,0,24,29,79
2/26/1997,26,0,18,25,69
2/27/1997,20,0,26,21,67
2/28/1997,18,0,18,19,55
3/1/1997,25,0,19,24,68
3/2/1997,34,0,9,19,62
3/3/1997,23,0,18,26,67
3/4/1997,24,0,18,14,56
3/5/1997,17,0,24,15,56
3/6/1997,21,0,19,4,44
3/7/1997,19,0,34,32,85
3/8/1997,28,0,23,17,68
3/9/1997,32,0,20,19,71
3/10/1997,19,0,22,37,78
3/11/1997,19,0,20,20,59
3/12/1997,23,0,19,17,59
3/13/1997,18,0,21,23,62
3/14/1997,20,0,24,20,64
3/15/1997,15,0,21,25,61
3/16/1997,15,0,21,20,56
3/17/1997,31,0,23,19,73
3/18/1997,25,0,17,17,59
3/19/1997,19,0,18,14,51
3/20/1997,19,0,26,17,62
3/21/1997,30,0,21,20,71
3/22/1997,18,0,28,21,67
3/23/1997,21,0,30,22,73
3/24/1997,19,0,26,26,71
3/25/1997,27,0,12,22,61
3/26/1997,25,0,25,11,61
3/27/1997,20,0,23,21,64
3/28/1997,26,0,15,18,59
3/29/1997,19,0,15,11,45
3/30/1997,24,0,17,22,63
3/31/1997,25,0,22,33,80
4/1/1997,22,0,15,19,56
4/2/1997,21,0,21,25,67
4/3/1997,25,0,18,29,72
4/4/1997,24,0,18,17,59
4/5/1997,20,0,30,32,82
4/6/1997,21,0,11,30,62
4/7/1997,22,0,20,31,73
4/8/1997,25,0,18,25,68
4/9/1997,22,0,29,15,66
4/10/1997,25,0,25,7,57
4/11/1997,31,0,16,14,61
4/12/1997,29,0,16,23,68
4/13/1997,19,0,13,18,50
4/14/1997,26,0,32,16,74
4/15/1997,27,0,23,17,67
4/16/1997,16,0,18,14,48
4/17/1997,27,0,22,9,58
4/18/1997,25,0,19,18,62
4/19/1997,18,0,18,17,53
4/20/1997,22,0,23,28,73
4/21/1997,22,0,28,28,78
4/22/1997,21,0,19,20,60
4/23/1997,24,0,17,17,58
4/24/1997,26,0,19,25,70
4/25/1997,18,0,22,27,67
4/26/1997,18,0,25,18,61
4/27/1997,20,0,15,7,42
4/28/1997,19,0,25,15,59
4/29/1997,30,0,19,21,70
4/30/1997,17,0,22,28,67
5/1/1997,10,0,28,9,47
5/2/1997,21,0,12,7,40
5/3/1997,33,0,20,22,75
5/4/1997,25,0,21,15,61
5/5/1997,26,0,26,30,82
5/6/1997,26,0,11,19,56
5/7/1997,19,0,27,24,70
5/8/1997,15,0,14,18,47
5/9/1997,25,0,21,21,67
5/10/1997,15,0,16,8,39
5/11/1997,18,0,23,11,52
5/12/1997,27,0,23,21,71
5/13/1997,28,0,23,14,65
5/14/1997,29,0,23,27,79
5/15/1997,26,0,15,13,54
5/16/1997,27,0,23,7,57
5/17/1997,26,0,15,29,70
5/18/1997,21,0,22,33,76
5/19/1997,22,0,18,15,55
5/20/1997,28,0,18,16,62
5/21/1997,30,0,27,34,91
5/22/1997,15,0,26,27,68
5/23/1997,14,0,30,17,61
5/24/1997,17,0,22,12,51
5/25/1997,17,0,26,24,67
5/26/1997,13,0,20,17,50
5/27/1997,26,0,11,16,53
5/28/1997,29,0,20,37,86
5/29/1997,19,0,14,16,49
5/30/1997,19,0,27,22,68
5/31/1997,20,0,22,19,61
6/1/1997,24,0,25,38,87
6/2/1997,18,0,16,17,51
6/3/1997,25,0,9,17,51
6/4/1997,20,0,23,13,56
6/5/1997,18,0,19,20,57
6/6/1997,18,0,21,13,52
6/7/1997,35,0,27,25,87
6/8/1997,32,0,23,21,76
6/9/1997,26,0,13,22,61
6/10/1997,20,0,23,29,72
6/11/1997,25,0,19,25,69
6/12/1997,17,0,12,27,56
6/13/1997,20,0,17,5,42
6/14/1997,15,0,10,21,46
6/15/1997,27,0,16,26,69
6/16/1997,20,0,21,23,64
6/17/1997,13,0,18,16,47
6/18/1997,26,0,14,22,62
6/19/1997,20,0,23,30,73
6/20/1997,23,0,12,13,48
6/21/1997,21,0,27,20,68
6/22/1997,27,0,27,29,83
6/23/1997,22,0,27,30,79
6/24/1997,29,0,24,29,82
6/25/1997,30,0,21,20,71
6/26/1997,21,0,21,3,45
6/27/1997,24,0,20,11,55
6/28/1997,18,0,17,25,60
6/29/1997,25,0,20,19,64
6/30/1997,28,0,18,29,75
7/1/1997,18,0,18,17,53
7/2/1997,15,0,22,12,49
7/3/1997,30,0,24,19,73
7/4/1997,27,0,14,10,51
7/5/1997,10,0,16,10,36
7/6/1997,23,0,28,12,63
7/7/1997,25,0,14,23,62
7/8/1997,16,0,20,15,51
7/9/1997,22,0,19,12,53
7/10/1997,34,0,12,28,74
7/11/1997,26,0,20,7,53
7/12/1997,19,0,30,7,56
7/13/1997,15,0,15,24,54
7/14/1997,23,0,15,17,55
7/15/1997,27,0,24,7,58
7/16/1997,25,0,28,30,83
7/17/1997,26,0,13,19,58
7/18/1997,20,0,25,18,63
7/19/1997,26,0,22,19,67
7/20/1997,14,0,19,15,48
7/21/1997,16,0,29,22,67
7/22/1997,21,0,19,20,60
7/23/1997,24,0,19,16,59
7/24/1997,29,0,19,28,76
7/25/1997,19,0,30,5,54
7/26/1997,28,0,30,22,80
7/27/1997,27,0,30,17,74
7/28/1997,17,0,18,5,40
7/29/1997,24,0,23,11,58
7/30/1997,23,0,13,5,41
7/31/1997,26,0,23,16,65
8/1/1997,21,0,16,22,59
8/2/1997,16,0,26,22,64
8/3/1997,15,0,17,23,55
8/4/1997,21,0,13,25,59
8/5/1997,16,0,19,22,57
8/6/1997,25,0,24,10,59
8/7/1997,28,0,19,11,58
8/8/1997,32,0,27,31,90
8/9/1997,27,0,16,14,57
8/10/1997,33,0,27,16,76
8/11/1997,28,0,29,3,60
8/12/1997,27,0,14,35,76
8/13/1997,24,0,21,11,56
8/14/1997,28,0,28,29,85
8/15/1997,29,0,16,11,56
8/16/1997,14,0,23,17,54
8/17/1997,23,0,19,28,70
8/18/1997,32,0,23,28,83
8/19/1997,21,0,14,20,55
8/20/1997,21,0,13,13,47
8/21/1997,21,0,20,24,65
8/22/1997,22,0,13,18,53
8/23/1997,23,0,12,15,50
8/24/1997,14,0,26,28,68
8/25/1997,25,0,24,10,59
8/26/1997,27,0,15,22,64
8/27/1997,12,0,12,15,39
8/28/1997,21,0,15,24,60
8/29/1997,21,0,14,23,58
8/30/1997,31,0,21,32,84
8/31/1997,29,0,15,10,54
9/1/1997,14,0,24,11,49
9/2/1997,24,0,24,12,60
9/3/1997,27,0,33,16,76
9/4/1997,30,0,29,29,88
9/5/1997,26,0,22,21,69
9/6/1997,16,0,32,20,68
9/7/1997,25,0,24,16,65
9/8/1997,22,0,24,20,66
9/9/1997,17,0,17,18,52
9/10/1997,23,0,22,15,60
9/11/1997,24,0,13,15,52
9/12/1997,25,0,18,22,65
9/13/1997,21,0,14,16,51
9/14/1997,30,0,29,11,70
9/15/1997,30,0,12,35,77
9/16/1997,27,0,18,16,61
9/17/1997,21,0,23,19,63
9/18/1997,23,0,23,22,68
9/19/1997,26,0,14,15,55
9/20/1997,18,0,16,27,61
9/21/1997,23,0,14,18,55
9/22/1997,25,0,30,17,72
9/23/1997,31,0,18,35,84
9/24/1997,25,0,10,20,55
9/25/1997,22,0,22,22,66
9/26/1997,27,0,24,21,72
9/27/1997,25,0,22,4,51
9/28/1997,30,0,24,31,85
9/29/1997,20,0,18,27,65
9/30/1997,23,0,26,19,68
10/1/1997,16,0,20,24,60
10/2/1997,20,0,21,21,62
10/3/1997,25,0,27,13,65
10/4/1997,30,0,16,24,70
10/5/1997,18,0,19,28,65
10/6/1997,14,0,26,19,59
10/7/1997,30,0,24,30,84
10/8/1997,27,0,23,28,78
10/9/1997,23,0,28,24,75
10/10/1997,24,0,21,21,66
10/11/1997,19,0,28,17,64
10/12/1997,25,0,13,20,58
10/13/1997,26,0,18,32,76
10/14/1997,18,0,26,13,57
10/15/1997,24,0,23,8,55
10/16/1997,21,0,27,29,77
10/17/1997,15,0,18,15,48
10/18/1997,31,0,28,24,83
10/19/1997,22,0,30,14,66
10/20/1997,20,0,25,32,77
10/21/1997,31,0,18,18,67
10/22/1997,17,0,17,19,53
10/23/1997,24,0,15,32,71
10/24/1997,34,0,23,17,74
10/25/1997,24,0,13,27,64
10/26/1997,25,0,20,24,69
10/27/1997,21,0,29,16,66
10/28/1997,25,0,14,22,61
10/29/1997,28,0,17,9,54
10/30/1997,27,0,18,25,70
10/31/1997,22,0,11,14,47
11/1/1997,23,0,17,27,67
11/2/1997,19,0,24,23,66
11/3/1997,22,0,24,29,75
11/4/1997,26,0,19,11,56
11/5/1997,18,0,20,30,68
11/6/1997,24,0,21,18,63
11/7/1997,20,0,28,21,69
11/8/1997,24,0,15,25,64
11/9/1997,17,0,19,15,51
11/10/1997,23,0,13,15,51
11/11/1997,29,0,21,27,77
11/12/1997,16,0,23,18,57
11/13/1997,30,0,17,30,77
11/14/1997,28,0,28,20,76
11/15/1997,18,0,8,5,31
11/16/1997,19,0,15,27,61
11/17/1997,20,0,21,34,75
11/18/1997,22,0,12,9,43
11/19/1997,20,0,21,20,61
11/20/1997,19,0,25,19,63
11/21/1997,28,0,21,12,61
11/22/1997,23,0,23,29,75
11/23/1997,27,0,23,15,65
11/24/1997,16,0,13,32,61
11/25/1997,28,0,17,17,62
11/26/1997,16,0,18,16,50
11/27/1997,32,0,22,19,73
11/28/1997,20,0,20,31,71
11/29/1997,29,0,23,21,73
11/30/1997,26,0,21,23,70
12/1/1997,29,0,20,17,66
12/2/1997,30,0,27,24,81
12/3/1997,23,0,18,35,76
12/4/1997,29,0,18,28,75
12/5/1997,21,0,18,25,64
12/6/1997,25,0,17,15,57
12/7/1997,19,0,23,28,70
12/8/1997,11,0,8,9,28
12/9/1997,20,0,20,24,64
12/10/1997,31,0,13,24,68
12/11/1997,19,0,15,30,64
12/12/1997,21,0,22,25,68
12/13/1997,23,0,22,16,61
12/14/1997,30,0,24,11,65
12/15/1997,32,0,21,19,72
12/16/1997,25,0,28,29,82
12/17/1997,28,0,18,17,63
12/18/1997,25,0,22,18,65
12/19/1997,21,0,18,16,55
12/20/1997,23,0,12,11,46
12/21/1997,22,0,24,23,69
12/22/1997,12,0,29,26,67
12/23/1997,13,0,22,18,53
12/24/1997,18,0,26,21,65
12/25/1997,27,0,20,16,63
12/26/1997,25,0,22,30,77
12/27/1997,21,0,24,15,60
12/28/1997,24,0,16,9,49
12/29/1997,21,0,23,17,61
12/30/1997,21,0,28,11,60
12/31/1997,18,0,13,34,65
1/1/1998,32,0,20,14,66
1/2/1998,23,0,30,20,73
1/3/1998,28,0,26,20,74
1/4/1998,23,0,31,14,68
1/5/1998,28,0,16,22,66
1/6/1998,19,0,25,27,71
1/7/1998,27,0,20,26,73
1/8/1998,14,0,24,27,65
1/9/1998,20,0,15,13,48
1/10/1998,28,0,24,19,71
1/11/1998,22,0,21,18,61
1/12/1998,27,0,14,29,70
1/13/1998,22,0,28,36,86
1/14/1998,25,0,19,12,56
1/15/1998,24,0,19,18,61
1/16/1998,21,0,20,24,65
1/17/1998,21,0,22,18,61
1/18/1998,15,0,30,28,73
1/19/1998,18,0,13,36,67
1/20/1998,33,0,29,24,86
1/21/1998,23,0,27,9,59
1/22/1998,12,0,8,22,42
1/23/1998,17,0,26,14,57
1/24/1998,20,0,27,21,68
1/25/1998,22,0,22,25,69
1/26/1998,30,0,19,19,68
1/27/1998,20,0,18,16,54
1/28/1998,19,0,17,10,46
1/29/1998,22,0,16,11,49
1/30/1998,22,0,20,25,67
1/31/1998,20,0,13,17,50
2/1/1998,13,0,25,30,68
2/2/1998,18,0,14,17,49
2/3/1998,27,0,28,27,82
2/4/1998,14,0,21,17,52
2/5/1998,26,0,23,18,67
2/6/1998,20,0,13,11,44
2/7/1998,24,0,28,20,72
2/8/1998,24,0,17,16,57
2/9/1998,22,0,11,19,52
2/10/1998,21,0,24,18,63
2/11/1998,24,0,21,23,68
2/12/1998,24,0,21,28,73
2/13/1998,17,0,24,23,64
2/14/1998,12,0,25,19,56
2/15/1998,18,0,12,17,47
2/16/1998,26,0,11,9,46
2/17/1998,31,0,19,32,82
2/18/1998,18,0,31,27,76
2/19/1998,29,0,26,19,74
2/20/1998,26,0,24,28,78
2/21/1998,11,0,17,21,49
2/22/1998,29,0,15,29,73
2/23/1998,25,0,29,9,63
2/24/1998,19,0,24,16,59
2/25/1998,23,0,17,6,46
2/26/1998,34,0,21,12,67
2/27/1998,29,0,24,33,86
2/28/1998,27,0,24,12,63
3/1/1998,24,0,27,12,63
3/2/1998,16,0,18,24,58
3/3/1998,26,0,13,32,71
3/4/1998,16,0,22,15,53
3/5/1998,25,0,20,22,67
3/6/1998,19,0,18,6,43
3/7/1998,23,0,26,29,78
3/8/1998,19,0,15,17,51
3/9/1998,17,0,17,25,59
3/10/1998,18,0,21,21,60
3/11/1998,20,0,14,31,65
3/12/1998,19,0,16,21,56
3/13/1998,18,0,21,9,48
3/14/1998,20,0,12,13,45
3/15/1998,17,0,26,23,66
3/16/1998,20,0,25,27,72
3/17/1998,26,0,26,25,77
3/18/1998,25,0,18,23,66
3/19/1998,25,0,12,20,57
3/20/1998,21,0,27,35,83
3/21/1998,27,0,26,20,73
3/22/1998,26,0,12,15,53
3/23/1998,21,0,19,19,59
3/24/1998,26,0,24,16,66
3/25/1998,24,0,19,20,63
3/26/1998,25,0,14,21,60
3/27/1998,23,0,24,16,63
3/28/1998,24,0,25,17,66
3/29/1998,24,0,30,28,82
3/30/1998,32,0,9,23,64
3/31/1998,26,0,17,23,66
4/1/1998,23,0,9,14,46
4/2/1998,28,0,11,14,53
4/3/1998,24,0,15,20,59
4/4/1998,18,0,15,16,49
4/5/1998,20,0,6,16,42
4/6/1998,21,0,31,19,71
4/7/1998,17,0,21,20,58
4/8/1998,11,0,19,24,54
4/9/1998,24,0,14,23,61
4/10/1998,31,0,23,19,73
4/11/1998,19,0,13,27,59
4/12/1998,29,0,22,16,67
4/13/1998,22,0,22,7,51
4/14/1998,33,0,10,19,62
4/15/1998,35,0,18,24,77
4/16/1998,20,0,25,9,54
4/17/1998,21,0,14,24,59
4/18/1998,22,0,19,15,56
4/19/1998,18,0,22,22,62
4/20/1998,26,0,17,19,62
4/21/1998,22,0,19,33,74
4/22/1998,26,0,26,30,82
4/23/1998,24,0,30,22,76
4/24/1998,28,0,20,15,63
4/25/1998,34,0,12,18,64
4/26/1998,15,0,11,20,46
4/27/1998,24,0,22,9,55
4/28/1998,27,0,17,28,72
4/29/1998,23,0,20,17,60
4/30/1998,19,0,33,10,62
5/1/1998,25,0,18,26,69
5/2/1998,26,0,22,19,67
5/3/1998,27,0,24,7,58
5/4/1998,30,0,26,14,70
5/5/1998,22,0,19,9,50
5/6/1998,30,0,24,16,70
5/7/1998,18,0,26,37,81
5/8/1998,29,0,13,33,75
5/9/1998,29,0,23,24,76
5/10/1998,27,0,19,19,65
5/11/1998,15,0,24,25,64
5/12/1998,28,0,23,23,74
5/13/1998,20,0,18,25,63
5/14/1998,27,0,22,26,75
5/15/1998,23,0,26,27,76
5/16/1998,31,0,25,23,79
5/17/1998,27,0,21,25,73
5/18/1998,23,0,26,30,79
5/19/1998,24,0,21,18,63
5/20/1998,19,0,24,30,73
5/21/1998,18,0,20,6,44
5/22/1998,29,0,12,14,55
5/23/1998,29,0,19,23,71
5/24/1998,15,0,25,16,56
5/25/1998,28,0,16,10,54
5/26/1998,23,0,24,23,70
5/27/1998,28,0,25,13,66
5/28/1998,18,0,14,12,44
5/29/1998,24,0,18,12,54
5/30/1998,31,0,24,30,85
5/31/1998,30,0,10,20,60
6/1/1998,24,0,28,18,70
6/2/1998,28,0,20,34,82
6/3/1998,20,0,21,22,63
6/4/1998,28,0,23,12,63
6/5/1998,17,0,20,22,59
6/6/1998,26,0,22,15,63
6/7/1998,18,0,17,22,57
6/8/1998,26,0,15,21,62
6/9/1998,19,0,22,28,69
6/10/1998,21,0,15,21,57
6/11/1998,25,0,15,9,49
6/12/1998,20,0,29,27,76
6/13/1998,26,0,17,14,57
6/14/1998,21,0,9,23,53
6/15/1998,23,0,11,27,61
6/16/1998,17,0,22,16,55
6/17/1998,30,0,22,21,73
6/18/1998,25,0,19,22,66
6/19/1998,29,0,21,25,75
6/20/1998,15,0,25,27,67
6/21/1998,22,0,16,17,55
6/22/1998,16,0,15,17,48
6/23/1998,18,0,10,17,45
6/24/1998,20,0,23,25,68
6/25/1998,30,0,18,21,69
6/26/1998,29,0,22,26,77
6/27/1998,29,0,20,25,74
6/28/1998,20,0,22,20,62
6/29/1998,27,0,26,25,78
6/30/1998,18,0,26,18,62
7/1/1998,17,0,13,18,48
7/2/1998,21,0,18,32,71
7/3/1998,28,0,24,20,72
7/4/1998,22,0,11,5,38
7/5/1998,23,0,26,9,58
7/6/1998,26,0,17,30,73
7/7/1998,29,0,16,23,68
7/8/1998,21,0,25,21,67
7/9/1998,34,0,16,20,70
7/10/1998,29,0,22,27,78
7/11/1998,22,0,14,31,67
7/12/1998,33,0,17,22,72
7/13/1998,19,0,23,31,73
7/14/1998,24,0,12,14,50
7/15/1998,28,0,21,3,52
7/16/1998,21,0,18,23,62
7/17/1998,18,0,30,20,68
7/18/1998,28,0,13,27,68
7/19/1998,16,0,21,20,57
7/20/1998,30,0,15,19,64
7/21/1998,20,0,25,19,64
7/22/1998,24,0,18,20,62
7/23/1998,25,0,30,3,58
7/24/1998,25,0,25,31,81
7/25/1998,22,0,14,24,60
7/26/1998,19,0,8,25,52
7/27/1998,22,0,19,14,55
7/28/1998,26,0,13,15,54
7/29/1998,23,0,14,12,49
7/30/1998,25,0,18,24,67
7/31/1998,34,0,14,11,59
8/1/1998,21,0,12,30,63
8/2/1998,30,0,24,11,65
8/3/1998,18,0,21,31,70
8/4/1998,19,0,17,26,62
8/5/1998,26,0,23,19,68
8/6/1998,22,0,15,10,47
8/7/1998,19,0,10,15,44
8/8/1998,25,0,22,23,70
8/9/1998,22,0,25,18,65
8/10/1998,20,0,19,27,66
8/11/1998,17,0,16,22,55
8/12/1998,28,0,12,24,64
8/13/1998,29,0,22,21,72
8/14/1998,15,0,18,24,57
8/15/1998,19,0,17,25,61
8/16/1998,19,0,13,17,49
8/17/1998,28,0,10,10,48
8/18/1998,14,0,15,11,40
8/19/1998,22,0,8,18,48
8/20/1998,20,0,25,28,73
8/21/1998,33,0,30,21,84
8/22/1998,16,0,18,20,54
8/23/1998,20,0,22,14,56
8/24/1998,21,0,21,28,70
8/25/1998,21,0,32,14,67
8/26/1998,18,0,17,28,63
8/27/1998,24,0,15,25,64
8/28/1998,27,0,15,12,54
8/29/1998,26,0,21,20,67
8/30/1998,15,0,11,22,48
8/31/1998,21,0,27,21,69
9/1/1998,16,0,30,13,59
9/2/1998,24,0,24,18,66
9/3/1998,24,0,21,21,66
9/4/1998,19,0,15,33,67
9/5/1998,18,0,17,11,46
9/6/1998,23,0,19,19,61
9/7/1998,26,0,24,29,79
9/8/1998,20,0,8,28,56
9/9/1998,24,0,19,29,72
9/10/1998,20,0,11,21,52
9/11/1998,24,0,15,20,59
9/12/1998,26,0,19,26,71
9/13/1998,30,0,18,17,65
9/14/1998,21,0,28,15,64
9/15/1998,24,0,15,17,56
9/16/1998,18,0,17,11,46
9/17/1998,27,0,15,19,61
9/18/1998,22,0,18,28,68
9/19/1998,26,0,24,9,59
9/20/1998,22,0,12,22,56
9/21/1998,31,0,19,15,65
9/22/1998,30,0,28,28,86
9/23/1998,25,0,17,11,53
9/24/1998,16,0,18,15,49
9/25/1998,11,0,14,29,54
9/26/1998,22,0,17,15,54
9/27/1998,24,0,23,22,69
9/28/1998,24,0,23,28,75
9/29/1998,19,0,21,27,67
9/30/1998,28,0,15,27,70
10/1/1998,28,0,16,18,62
10/2/1998,23,0,22,16,61
10/3/1998,32,0,19,26,77
10/4/1998,20,0,25,14,59
10/5/1998,24,0,18,18,60
10/6/1998,21,0,16,19,56
10/7/1998,20,0,17,12,49
10/8/1998,30,0,26,17,73
10/9/1998,27,0,27,16,70
10/10/1998,25,0,12,26,63
10/11/1998,31,0,20,24,75
10/12/1998,20,0,25,23,68
10/13/1998,17,0,23,18,58
10/14/1998,20,0,22,18,60
10/15/1998,24,0,26,10,60
10/16/1998,15,0,14,15,44
10/17/1998,24,0,21,22,67
10/18/1998,17,0,21,20,58
10/19/1998,21,0,17,19,57
10/20/1998,23,0,21,19,63
10/21/1998,21,0,29,20,70
10/22/1998,21,0,20,22,63
10/23/1998,27,0,26,25,78
10/24/1998,24,0,23,17,64
10/25/1998,26,0,8,12,46
10/26/1998,28,0,18,7,53
10/27/1998,17,0,10,8,35
10/28/1998,28,0,16,35,79
10/29/1998,27,0,22,18,67
10/30/1998,19,0,15,26,60
10/31/1998,29,0,28,14,71
11/1/1998,20,0,25,34,79
11/2/1998,19,0,14,28,61
11/3/1998,18,0,25,14,57
11/4/1998,16,0,12,19,47
11/5/1998,25,0,21,10,56
11/6/1998,17,0,21,13,51
11/7/1998,28,0,17,24,69
11/8/1998,27,0,21,13,61
11/9/1998,23,0,24,23,70
11/10/1998,22,0,17,19,58
11/11/1998,24,0,27,19,70
11/12/1998,26,0,18,25,69
11/13/1998,24,0,29,26,79
11/14/1998,22,0,11,21,54
11/15/1998,21,0,13,15,49
11/16/1998,31,0,24,37,92
11/17/1998,15,0,17,17,49
11/18/1998,16,0,20,23,59
11/19/1998,25,0,14,23,62
11/20/1998,28,0,26,24,78
11/21/1998,19,0,19,24,62
11/22/1998,29,0,15,29,73
11/23/1998,26,0,15,20,61
11/24/1998,22,0,12,22,56
11/25/1998,25,0,25,15,65
11/26/1998,28,0,28,22,78
11/27/1998,15,0,16,20,51
11/28/1998,25,0,23,10,58
11/29/1998,27,0,22,17,66
11/30/1998,18,0,18,27,63
12/1/1998,26,0,19,18,63
12/2/1998,25,0,18,22,65
12/3/1998,28,0,24,26,78
12/4/1998,32,0,17,14,63
12/5/1998,26,0,16,30,72
12/6/1998,32,0,25,18,75
12/7/1998,24,0,13,17,54
12/8/1998,13,0,11,5,29
12/9/1998,22,0,15,4,41
12/10/1998,17,0,23,22,62
12/11/1998,16,0,21,13,50
12/12/1998,18,0,26,19,63
12/13/1998,22,0,12,25,59
12/14/1998,20,0,11,31,62
12/15/1998,27,0,11,14,52
12/16/1998,29,0,28,16,73
12/17/1998,27,0,25,20,72
12/18/1998,22,0,12,11,45
12/19/1998,18,0,18,17,53
12/20/1998,18,0,16,25,59
12/21/1998,26,0,21,26,73
12/22/1998,16,0,26,22,64
12/23/1998,21,0,14,31,66
12/24/1998,19,0,18,31,68
12/25/1998,28,0,16,28,72
12/26/1998,30,0,12,24,66
12/27/1998,26,0,24,20,70
12/28/1998,27,0,28,20,75
12/29/1998,20,0,16,32,68
12/30/1998,24,0,27,17,68
12/31/1998,18,0,22,32,72
1/1/1999,21,0,15,25,61
1/2/1999,14,0,22,20,56
1/3/1999,28,0,30,19,77
1/4/1999,20,0,22,27,69
1/5/1999,23,0,20,14,57
1/6/1999,26,0,22,38,86
1/7/1999,23,0,20,17,60
1/8/1999,26,0,10,22,58
1/9/1999,31,0,12,27,70
1/10/1999,26,0,17,20,63
1/11/1999,14,0,12,31,57
1/12/1999,27,0,21,22,70
1/13/1999,21,0,16,35,72
1/14/1999,23,0,19,25,67
1/15/1999,30,0,15,23,68
1/16/1999,14,0,12,15,41
1/17/1999,26,0,18,14,58
1/18/1999,26,0,21,25,72
1/19/1999,22,0,17,20,59
1/20/1999,25,0,17,14,56
1/21/1999,14,0,21,6,41
1/22/1999,15,0,18,11,44
1/23/1999,24,0,21,26,71
1/24/1999,28,0,15,12,55
1/25/1999,23,0,15,20,58
1/26/1999,25,0,16,23,64
1/27/1999,20,0,14,22,56
1/28/1999,19,0,23,12,54
1/29/1999,27,0,21,16,64
1/30/1999,27,0,24,22,73
1/31/1999,23,0,14,20,57
2/1/1999,23,0,20,7,50
2/2/1999,25,0,16,20,61
2/3/1999,25,0,15,12,52
2/4/1999,23,0,31,14,68
2/5/1999,14,0,22,34,70
2/6/1999,23,0,16,11,50
2/7/1999,14,0,30,15,59
2/8/1999,20,0,20,26,66
2/9/1999,22,0,31,24,77
2/10/1999,18,0,23,32,73
2/11/1999,19,0,31,22,72
2/12/1999,17,0,21,19,57
2/13/1999,25,0,11,16,52
2/14/1999,25,0,15,22,62
2/15/1999,15,0,12,25,52
2/16/1999,23,0,21,12,56
2/17/1999,23,0,25,20,68
2/18/1999,29,0,13,14,56
2/19/1999,18,0,19,17,54
2/20/1999,18,0,25,26,69
2/21/1999,22,0,20,25,67
2/22/1999,31,0,19,10,60
2/23/1999,26,0,25,19,70
2/24/1999,25,0,16,27,68
2/25/1999,25,0,28,17,70
2/26/1999,32,0,16,19,67
2/27/1999,19,0,31,22,72
2/28/1999,24,0,24,17,65
3/1/1999,27,0,16,27,70
3/2/1999,26,0,23,16,65
3/3/1999,24,0,19,25,68
3/4/1999,27,0,11,20,58
3/5/1999,16,0,27,21,64
3/6/1999,23,0,21,12,56
3/7/1999,26,0,14,21,61
3/8/1999,27,0,23,21,71
3/9/1999,22,0,15,16,53
3/10/1999,20,0,15,15,50
3/11/1999,17,0,15,22,54
3/12/1999,13,0,22,18,53
3/13/1999,26,0,24,24,74
3/14/1999,22,0,24,17,63
3/15/1999,19,0,27,12,58
3/16/1999,32,0,20,21,73
3/17/1999,14,0,22,23,59
3/18/1999,23,0,14,23,60
3/19/1999,27,0,16,27,70
3/20/1999,21,0,18,22,61
3/21/1999,21,0,27,14,62
3/22/1999,26,0,10,11,47
3/23/1999,22,0,16,19,57
3/24/1999,19,0,25,24,68
3/25/1999,29,0,25,15,69
3/26/1999,23,0,25,17,65
3/27/1999,23,0,17,29,69
3/28/1999,28,0,25,35,88
3/29/1999,31,0,22,23,76
3/30/1999,25,0,22,15,62
3/31/1999,15,0,15,17,47
4/1/1999,20,0,9,25,54
4/2/1999,32,0,29,24,85
4/3/1999,22,0,20,14,56
4/4/1999,19,0,18,18,55
4/5/1999,22,0,22,29,73
4/6/1999,25,0,29,17,71
4/7/1999,20,0,32,13,65
4/8/1999,31,0,14,16,61
4/9/1999,22,0,8,17,47
4/10/1999,17,0,26,34,77
4/11/1999,23,0,12,30,65
4/12/1999,21,0,14,32,67
4/13/1999,21,0,19,19,59
4/14/1999,25,0,26,21,72
4/15/1999,27,0,19,14,60
4/16/1999,21,0,22,30,73
4/17/1999,13,0,31,21,65
4/18/1999,28,0,21,24,73
4/19/1999,20,0,18,27,65
4/20/1999,25,0,14,12,51
4/21/1999,24,0,17,10,51
4/22/1999,24,0,27,14,65
4/23/1999,16,0,21,25,62
4/24/1999,24,0,15,18,57
4/25/1999,24,0,26,28,78
4/26/1999,23,0,12,20,55
4/27/1999,25,0,23,25,73
4/28/1999,24,0,15,25,64
4/29/1999,28,0,15,23,66
4/30/1999,22,0,12,24,58
5/1/1999,21,0,23,1,45
5/2/1999,21,0,28,16,65
5/3/1999,14,0,25,9,48
5/4/1999,21,0,31,28,80
5/5/1999,19,0,14,17,50
5/6/1999,27,0,16,23,66
5/7/1999,28,0,24,20,72
5/8/1999,30,0,26,14,70
5/9/1999,24,0,26,19,69
5/10/1999,17,0,23,14,54
5/11/1999,15,0,27,15,57
5/12/1999,12,0,23,19,54
5/13/1999,21,0,15,12,48
5/14/1999,24,0,15,11,50
5/15/1999,16,0,31,8,55
5/16/1999,29,0,17,11,57
5/17/1999,23,0,13,17,53
5/18/1999,25,0,15,26,66
5/19/1999,24,0,26,30,80
5/20/1999,23,0,17,29,69
5/21/1999,11,0,17,10,38
5/22/1999,20,0,16,29,65
5/23/1999,24,0,17,16,57
5/24/1999,30,0,27,17,74
5/25/1999,28,0,24,22,74
5/26/1999,20,0,18,22,60
5/27/1999,25,0,19,13,57
5/28/1999,22,0,24,19,65
5/29/1999,27,0,31,27,85
5/30/1999,15,0,13,14,42
5/31/1999,26,0,21,11,58
6/1/1999,16,0,18,16,50
6/2/1999,13,0,21,19,53
6/3/1999,19,0,27,23,69
6/4/1999,25,0,17,17,59
6/5/1999,24,0,16,9,49
6/6/1999,16,0,17,26,59
6/7/1999,30,0,17,16,63
6/8/1999,22,0,33,32,87
6/9/1999,28,0,18,20,66
6/10/1999,22,0,11,28,61
6/11/1999,22,0,13,25,60
6/12/1999,25,0,30,13,68
6/13/1999,26,0,17,27,70
6/14/1999,24,0,16,26,66
6/15/1999,29,0,11,28,68
6/16/1999,11,0,24,23,58
6/17/1999,31,0,10,22,63
6/18/1999,21,0,17,18,56
6/19/1999,31,0,15,23,69
6/20/1999,20,0,22,22,64
6/21/1999,14,0,20,16,50
6/22/1999,15,0,21,16,52
6/23/1999,10,0,12,12,34
6/24/1999,17,0,19,18,54
6/25/1999,21,0,21,24,66
6/26/1999,25,0,7,4,36
6/27/1999,13,0,18,23,54
6/28/1999,18,0,28,17,63
6/29/1999,29,0,25,25,79
6/30/1999,29,0,17,15,61
7/1/1999,22,0,21,28,71
7/2/1999,33,0,26,16,75
7/3/1999,30,0,20,16,66
7/4/1999,31,0,19,14,64
7/5/1999,24,0,32,19,75
7/6/1999,20,0,12,17,49
7/7/1999,31,0,21,25,77
7/8/1999,18,0,22,29,69
7/9/1999,26,0,20,26,72
7/10/1999,16,0,19,16,51
7/11/1999,23,0,22,27,72
7/12/1999,23,0,22,25,70
7/13/1999,30,0,22,26,78
7/14/1999,23,0,18,21,62
7/15/1999,28,0,23,29,80
7/16/1999,29,0,13,15,57
7/17/1999,20,0,26,17,63
7/18/1999,26,0,19,28,73
7/19/1999,25,0,19,18,62
7/20/1999,18,0,15,20,53
7/21/1999,17,0,29,20,66
7/22/1999,17,0,22,30,69
7/23/1999,23,0,23,21,67
7/24/1999,16,0,19,29,64
7/25/1999,28,0,17,13,58
7/26/1999,16,0,17,9,42
7/27/1999,25,0,28,18,71
7/28/1999,28,0,12,27,67
7/29/1999,23,0,24,16,63
7/30/1999,15,0,26,19,60
7/31/1999,21,0,20,35,76
8/1/1999,21,0,32,21,74
8/2/1999,23,0,16,29,68
8/3/1999,21,0,19,16,56
8/4/1999,19,0,20,17,56
8/5/1999,16,0,22,28,66
8/6/1999,14,0,25,25,64
8/7/1999,16,0,23,19,58
8/8/1999,27,0,20,25,72
8/9/1999,15,0,17,11,43
8/10/1999,36,0,21,19,76
8/11/1999,29,0,11,9,49
8/12/1999,23,0,14,25,62
8/13/1999,28,0,19,30,77
8/14/1999,21,0,19,31,71
8/15/1999,21,0,13,31,65
8/16/1999,26,0,23,22,71
8/17/1999,31,0,20,25,76
8/18/1999,24,0,19,30,73
8/19/1999,26,0,26,26,78
8/20/1999,17,0,22,6,45
8/21/1999,29,0,20,10,59
8/22/1999,17,0,13,31,61
8/23/1999,19,0,12,30,61
8/24/1999,23,0,22,17,62
8/25/1999,22,0,23,29,74
8/26/1999,34,0,13,19,66
8/27/1999,21,0,27,7,55
8/28/1999,30,0,13,15,58
8/29/1999,23,0,16,10,49
8/30/1999,18,0,18,16,52
8/31/1999,22,0,26,24,72
9/1/1999,28,0,14,30,72
9/2/1999,17,0,16,13,46
9/3/1999,22,0,23,20,65
9/4/1999,22,0,15,6,43
9/5/1999,18,0,17,20,55
9/6/1999,15,0,21,10,46
9/7/1999,13,0,24,18,55
9/8/1999,24,0,22,25,71
9/9/1999,22,0,25,17,64
9/10/1999,27,0,16,13,56
9/11/1999,28,0,24,17,69
9/12/1999,21,0,9,21,51
9/13/1999,31,0,26,33,90
9/14/1999,22,0,22,20,64
9/15/1999,20,0,17,18,55
9/16/1999,27,0,9,20,56
9/17/1999,23,0,16,35,74
9/18/1999,28,0,26,22,76
9/19/1999,25,0,22,15,62
9/20/1999,20,0,19,14,53
9/21/1999,29,0,19,28,76
9/22/1999,22,0,23,26,71
9/23/1999,26,0,26,17,69
9/24/1999,23,0,28,27,78
9/25/1999,30,0,8,18,56
9/26/1999,19,0,26,16,61
9/27/1999,25,0,19,16,60
9/28/1999,29,0,19,33,81
9/29/1999,15,0,13,21,49
9/30/1999,23,0,19,16,58
10/1/1999,34,0,23,19,76
10/2/1999,26,0,18,18,62
10/3/1999,20,0,21,16,57
10/4/1999,28,0,13,13,54
10/5/1999,19,0,11,37,67
10/6/1999,29,0,17,19,65
10/7/1999,25,0,20,13,58
10/8/1999,32,0,19,24,75
10/9/1999,25,0,18,4,47
10/10/1999,30,0,11,30,71
10/11/1999,28,0,14,12,54
10/12/1999,28,0,15,26,69
10/13/1999,23,0,11,21,55
10/14/1999,16,0,14,19,49
10/15/1999,19,0,20,22,61
10/16/1999,23,0,14,19,56
10/17/1999,29,0,16,10,55
10/18/1999,18,0,34,26,78
10/19/1999,18,0,15,17,50
10/20/1999,28,0,23,22,73
10/21/1999,30,0,14,14,58
10/22/1999,29,0,23,12,64
10/23/1999,25,0,19,17,61
10/24/1999,23,0,32,28,83
10/25/1999,26,0,23,11,60
10/26/1999,27,0,18,24,69
10/27/1999,20,0,22,18,60
10/28/1999,29,0,18,19,66
10/29/1999,26,0,24,12,62
10/30/1999,21,0,16,9,46
10/31/1999,24,0,18,33,75
11/1/1999,18,0,23,30,71
11/2/1999,30,0,19,16,65
11/3/1999,32,0,20,17,69
11/4/1999,19,0,21,11,51
11/5/1999,27,0,25,22,74
11/6/1999,30,0,28,7,65
11/7/1999,17,0,17,12,46
11/8/1999,13,0,24,21,58
11/9/1999,25,0,25,18,68
11/10/1999,24,0,29,19,72
11/11/1999,16,0,10,2,28
11/12/1999,18,0,22,19,59
11/13/1999,32,0,16,18,66
11/14/1999,16,0,17,17,50
11/15/1999,23,0,22,31,76
11/16/1999,31,0,22,22,75
11/17/1999,24,0,23,13,60
11/18/1999,23,0,19,15,57
11/19/1999,22,0,18,23,63
11/20/1999,24,0,24,26,74
11/21/1999,26,0,20,18,64
11/22/1999,17,0,20,26,63
11/23/1999,29,0,24,21,74
11/24/1999,30,0,18,17,65
11/25/1999,20,0,20,19,59
11/26/1999,24,0,19,18,61
11/27/1999,17,0,21,31,69
11/28/1999,22,0,29,19,70
11/29/1999,20,0,10,14,44
11/30/1999,19,0,23,20,62
12/1/1999,20,0,20,16,56
12/2/1999,16,0,12,18,46
12/3/1999,28,0,20,24,72
12/4/1999,26,0,26,20,72
12/5/1999,18,0,18,23,59
12/6/1999,27,0,18,17,62
12/7/1999,22,0,19,20,61
12/8/1999,27,0,21,16,64
12/9/1999,25,0,22,18,65
12/10/1999,20,0,17,11,48
12/11/1999,31,0,13,15,59
12/12/1999,24,0,22,5,51
12/13/1999,25,0,24,16,65
12/14/1999,26,0,11,26,63
12/15/1999,24,0,21,27,72
12/16/1999,10,0,31,9,50
12/17/1999,19,0,21,19,59
12/18/1999,25,0,28,30,83
12/19/1999,25,0,20,15,60
12/20/1999,25,0,17,23,65
12/21/1999,22,0,17,23,62
12/22/1999,24,0,24,13,61
12/23/1999,19,0,26,16,61
12/24/1999,24,0,17,30,71
12/25/1999,22,0,22,22,66
12/26/1999,21,0,15,20,56
12/27/1999,34,0,23,19,76
12/28/1999,18,0,18,22,58
12/29/1999,19,0,22,22,63
12/30/1999,32,0,20,16,68
12/31/1999,22,0,27,15,64
1/1/2000,25,0,22,13,60
1/2/2000,29,0,31,17,77
1/3/2000,30,0,27,14,71
1/4/2000,22,0,25,25,72
1/5/2000,13,0,14,28,55
1/6/2000,17,0,22,34,73
1/7/2000,15,0,14,24,53
1/8/2000,25,0,13,29,67
1/9/2000,19,0,24,23,66
1/10/2000,23,0,12,16,51
1/11/2000,28,0,23,15,66
1/12/2000,30,0,11,27,68
1/13/2000,21,0,23,19,63
1/14/2000,23,0,25,26,74
1/15/2000,23,0,12,12,47
1/16/2000,29,0,32,16,77
1/17/2000,11,0,17,19,47
1/18/2000,33,0,21,14,68
1/19/2000,18,0,17,28,63
1/20/2000,22,0,20,24,66
1/21/2000,19,0,17,18,54
1/22/2000,22,0,13,25,60
1/23/2000,23,0,28,3,54
1/24/2000,21,0,16,28,65
1/25/2000,26,0,21,29,76
1/26/2000,25,0,13,30,68
1/27/2000,20,0,14,25,59
1/28/2000,29,0,16,36,81
1/29/2000,28,0,26,21,75
1/30/2000,24,0,17,30,71
1/31/2000,22,0,17,25,64
2/1/2000,35,0,32,20,87
2/2/2000,22,0,26,21,69
2/3/2000,18,0,14,13,45
2/4/2000,20,0,13,12,45
2/5/2000,23,0,21,3,47
2/6/2000,24,0,17,4,45
2/7/2000,23,0,13,29,65
2/8/2000,14,0,19,5,38
2/9/2000,27,0,23,12,62
2/10/2000,23,0,24,21,68
2/11/2000,23,0,18,26,67
2/12/2000,25,0,24,16,65
2/13/2000,20,0,24,11,55
2/14/2000,19,0,17,13,49
2/15/2000,20,0,23,25,68
2/16/2000,27,0,18,9,54
2/17/2000,15,0,19,12,46
2/18/2000,23,0,23,27,73
2/19/2000,19,0,26,23,68
2/20/2000,21,0,21,30,72
2/21/2000,25,0,16,19,60
2/22/2000,30,0,18,23,71
2/23/2000,13,0,25,32,70
2/24/2000,23,0,26,24,73
2/25/2000,29,0,22,21,72
2/26/2000,23,0,27,16,66
2/27/2000,33,0,19,23,75
2/28/2000,22,0,21,21,64
2/29/2000,24,0,11,14,49
3/1/2000,29,0,14,12,55
3/2/2000,20,0,28,10,58
3/3/2000,29,0,16,13,58
3/4/2000,16,0,24,32,72
3/5/2000,21,0,19,21,61
3/6/2000,19,0,14,32,65
3/7/2000,26,0,27,27,80
3/8/2000,27,0,30,9,66
3/9/2000,24,0,22,22,68
3/10/2000,22,0,15,23,60
3/11/2000,17,0,26,31,74
3/12/2000,26,0,29,25,80
3/13/2000,18,0,23,24,65
3/14/2000,26,0,23,11,60
3/15/2000,22,0,21,15,58
3/16/2000,23,0,19,27,69
3/17/2000,21,0,31,30,82
3/18/2000,17,0,20,20,57
3/19/2000,16,0,9,27,52
3/20/2000,24,0,13,20,57
3/21/2000,23,0,19,17,59
3/22/2000,27,0,18,24,69
3/23/2000,26,0,33,27,86
3/24/2000,23,0,21,24,68
3/25/2000,20,0,17,26,63
3/26/2000,14,0,24,23,61
3/27/2000,30,0,16,25,71
3/28/2000,28,0,20,24,72
3/29/2000,33,0,12,11,56
3/30/2000,21,0,11,32,64
3/31/2000,26,0,25,23,74
4/1/2000,25,0,20,23,68
4/2/2000,17,0,10,21,48
4/3/2000,24,0,22,11,57
4/4/2000,20,0,21,16,57
4/5/2000,28,0,20,32,80
4/6/2000,25,0,18,17,60
4/7/2000,28,0,16,13,57
4/8/2000,26,0,16,12,54
4/9/2000,15,0,17,28,60
4/10/2000,24,0,26,30,80
4/11/2000,17,0,20,15,52
4/12/2000,27,0,11,14,52
4/13/2000,20,0,16,31,67
4/14/2000,22,0,22,8,52
4/15/2000,23,0,25,10,58
4/16/2000,30,0,26,26,82
4/17/2000,30,0,20,27,77
4/18/2000,26,0,22,24,72
4/19/2000,18,0,17,27,62
4/20/2000,22,0,21,18,61
4/21/2000,31,0,20,30,81
4/22/2000,24,0,15,17,56
4/23/2000,26,0,28,25,79
4/24/2000,32,0,23,22,77
4/25/2000,22,0,20,23,65
4/26/2000,27,0,6,33,66
4/27/2000,23,0,17,21,61
4/28/2000,26,0,13,24,63
4/29/2000,15,0,19,21,55
4/30/2000,22,0,17,11,50
5/1/2000,14,0,29,19,62
5/2/2000,19,0,29,17,65
5/3/2000,20,0,14,21,55
5/4/2000,17,0,20,22,59
5/5/2000,22,0,17,16,55
5/6/2000,18,0,28,15,61
5/7/2000,17,0,24,27,68
5/8/2000,24,0,17,28,69
5/9/2000,23,0,21,16,60
5/10/2000,26,0,11,14,51
5/11/2000,25,0,18,9,52
5/12/2000,20,0,21,19,60
5/13/2000,21,0,23,30,74
5/14/2000,16,0,14,19,49
5/15/2000,24,0,17,30,71
5/16/2000,27,0,29,9,65
5/17/2000,19,0,11,20,50
5/18/2000,23,0,25,2,50
5/19/2000,22,0,19,18,59
5/20/2000,23,0,21,10,54
5/21/2000,20,0,20,30,70
5/22/2000,19,0,13,21,53
5/23/2000,29,0,21,11,61
5/24/2000,25,0,15,20,60
5/25/2000,17,0,25,27,69
5/26/2000,24,0,15,10,49
5/27/2000,20,0,32,23,75
5/28/2000,20,0,14,26,60
5/29/2000,25,0,17,19,61
5/30/2000,19,0,19,22,60
5/31/2000,27,0,13,16,56
6/1/2000,28,0,30,30,88
6/2/2000,25,0,24,26,75
6/3/2000,30,0,18,25,73
6/4/2000,19,0,21,16,56
6/5/2000,27,0,12,17,56
6/6/2000,24,0,14,4,42
6/7/2000,22,0,25,14,61
6/8/2000,19,0,26,12,57
6/9/2000,22,0,10,29,61
6/10/2000,20,0,31,16,67
6/11/2000,23,0,25,26,74
6/12/2000,24,0,26,14,64
6/13/2000,27,0,14,26,67
6/14/2000,25,0,26,19,70
6/15/2000,22,0,13,18,53
6/16/2000,23,0,18,9,50
6/17/2000,13,0,21,16,50
6/18/2000,25,0,27,16,68
6/19/2000,31,0,13,11,55
6/20/2000,30,0,16,16,62
6/21/2000,28,0,18,24,70
6/22/2000,18,0,24,16,58
6/23/2000,25,0,17,32,74
6/24/2000,25,0,28,30,83
6/25/2000,14,0,26,7,47
6/26/2000,21,0,32,18,71
6/27/2000,18,0,24,15,57
6/28/2000,30,0,14,27,71
6/29/2000,20,0,25,7,52
6/30/2000,30,0,17,21,68
7/1/2000,18,0,16,23,57
7/2/2000,33,0,20,13,66
7/3/2000,14,0,28,25,67
7/4/2000,14,0,27,17,58
7/5/2000,24,0,26,21,71
7/6/2000,24,0,10,15,49
7/7/2000,22,0,13,10,45
7/8/2000,22,0,25,5,52
7/9/2000,26,0,20,21,67
7/10/2000,30,0,18,20,68
7/11/2000,29,0,22,34,85
7/12/2000,23,0,14,18,55
7/13/2000,24,0,13,21,58
7/14/2000,29,0,21,22,72
7/15/2000,24,0,17,16,57
7/16/2000,34,0,28,23,85
7/17/2000,29,0,16,24,69
7/18/2000,24,0,30,12,66
7/19/2000,30,0,26,18,74
7/20/2000,20,0,21,17,58
7/21/2000,22,0,33,28,83
7/22/2000,17,0,23,22,62
7/23/2000,17,0,23,28,68
7/24/2000,28,0,22,23,73
7/25/2000,17,0,23,25,65
7/26/2000,32,0,18,27,77
7/27/2000,27,0,18,20,65
7/28/2000,21,0,15,25,61
7/29/2000,27,0,24,32,83
7/30/2000,25,0,21,18,64
7/31/2000,20,0,26,14,60
8/1/2000,26,0,25,18,69
8/2/2000,11,0,18,9,38
8/3/2000,26,0,19,28,73
8/4/2000,24,0,17,31,72
8/5/2000,23,0,9,27,59
8/6/2000,25,0,20,3,48
8/7/2000,34,0,18,26,78
8/8/2000,28,0,20,11,59
8/9/2000,28,0,22,15,65
8/10/2000,19,0,23,34,76
8/11/2000,24,0,7,28,59
8/12/2000,19,0,30,17,66
8/13/2000,26,0,23,31,80
8/14/2000,26,0,24,27,77
8/15/2000,24,0,14,11,49
8/16/2000,27,0,17,20,64
8/17/2000,26,0,12,23,61
8/18/2000,29,0,23,14,66
8/19/2000,17,0,29,18,64
8/20/2000,34,0,22,22,78
8/21/2000,26,0,25,28,79
8/22/2000,25,0,17,22,64
8/23/2000,22,0,26,16,64
8/24/2000,15,0,24,26,65
8/25/2000,22,0,10,11,43
8/26/2000,25,0,15,29,69
8/27/2000,15,0,21,12,48
8/28/2000,22,0,23,32,77
8/29/2000,27,0,20,15,62
8/30/2000,25,0,15,5,45
8/31/2000,22,0,19,19,60
9/1/2000,22,0,23,30,75
9/2/2000,28,0,17,26,71
9/3/2000,26,0,15,14,55
9/4/2000,31,0,19,10,60
9/5/2000,26,0,24,18,68
9/6/2000,26,0,25,25,76
9/7/2000,16,0,26,15,57
9/8/2000,18,0,31,16,65
9/9/2000,18,0,17,28,63
9/10/2000,27,0,23,19,69
9/11/2000,19,0,19,32,70
9/12/2000,22,0,20,18,60
9/13/2000,31,0,16,8,55
9/14/2000,24,0,24,25,73
9/15/2000,28,0,9,18,55
9/16/2000,26,0,25,15,66
9/17/2000,19,0,20,26,65
9/18/2000,26,0,27,19,72
9/19/2000,21,0,23,18,62
9/20/2000,25,0,27,7,59
9/21/2000,23,0,16,14,53
9/22/2000,15,0,17,21,53
9/23/2000,15,0,22,20,57
9/24/2000,17,0,18,23,58
9/25/2000,18,0,19,19,56
9/26/2000,20,0,25,26,71
9/27/2000,17,0,17,17,51
9/28/2000,17,0,19,28,64
9/29/2000,22,0,23,11,56
9/30/2000,27,0,20,17,64
10/1/2000,23,0,14,25,62
10/2/2000,28,0,22,37,87
10/3/2000,20,0,26,17,63
10/4/2000,21,0,19,16,56
10/5/2000,27,0,20,10,57
10/6/2000,22,0,17,23,62
10/7/2000,19,0,15,15,49
10/8/2000,18,0,26,26,70
10/9/2000,27,0,15,28,70
10/10/2000,29,0,20,8,57
10/11/2000,22,0,14,18,54
10/12/2000,18,0,19,14,51
10/13/2000,17,0,16,19,52
10/14/2000,20,0,24,16,60
10/15/2000,25,0,13,27,65
10/16/2000,20,0,19,17,56
10/17/2000,21,0,14,25,60
10/18/2000,18,0,27,12,57
10/19/2000,17,0,25,21,63
10/20/2000,16,0,11,12,39
10/21/2000,22,0,21,31,74
10/22/2000,16,0,26,10,52
10/23/2000,28,0,15,21,64
10/24/2000,25,0,14,16,55
10/25/2000,20,0,15,24,59
10/26/2000,24,0,33,23,80
10/27/2000,21,0,23,10,54
10/28/2000,32,0,22,13,67
10/29/2000,21,0,19,21,61
10/30/2000,32,0,23,10,65
10/31/2000,23,0,18,23,64
11/1/2000,18,0,15,16,49
11/2/2000,28,0,19,15,62
11/3/2000,21,0,15,15,51
11/4/2000,15,0,22,31,68
11/5/2000,21,0,12,24,57
11/6/2000,10,0,23,8,41
11/7/2000,26,0,27,24,77
11/8/2000,19,0,24,24,67
11/9/2000,19,0,14,19,52
11/10/2000,21,0,21,17,59
11/11/2000,32,0,25,30,87
11/12/2000,23,0,27,13,63
11/13/2000,22,0,24,19,65
11/14/2000,24,0,24,23,71
11/15/2000,26,0,24,16,66
11/16/2000,20,0,14,26,60
11/17/2000,25,0,18,12,55
11/18/2000,20,0,19,19,58
11/19/2000,20,0,16,14,50
11/20/2000,32,0,24,30,86
11/21/2000,25,0,15,15,55
11/22/2000,25,0,18,26,69
11/23/2000,27,0,19,23,69
11/24/2000,20,0,21,22,63
11/25/2000,23,0,24,10,57
11/26/2000,25,0,17,11,53
11/27/2000,25,0,24,23,72
11/28/2000,21,0,19,8,48
11/29/2000,24,0,15,23,62
11/30/2000,19,0,18,10,47
12/1/2000,21,0,12,17,50
12/2/2000,21,0,27,35,83
12/3/2000,15,0,22,33,70
12/4/2000,24,0,30,7,61
12/5/2000,20,0,23,16,59
12/6/2000,20,0,14,23,57
12/7/2000,26,0,28,18,72
12/8/2000,15,0,28,8,51
12/9/2000,25,0,26,18,69
12/10/2000,24,0,26,25,75
12/11/2000,20,0,12,31,63
12/12/2000,22,0,15,1,38
12/13/2000,21,0,32,15,68
12/14/2000,21,0,24,15,60
12/15/2000,18,0,11,24,53
12/16/2000,16,0,30,22,68
12/17/2000,21,0,19,15,55
12/18/2000,23,0,25,17,65
12/19/2000,24,0,30,5,59
12/20/2000,26,0,27,33,86
12/21/2000,28,0,19,20,67
12/22/2000,26,0,18,10,54
12/23/2000,17,0,21,21,59
12/24/2000,22,0,16,24,62
12/25/2000,24,0,20,20,64
12/26/2000,31,0,21,27,79
12/27/2000,21,0,18,31,70
12/28/2000,28,0,20,17,65
12/29/2000,15,0,31,13,59
12/30/2000,17,0,28,5,50
12/31/2000,16,0,19,30,65
1/1/2001,22,0,26,22,70
1/2/2001,34,0,13,20,67
1/3/2001,24,0,27,31,82
1/4/2001,15,0,28,23,66
1/5/2001,27,0,26,22,75
1/6/2001,16,0,27,22,65
1/7/2001,26,0,17,16,59
1/8/2001,27,0,18,19,64
1/9/2001,19,0,18,30,67
1/10/2001,26,0,19,8,53
1/11/2001,29,0,13,35,77
1/12/2001,18,0,23,36,77
1/13/2001,28,0,26,10,64
1/14/2001,29,0,20,20,69
1/15/2001,12,0,15,18,45
1/16/2001,27,0,27,13,67
1/17/2001,15,0,26,13,54
1/18/2001,18,0,15,9,42
1/19/2001,18,0,20,22,60
1/20/2001,25,0,21,15,61
1/21/2001,19,0,18,6,43
1/22/2001,21,0,19,18,58
1/23/2001,30,0,21,22,73
1/24/2001,31,0,21,32,84
1/25/2001,23,0,11,28,62
1/26/2001,22,0,22,8,52
1/27/2001,12,0,25,27,64
1/28/2001,18,0,17,27,62
1/29/2001,29,0,14,16,59
1/30/2001,26,0,9,32,67
1/31/2001,28,0,17,21,66
2/1/2001,26,0,25,12,63
2/2/2001,23,0,13,30,66
2/3/2001,23,0,20,29,72
2/4/2001,28,0,24,16,68
2/5/2001,29,0,23,8,60
2/6/2001,27,0,17,18,62
2/7/2001,22,0,28,26,76
2/8/2001,29,0,16,16,61
2/9/2001,15,0,24,16,55
2/10/2001,16,0,25,18,59
2/11/2001,24,0,21,17,62
2/12/2001,23,0,17,23,63
2/13/2001,21,0,17,23,61
2/14/2001,17,0,17,15,49
2/15/2001,27,0,16,24,67
2/16/2001,15,0,16,22,53
2/17/2001,22,0,23,25,70
2/18/2001,26,0,14,17,57
2/19/2001,21,0,20,26,67
2/20/2001,20,0,22,28,70
2/21/2001,29,0,25,14,68
2/22/2001,27,0,18,23,68
2/23/2001,11,0,16,7,34
2/24/2001,27,0,13,17,57
2/25/2001,23,0,20,30,73
2/26/2001,19,0,19,22,60
2/27/2001,22,0,17,11,50
2/28/2001,17,0,19,30,66
3/1/2001,21,0,18,13,52
3/2/2001,18,0,27,17,62
3/3/2001,20,0,21,13,54
3/4/2001,15,0,15,27,57
3/5/2001,26,0,27,15,68
3/6/2001,25,0,21,6,52
3/7/2001,24,0,23,28,75
3/8/2001,20,0,25,13,58
3/9/2001,15,0,25,14,54
3/10/2001,32,0,14,19,65
3/11/2001,15,0,14,11,40
3/12/2001,19,0,19,28,66
3/13/2001,21,0,17,31,69
3/14/2001,31,0,12,21,64
3/15/2001,13,0,19,2,34
3/16/2001,17,0,26,31,74
3/17/2001,20,0,18,18,56
3/18/2001,33,0,18,7,58
3/19/2001,21,0,12,26,59
3/20/2001,15,0,12,12,39
3/21/2001,23,0,26,10,59
3/22/2001,24,0,19,20,63
3/23/2001,28,0,27,26,81
3/24/2001,22,0,27,24,73
3/25/2001,21,0,16,26,63
3/26/2001,25,0,12,26,63
3/27/2001,28,0,21,22,71
3/28/2001,22,0,21,38,81
3/29/2001,15,0,21,17,53
3/30/2001,20,0,23,19,62
3/31/2001,24,0,24,11,59
4/1/2001,25,0,16,27,68
4/2/2001,30,0,19,17,66
4/3/2001,20,0,16,19,55
4/4/2001,21,0,23,21,65
4/5/2001,24,0,19,21,64
4/6/2001,22,0,13,20,55
4/7/2001,22,0,23,12,57
4/8/2001,22,0,19,11,52
4/9/2001,14,0,30,13,57
4/10/2001,14,0,16,15,45
4/11/2001,29,0,20,26,75
4/12/2001,25,0,11,22,58
4/13/2001,22,0,13,16,51
4/14/2001,27,0,19,27,73
4/15/2001,34,0,20,34,88
4/16/2001,24,0,17,8,49
4/17/2001,16,0,21,20,57
4/18/2001,22,0,21,31,74
4/19/2001,26,0,13,25,64
4/20/2001,25,0,25,17,67
4/21/2001,22,0,19,9,50
4/22/2001,28,0,19,34,81
4/23/2001,25,0,14,34,73
4/24/2001,14,0,22,15,51
4/25/2001,22,0,14,27,63
4/26/2001,19,0,27,23,69
4/27/2001,29,0,25,14,68
4/28/2001,22,0,22,8,52
4/29/2001,34,0,26,16,76
4/30/2001,20,0,12,16,48
5/1/2001,22,0,25,13,60
5/2/2001,17,0,13,20,50
5/3/2001,28,0,22,22,72
5/4/2001,29,0,16,26,71
5/5/2001,19,0,23,21,63
5/6/2001,24,0,13,15,52
5/7/2001,27,0,23,23,73
5/8/2001,15,0,21,7,43
5/9/2001,19,0,16,14,49
5/10/2001,23,0,16,19,58
5/11/2001,25,0,21,6,52
5/12/2001,28,0,27,21,76
5/13/2001,14,0,26,7,47
5/14/2001,12,0,28,18,58
5/15/2001,20,0,26,30,76
5/16/2001,28,0,14,18,60
5/17/2001,17,0,15,30,62
5/18/2001,17,0,19,14,50
5/19/2001,20,0,11,23,54
5/20/2001,28,0,18,23,69
5/21/2001,26,0,20,15,61
5/22/2001,17,0,26,12,55
5/23/2001,20,0,28,32,80
5/24/2001,19,0,26,21,66
5/25/2001,21,0,11,3,35
5/26/2001,31,0,19,20,70
5/27/2001,21,0,19,24,64
5/28/2001,27,0,23,29,79
5/29/2001,19,0,29,11,59
5/30/2001,27,0,17,20,64
5/31/2001,26,0,19,27,72
6/1/2001,22,0,25,26,73
6/2/2001,29,0,24,23,76
6/3/2001,28,0,24,13,65
6/4/2001,27,0,18,11,56
6/5/2001,20,0,24,20,64
6/6/2001,17,0,24,29,70
6/7/2001,23,0,18,7,48
6/8/2001,13,0,18,11,42
6/9/2001,20,0,23,7,50
6/10/2001,26,0,12,17,55
6/11/2001,17,0,20,35,72
6/12/2001,21,0,21,22,64
6/13/2001,24,0,21,26,71
6/14/2001,16,0,19,22,57
6/15/2001,19,0,18,5,42
6/16/2001,26,0,29,14,69
6/17/2001,17,0,21,12,50
6/18/2001,21,0,17,9,47
6/19/2001,26,0,22,30,78
6/20/2001,19,0,26,12,57
6/21/2001,27,0,24,21,72
6/22/2001,21,0,23,11,55
6/23/2001,32,0,27,24,83
6/24/2001,25,0,23,24,72
6/25/2001,19,0,22,21,62
6/26/2001,31,0,26,29,86
6/27/2001,22,0,27,18,67
6/28/2001,30,0,20,8,58
6/29/2001,27,0,23,21,71
6/30/2001,29,0,21,13,63
7/1/2001,19,0,18,23,60
7/2/2001,28,0,20,21,69
7/3/2001,29,0,21,15,65
7/4/2001,24,0,23,31,78
7/5/2001,18,0,26,31,75
7/6/2001,22,0,21,25,68
7/7/2001,22,0,21,10,53
7/8/2001,21,0,16,26,63
7/9/2001,25,0,31,24,80
7/10/2001,16,0,22,32,70
7/11/2001,31,0,15,20,66
7/12/2001,21,0,25,5,51
7/13/2001,29,0,22,10,61
7/14/2001,29,0,21,21,71
7/15/2001,22,0,28,35,85
7/16/2001,26,0,17,29,72
7/17/2001,20,0,19,26,65
7/18/2001,24,0,16,12,52
7/19/2001,24,0,24,23,71
7/20/2001,15,0,24,8,47
7/21/2001,27,0,9,27,63
7/22/2001,33,0,13,9,55
7/23/2001,17,0,24,17,58
7/24/2001,19,0,20,12,51
7/25/2001,16,0,13,28,57
7/26/2001,21,0,16,16,53
7/27/2001,20,0,16,23,59
7/28/2001,19,0,24,24,67
7/29/2001,24,0,15,21,60
7/30/2001,21,0,27,10,58
7/31/2001,29,0,20,20,69
8/1/2001,30,0,20,15,65
8/2/2001,15,0,26,19,60
8/3/2001,30,0,22,17,69
8/4/2001,35,0,17,18,70
8/5/2001,26,0,13,9,48
8/6/2001,29,0,18,18,65
8/7/2001,18,0,15,19,52
8/8/2001,28,0,12,20,60
8/9/2001,18,0,21,7,46
8/10/2001,18,0,11,24,53
8/11/2001,18,0,24,26,68
8/12/2001,17,0,20,15,52
8/13/2001,26,0,13,24,63
8/14/2001,23,0,27,9,59
8/15/2001,23,0,29,9,61
8/16/2001,16,0,23,16,55
8/17/2001,26,0,20,22,68
8/18/2001,16,0,22,13,51
8/19/2001,30,0,28,11,69
8/20/2001,30,0,29,18,77
8/21/2001,22,0,31,16,69
8/22/2001,22,0,22,13,57
8/23/2001,25,0,16,31,72
8/24/2001,19,0,21,26,66
8/25/2001,19,0,17,23,59
8/26/2001,29,0,19,28,76
8/27/2001,12,0,23,17,52
8/28/2001,21,0,23,21,65
8/29/2001,22,0,16,36,74
8/30/2001,30,0,22,11,63
8/31/2001,16,0,24,21,61
9/1/2001,28,0,33,10,71
9/2/2001,13,0,30,28,71
9/3/2001,21,0,22,27,70
9/4/2001,23,0,25,28,76
9/5/2001,17,0,17,27,61
9/6/2001,30,0,13,6,49
9/7/2001,25,0,34,9,68
9/8/2001,22,0,17,19,58
9/9/2001,17,0,14,21,52
9/10/2001,27,0,32,14,73
9/11/2001,28,0,25,12,65
9/12/2001,22,0,28,37,87
9/13/2001,24,0,16,25,65
9/14/2001,21,0,29,16,66
9/15/2001,20,0,21,17,58
9/16/2001,22,0,19,13,54
9/17/2001,27,0,13,10,50
9/18/2001,21,0,16,15,52
9/19/2001,17,0,25,33,75
9/20/2001,27,0,24,24,75
9/21/2001,18,0,24,10,52
9/22/2001,23,0,22,19,64
9/23/2001,22,0,18,7,47
9/24/2001,16,0,15,21,52
9/25/2001,22,0,13,32,67
9/26/2001,26,0,21,15,62
9/27/2001,29,0,20,23,72
9/28/2001,23,0,15,29,67
9/29/2001,23,0,22,15,60
9/30/2001,26,0,31,22,79
10/1/2001,27,0,24,7,58
10/2/2001,21,0,18,25,64
10/3/2001,18,0,25,13,56
10/4/2001,21,0,14,29,64
10/5/2001,27,0,29,11,67
10/6/2001,20,0,24,16,60
10/7/2001,28,0,11,31,70
10/8/2001,17,0,14,13,44
10/9/2001,26,0,14,24,64
10/10/2001,18,0,23,26,67
10/11/2001,23,0,18,20,61
10/12/2001,21,0,25,17,63
10/13/2001,20,0,21,14,55
10/14/2001,26,0,19,22,67
10/15/2001,33,0,27,24,84
10/16/2001,18,0,18,18,54
10/17/2001,14,0,12,7,33
10/18/2001,19,0,23,15,57
10/19/2001,28,0,20,20,68
10/20/2001,30,0,18,19,67
10/21/2001,22,0,22,17,61
10/22/2001,14,0,13,23,50
10/23/2001,32,0,17,18,67
10/24/2001,20,0,25,28,73
10/25/2001,31,0,16,34,81
10/26/2001,27,0,22,21,70
10/27/2001,18,0,20,23,61
10/28/2001,25,0,22,19,66
10/29/2001,18,0,25,21,64
10/30/2001,21,0,15,17,53
10/31/2001,29,0,24,26,79
11/1/2001,29,0,33,31,93
11/2/2001,29,0,30,22,81
11/3/2001,20,0,13,34,67
11/4/2001,23,0,22,27,72
11/5/2001,25,0,28,30,83
11/6/2001,20,0,13,11,44
11/7/2001,25,0,18,21,64
11/8/2001,22,0,17,24,63
11/9/2001,17,0,22,33,72
11/10/2001,21,0,17,18,56
11/11/2001,19,0,19,20,58
11/12/2001,21,0,15,24,60
11/13/2001,20,0,19,30,69
11/14/2001,24,0,7,14,45
11/15/2001,28,0,20,14,62
11/16/2001,28,0,22,26,76
11/17/2001,19,0,31,22,72
11/18/2001,29,0,20,23,72
11/19/2001,28,0,18,25,71
11/20/2001,23,0,23,25,71
11/21/2001,18,0,16,20,54
11/22/2001,29,0,18,16,63
11/23/2001,27,0,21,33,81
11/24/2001,26,0,30,19,75
11/25/2001,23,0,19,22,64
11/26/2001,21,0,21,26,68
11/27/2001,34,0,20,15,69
11/28/2001,26,0,17,27,70
11/29/2001,16,0,19,13,48
11/30/2001,19,0,23,26,68
12/1/2001,30,0,27,33,90
12/2/2001,26,0,11,12,49
12/3/2001,31,0,26,25,82
12/4/2001,29,0,23,22,74
12/5/2001,26,0,14,24,64
12/6/2001,20,0,23,37,80
12/7/2001,27,0,24,22,73
12/8/2001,17,0,10,12,39
12/9/2001,21,0,17,21,59
12/10/2001,24,0,13,28,65
12/11/2001,20,0,10,23,53
12/12/2001,20,0,30,31,81
12/13/2001,31,0,20,9,60
12/14/2001,23,0,17,17,57
12/15/2001,32,0,25,26,83
12/16/2001,17,0,18,26,61
12/17/2001,23,0,24,8,55
12/18/2001,18,0,18,27,63
12/19/2001,16,0,22,34,72
12/20/2001,19,0,12,27,58
12/21/2001,11,0,25,24,60
12/22/2001,23,0,13,12,48
12/23/2001,21,0,18,30,69
12/24/2001,24,0,17,25,66
12/25/2001,28,0,9,20,57
12/26/2001,25,0,26,10,61
12/27/2001,23,0,20,18,61
12/28/2001,27,0,20,25,72
12/29/2001,28,0,22,29,79
12/30/2001,22,0,12,15,49
12/31/2001,16,0,22,10,48
1/1/2002,22,0,25,30,77
1/2/2002,19,0,24,25,68
1/3/2002,20,0,19,37,76
1/4/2002,24,0,10,22,56
1/5/2002,31,0,18,20,69
1/6/2002,12,0,23,12,47
1/7/2002,12,0,18,4,34
1/8/2002,17,0,21,18,56
1/9/2002,32,0,14,17,63
1/10/2002,13,0,15,34,62
1/11/2002,19,0,26,16,61
1/12/2002,31,0,25,14,70
1/13/2002,26,0,30,5,61
1/14/2002,21,0,13,21,55
1/15/2002,20,0,15,17,52
1/16/2002,16,0,30,23,69
1/17/2002,13,0,19,25,57
1/18/2002,20,0,31,24,75
1/19/2002,27,0,13,10,50
1/20/2002,27,0,17,26,70
1/21/2002,18,0,14,13,45
1/22/2002,26,0,14,30,70
1/23/2002,22,0,13,19,54
1/24/2002,17,0,18,18,53
1/25/2002,24,0,16,15,55
1/26/2002,24,0,23,1,48
1/27/2002,14,0,11,14,39
1/28/2002,27,0,22,26,75
1/29/2002,22,0,22,31,75
1/30/2002,14,0,26,7,47
1/31/2002,26,0,31,24,81
2/1/2002,21,0,20,14,55
2/2/2002,29,0,16,16,61
2/3/2002,22,0,25,16,63
2/4/2002,28,0,15,25,68
2/5/2002,12,0,16,11,39
2/6/2002,30,0,27,15,72
2/7/2002,24,0,33,21,78
2/8/2002,27,0,22,9,58
2/9/2002,23,0,25,32,80
2/10/2002,16,0,25,23,64
2/11/2002,24,0,23,16,63
2/12/2002,24,0,16,16,56
2/13/2002,21,0,27,15,63
2/14/2002,23,0,16,13,52
2/15/2002,24,0,18,36,78
2/16/2002,21,0,17,12,50
2/17/2002,16,0,30,22,68
2/18/2002,20,0,20,24,64
2/19/2002,18,0,12,18,48
2/20/2002,20,0,22,31,73
2/21/2002,17,0,13,28,58
2/22/2002,25,0,15,14,54
2/23/2002,11,0,22,12,45
2/24/2002,20,0,24,20,64
2/25/2002,16,0,24,21,61
2/26/2002,29,0,30,22,81
2/27/2002,20,0,16,27,63
2/28/2002,17,0,14,19,50
3/1/2002,24,0,14,16,54
3/2/2002,29,0,28,24,81
3/3/2002,20,0,23,4,47
3/4/2002,29,0,25,18,72
3/5/2002,26,0,10,22,58
3/6/2002,27,0,20,22,69
3/7/2002,25,0,17,27,69
3/8/2002,23,0,14,25,62
3/9/2002,21,0,16,27,64
3/10/2002,18,0,16,22,56
3/11/2002,22,0,13,19,54
3/12/2002,20,0,23,15,58
3/13/2002,12,0,23,18,53
3/14/2002,15,0,25,23,63
3/15/2002,28,0,18,9,55
3/16/2002,25,0,23,15,63
3/17/2002,22,0,23,5,50
3/18/2002,26,0,19,20,65
3/19/2002,22,0,25,29,76
3/20/2002,22,0,26,24,72
3/21/2002,26,0,18,21,65
3/22/2002,32,0,18,12,62
3/23/2002,21,0,15,21,57
3/24/2002,26,0,13,24,63
3/25/2002,26,0,16,23,65
3/26/2002,23,0,14,11,48
3/27/2002,23,0,27,27,77
3/28/2002,22,0,18,22,62
3/29/2002,17,0,8,28,53
3/30/2002,21,0,16,20,57
3/31/2002,29,0,22,20,71
4/1/2002,26,0,26,17,69
4/2/2002,19,0,18,34,71
4/3/2002,26,0,19,23,68
4/4/2002,25,0,19,21,65
4/5/2002,31,0,19,9,59
4/6/2002,24,0,26,9,59
4/7/2002,32,0,7,18,57
4/8/2002,31,0,23,16,70
4/9/2002,30,0,25,20,75
4/10/2002,29,0,23,25,77
4/11/2002,33,0,25,15,73
4/12/2002,25,0,10,19,54
4/13/2002,21,0,10,26,57
4/14/2002,28,0,20,14,62
4/15/2002,24,0,18,14,56
4/16/2002,24,0,15,22,61
4/17/2002,29,0,26,17,72
4/18/2002,23,0,18,6,47
4/19/2002,26,0,26,18,70
4/20/2002,24,0,22,9,55
4/21/2002,28,0,27,19,74
4/22/2002,34,0,15,29,78
4/23/2002,24,0,9,35,68
4/24/2002,28,0,18,19,65
4/25/2002,27,0,14,28,69
4/26/2002,18,0,14,14,46
4/27/2002,27,0,21,17,65
4/28/2002,18,0,22,26,66
4/29/2002,19,0,19,16,54
4/30/2002,16,0,23,26,65
5/1/2002,20,0,25,29,74
5/2/2002,23,0,16,33,72
5/3/2002,29,0,25,33,87
5/4/2002,25,0,10,21,56
5/5/2002,21,0,23,12,56
5/6/2002,28,0,30,18,76
5/7/2002,23,0,27,14,64
5/8/2002,16,0,24,13,53
5/9/2002,22,0,24,12,58
5/10/2002,17,0,20,31,68
5/11/2002,19,0,22,10,51
5/12/2002,15,0,12,6,33
5/13/2002,36,0,31,15,82
5/14/2002,21,0,27,30,78
5/15/2002,17,0,16,16,49
5/16/2002,17,0,25,18,60
5/17/2002,17,0,31,31,79
5/18/2002,20,0,9,27,56
5/19/2002,15,0,24,28,67
5/20/2002,29,0,17,6,52
5/21/2002,16,0,18,20,54
5/22/2002,22,0,20,17,59
5/23/2002,24,0,14,8,46
5/24/2002,19,0,9,21,49
5/25/2002,17,0,20,14,51
5/26/2002,21,0,22,29,72
5/27/2002,31,0,21,16,68
5/28/2002,22,0,29,17,68
5/29/2002,29,0,27,22,78
5/30/2002,25,0,22,19,66
5/31/2002,20,0,17,34,71
6/1/2002,29,0,18,18,65
6/2/2002,29,0,19,16,64
6/3/2002,24,0,17,11,52
6/4/2002,30,0,14,10,54
6/5/2002,31,0,15,4,50
6/6/2002,26,0,26,13,65
6/7/2002,18,0,16,12,46
6/8/2002,13,0,18,26,57
6/9/2002,15,0,18,20,53
6/10/2002,29,0,21,15,65
6/11/2002,24,0,28,9,61
6/12/2002,18,0,17,24,59
6/13/2002,22,0,18,4,44
6/14/2002,34,0,19,14,67
6/15/2002,14,0,26,18,58
6/16/2002,22,0,18,27,67
6/17/2002,19,0,23,17,59
6/18/2002,30,0,13,36,79
6/19/2002,24,0,21,4,49
6/20/2002,17,0,11,23,51
6/21/2002,27,0,31,12,70
6/22/2002,18,0,12,20,50
6/23/2002,16,0,16,16,48
6/24/2002,18,0,23,19,60
6/25/2002,18,0,18,27,63
6/26/2002,23,0,20,13,56
6/27/2002,19,0,27,18,64
6/28/2002,27,0,26,19,72
6/29/2002,19,0,23,31,73
6/30/2002,27,0,27,25,79
7/1/2002,18,0,25,17,60
7/2/2002,16,0,24,18,58
7/3/2002,25,0,14,23,62
7/4/2002,23,0,16,19,58
7/5/2002,21,0,25,23,69
7/6/2002,25,0,14,23,62
7/7/2002,23,0,23,13,59
7/8/2002,17,0,31,34,82
7/9/2002,23,0,15,25,63
7/10/2002,27,0,29,20,76
7/11/2002,21,0,9,24,54
7/12/2002,23,0,13,10,46
7/13/2002,25,0,16,20,61
7/14/2002,21,0,25,21,67
7/15/2002,28,0,25,16,69
7/16/2002,21,0,19,13,53
7/17/2002,28,0,17,14,59
7/18/2002,27,0,18,24,69
7/19/2002,31,0,14,2,47
7/20/2002,27,0,23,24,74
7/21/2002,32,0,24,19,75
7/22/2002,25,0,14,20,59
7/23/2002,20,0,20,23,63
7/24/2002,27,0,15,19,61
7/25/2002,23,0,21,24,68
7/26/2002,19,0,11,12,42
7/27/2002,21,0,19,9,49
7/28/2002,29,0,16,29,74
7/29/2002,30,0,13,17,60
7/30/2002,25,0,21,11,57
7/31/2002,31,0,14,33,78
8/1/2002,25,0,21,22,68
8/2/2002,27,0,18,1,46
8/3/2002,19,0,26,12,57
8/4/2002,17,0,17,28,62
8/5/2002,30,0,11,17,58
8/6/2002,30,0,20,16,66
8/7/2002,23,0,14,28,65
8/8/2002,27,0,16,16,59
8/9/2002,19,0,21,16,56
8/10/2002,27,0,19,25,71
8/11/2002,23,0,14,19,56
8/12/2002,26,0,25,22,73
8/13/2002,19,0,21,9,49
8/14/2002,21,0,18,22,61
8/15/2002,23,0,12,21,56
8/16/2002,20,0,25,29,74
8/17/2002,17,0,25,19,61
8/18/2002,21,0,14,23,58
8/19/2002,25,0,21,17,63
8/20/2002,15,0,20,7,42
8/21/2002,25,0,16,29,70
8/22/2002,20,0,22,17,59
8/23/2002,28,0,13,24,65
8/24/2002,25,0,23,16,64
8/25/2002,20,0,8,29,57
8/26/2002,18,0,30,24,72
8/27/2002,22,0,15,22,59
8/28/2002,19,0,18,26,63
8/29/2002,35,0,22,24,81
8/30/2002,14,0,26,16,56
8/31/2002,15,0,14,38,67
9/1/2002,16,0,19,20,55
9/2/2002,22,0,22,19,63
9/3/2002,26,0,16,29,71
9/4/2002,26,0,19,15,60
9/5/2002,24,0,21,26,71
9/6/2002,19,0,22,22,63
9/7/2002,20,0,20,13,53
9/8/2002,27,0,18,20,65
9/9/2002,26,0,26,20,72
9/10/2002,20,0,16,21,57
9/11/2002,20,0,8,12,40
9/12/2002,13,0,24,17,54
9/13/2002,27,0,21,5,53
9/14/2002,18,0,18,27,63
9/15/2002,20,0,14,12,46
9/16/2002,16,0,14,25,55
9/17/2002,29,0,23,14,66
9/18/2002,23,0,24,12,59
9/19/2002,21,0,24,29,74
9/20/2002,28,0,31,30,89
9/21/2002,19,0,23,29,71
9/22/2002,19,0,24,10,53
9/23/2002,25,0,16,14,55
9/24/2002,28,0,14,15,57
9/25/2002,26,0,17,22,65
9/26/2002,21,0,24,19,64
9/27/2002,23,0,29,12,64
9/28/2002,23,0,16,26,65
9/29/2002,20,0,26,21,67
9/30/2002,20,0,8,11,39
10/1/2002,19,0,21,27,67
10/2/2002,28,0,17,23,68
10/3/2002,19,0,28,19,66
10/4/2002,10,0,14,5,29
10/5/2002,24,0,26,22,72
10/6/2002,21,0,17,6,44
10/7/2002,23,0,18,10,51
10/8/2002,13,0,15,15,43
10/9/2002,33,0,20,2,55
10/10/2002,19,0,17,18,54
10/11/2002,23,0,27,16,66
10/12/2002,30,0,24,28,82
10/13/2002,18,0,13,34,65
10/14/2002,29,0,12,26,67
10/15/2002,25,0,17,24,66
10/16/2002,20,0,11,19,50
10/17/2002,27,0,23,22,72
10/18/2002,20,0,26,36,82
10/19/2002,19,0,23,18,60
10/20/2002,27,0,20,27,74
10/21/2002,29,0,15,19,63
10/22/2002,34,0,24,22,80
10/23/2002,22,0,13,16,51
10/24/2002,21,0,20,20,61
10/25/2002,25,0,20,19,64
10/26/2002,15,0,14,16,45
10/27/2002,32,0,14,15,61
10/28/2002,25,0,16,8,49
10/29/2002,25,0,19,18,62
10/30/2002,24,0,26,22,72
10/31/2002,21,0,26,22,69
11/1/2002,25,0,13,18,56
11/2/2002,25,0,16,22,63
11/3/2002,25,0,20,4,49
11/4/2002,24,0,20,13,57
11/5/2002,26,0,18,23,67
11/6/2002,25,0,24,6,55
11/7/2002,14,0,24,9,47
11/8/2002,23,0,18,22,63
11/9/2002,18,0,11,24,53
11/10/2002,20,0,17,14,51
11/11/2002,29,0,14,8,51
11/12/2002,23,0,22,12,57
11/13/2002,25,0,21,16,62
11/14/2002,30,0,8,25,63
11/15/2002,35,0,13,15,63
11/16/2002,28,0,21,20,69
11/17/2002,19,0,12,33,64
11/18/2002,15,0,18,19,52
11/19/2002,17,0,22,9,48
11/20/2002,29,0,25,38,92
11/21/2002,16,0,13,17,46
11/22/2002,23,0,23,4,50
11/23/2002,20,0,15,28,63
11/24/2002,30,0,27,25,82
11/25/2002,18,0,25,27,70
11/26/2002,19,0,8,24,51
11/27/2002,22,0,18,28,68
11/28/2002,25,0,16,27,68
11/29/2002,21,0,21,22,64
11/30/2002,23,0,13,31,67
12/1/2002,24,0,20,12,56
12/2/2002,23,0,20,23,66
12/3/2002,24,0,12,14,50
12/4/2002,22,0,25,11,58
12/5/2002,19,0,24,31,74
12/6/2002,32,0,22,19,73
12/7/2002,32,0,27,16,75
12/8/2002,20,0,27,38,85
12/9/2002,31,0,19,26,76
12/10/2002,31,0,26,24,81
12/11/2002,28,0,19,22,69
12/12/2002,18,0,25,21,64
12/13/2002,24,0,20,13,57
12/14/2002,30,0,12,21,63
12/15/2002,19,0,15,25,59
12/16/2002,27,0,20,27,74
12/17/2002,27,0,20,23,70
12/18/2002,18,0,11,18,47
12/19/2002,24,0,12,18,54
12/20/2002,30,0,22,25,77
12/21/2002,26,0,11,9,46
12/22/2002,26,0,27,27,80
12/23/2002,25,0,10,18,53
12/24/2002,15,0,9,13,37
12/25/2002,18,0,25,20,63
12/26/2002,24,0,27,17,68
12/27/2002,27,0,24,16,67
12/28/2002,21,0,23,20,64
12/29/2002,13,0,20,18,51
12/30/2002,28,0,17,24,69
12/31/2002,32,0,11,21,64
1/1/2003,10,0,27,18,55
1/2/2003,27,0,17,23,67
1/3/2003,26,0,20,17,63
1/4/2003,29,0,32,23,84
1/5/2003,26,0,11,23,60
1/6/2003,25,0,20,23,68
1/7/2003,16,0,24,10,50
1/8/2003,22,0,19,23,64
1/9/2003,25,0,24,19,68
1/10/2003,17,0,15,11,43
1/11/2003,15,0,16,16,47
1/12/2003,27,0,20,25,72
1/13/2003,20,0,18,25,63
1/14/2003,22,0,17,13,52
1/15/2003,23,0,23,23,69
1/16/2003,25,0,15,10,50
1/17/2003,24,0,13,23,60
1/18/2003,21,0,27,14,62
1/19/2003,24,0,21,28,73
1/20/2003,18,0,18,36,72
1/21/2003,22,0,8,30,60
1/22/2003,18,0,32,25,75
1/23/2003,29,0,22,28,79
1/24/2003,24,0,23,9,56
1/25/2003,25,0,19,6,50
1/26/2003,20,0,21,27,68
1/27/2003,20,0,16,17,53
1/28/2003,22,0,25,19,66
1/29/2003,17,0,16,26,59
1/30/2003,27,0,26,25,78
1/31/2003,17,0,14,16,47
2/1/2003,13,0,17,21,51
2/2/2003,29,0,23,14,66
2/3/2003,23,0,18,17,58
2/4/2003,20,0,27,31,78
2/5/2003,15,0,22,29,66
2/6/2003,18,0,32,28,78
2/7/2003,26,0,20,15,61
2/8/2003,25,0,19,18,62
2/9/2003,22,0,12,31,65
2/10/2003,31,0,21,13,65
2/11/2003,25,0,26,13,64
2/12/2003,18,0,10,27,55
2/13/2003,13,0,24,15,52
2/14/2003,28,0,22,21,71
2/15/2003,22,0,15,23,60
2/16/2003,28,0,14,17,59
2/17/2003,25,0,30,28,83
2/18/2003,24,0,20,20,64
2/19/2003,31,0,21,29,81
2/20/2003,27,0,20,27,74
2/21/2003,26,0,20,30,76
2/22/2003,22,0,28,18,68
2/23/2003,24,0,28,16,68
2/24/2003,13,0,9,23,45
2/25/2003,20,0,22,17,59
2/26/2003,25,0,28,24,77
2/27/2003,24,0,11,20,55
2/28/2003,32,0,26,17,75
3/1/2003,22,0,10,17,49
3/2/2003,20,0,14,26,60
3/3/2003,23,0,23,21,67
3/4/2003,18,0,13,24,55
3/5/2003,27,0,20,20,67
3/6/2003,18,0,17,6,41
3/7/2003,11,0,34,11,56
3/8/2003,27,0,18,21,66
3/9/2003,22,0,22,20,64
3/10/2003,20,0,16,10,46
3/11/2003,23,0,15,10,48
3/12/2003,31,0,18,24,73
3/13/2003,23,0,20,16,59
3/14/2003,27,0,19,22,68
3/15/2003,19,0,19,22,60
3/16/2003,24,0,30,19,73
3/17/2003,31,0,24,17,72
3/18/2003,21,0,23,26,70
3/19/2003,20,0,20,28,68
3/20/2003,15,0,17,21,53
3/21/2003,30,0,17,9,56
3/22/2003,31,0,18,17,66
3/23/2003,28,0,22,14,64
3/24/2003,29,0,22,28,79
3/25/2003,30,0,17,18,65
3/26/2003,27,0,22,19,68
3/27/2003,17,0,14,28,59
3/28/2003,19,0,12,6,37
3/29/2003,28,0,12,22,62
3/30/2003,19,0,21,20,60
3/31/2003,19,0,16,5,40
4/1/2003,21,0,27,7,55
4/2/2003,34,0,14,16,64
4/3/2003,28,0,22,10,60
4/4/2003,22,0,26,20,68
4/5/2003,10,0,27,3,40
4/6/2003,24,0,28,9,61
4/7/2003,18,0,20,25,63
4/8/2003,22,0,31,8,61
4/9/2003,22,0,18,18,58
4/10/2003,25,0,20,18,63
4/11/2003,22,0,16,27,65
4/12/2003,16,0,23,10,49
4/13/2003,24,0,22,13,59
4/14/2003,29,0,12,35,76
4/15/2003,33,0,29,13,75
4/16/2003,21,0,15,19,55
4/17/2003,31,0,26,10,67
4/18/2003,14,0,21,12,47
4/19/2003,30,0,12,24,66
4/20/2003,22,0,21,22,65
4/21/2003,29,0,19,7,55
4/22/2003,14,0,24,14,52
4/23/2003,16,0,21,21,58
4/24/2003,23,0,20,28,71
4/25/2003,22,0,18,28,68
4/26/2003,23,0,20,10,53
4/27/2003,20,0,25,14,59
4/28/2003,36,0,20,27,83
4/29/2003,16,0,23,21,60
4/30/2003,15,0,16,22,53
5/1/2003,28,0,21,15,64
5/2/2003,25,0,25,20,70
5/3/2003,31,0,30,17,78
5/4/2003,26,0,24,23,73
5/5/2003,13,0,27,13,53
5/6/2003,25,0,28,14,67
5/7/2003,16,0,22,8,46
5/8/2003,28,0,26,29,83
5/9/2003,18,0,19,22,59
5/10/2003,23,0,16,27,66
5/11/2003,23,0,20,11,54
5/12/2003,19,0,26,6,51
5/13/2003,21,0,21,21,63
5/14/2003,22,0,17,19,58
5/15/2003,27,0,16,14,57
5/16/2003,24,0,22,29,75
5/17/2003,28,0,12,26,66
5/18/2003,30,0,16,25,71
5/19/2003,22,0,19,11,52
5/20/2003,25,0,21,11,57
5/21/2003,18,0,25,14,57
5/22/2003,17,0,23,30,70
5/23/2003,18,0,25,4,47
5/24/2003,29,0,25,32,86
5/25/2003,19,0,19,28,66
5/26/2003,25,0,16,31,72
5/27/2003,21,0,10,28,59
5/28/2003,24,0,24,17,65
5/29/2003,25,0,13,14,52
5/30/2003,20,0,17,31,68
5/31/2003,23,0,24,20,67
6/1/2003,26,0,14,33,73
6/2/2003,21,0,15,21,57
6/3/2003,23,0,16,12,51
6/4/2003,20,0,21,20,61
6/5/2003,21,0,13,19,53
6/6/2003,18,0,29,22,69
6/7/2003,30,0,25,21,76
6/8/2003,30,0,20,30,80
6/9/2003,21,0,24,18,63
6/10/2003,29,0,13,20,62
6/11/2003,15,0,22,29,66
6/12/2003,19,0,14,34,67
6/13/2003,22,0,27,18,67
6/14/2003,27,0,21,26,74
6/15/2003,27,0,30,19,76
6/16/2003,29,0,21,4,54
6/17/2003,22,0,20,14,56
6/18/2003,19,0,23,21,63
6/19/2003,31,0,11,12,54
6/20/2003,22,0,19,19,60
6/21/2003,21,0,26,17,64
6/22/2003,29,0,25,34,88
6/23/2003,23,0,19,8,50
6/24/2003,25,0,14,16,55
6/25/2003,24,0,15,22,61
6/26/2003,16,0,27,18,61
6/27/2003,21,0,17,28,66
6/28/2003,25,0,17,31,73
6/29/2003,27,0,17,18,62
6/30/2003,25,0,19,8,52
7/1/2003,31,0,23,17,71
7/2/2003,16,0,16,9,41
7/3/2003,18,0,14,19,51
7/4/2003,23,0,20,19,62
7/5/2003,29,0,22,24,75
7/6/2003,27,0,9,23,59
7/7/2003,26,0,23,14,63
7/8/2003,15,0,27,26,68
7/9/2003,18,0,15,9,42
7/10/2003,16,0,17,21,54
7/11/2003,29,0,13,15,57
7/12/2003,28,0,13,13,54
7/13/2003,15,0,26,27,68
7/14/2003,16,0,30,21,67
7/15/2003,27,0,25,30,82
7/16/2003,25,0,21,20,66
7/17/2003,16,0,21,8,45
7/18/2003,25,0,22,17,64
7/19/2003,29,0,26,9,64
7/20/2003,28,0,22,30,80
7/21/2003,27,0,20,34,81
7/22/2003,23,0,12,11,46
7/23/2003,16,0,15,32,63
7/24/2003,16,0,14,21,51
7/25/2003,21,0,21,19,61
7/26/2003,30,0,19,33,82
7/27/2003,27,0,19,28,74
7/28/2003,22,0,12,29,63
7/29/2003,19,0,16,34,69
7/30/2003,22,0,23,18,63
7/31/2003,33,0,26,20,79
8/1/2003,27,0,21,25,73
8/2/2003,28,0,18,21,67
8/3/2003,22,0,18,31,71
8/4/2003,30,0,29,23,82
8/5/2003,26,0,19,17,62
8/6/2003,25,0,19,28,72
8/7/2003,23,0,15,25,63
8/8/2003,21,0,23,23,67
8/9/2003,24,0,17,28,69
8/10/2003,32,0,19,15,66
8/11/2003,27,0,9,14,50
8/12/2003,21,0,18,14,53
8/13/2003,17,0,21,30,68
8/14/2003,28,0,13,26,67
8/15/2003,17,0,25,14,56
8/16/2003,19,0,16,36,71
8/17/2003,24,0,16,15,55
8/18/2003,12,0,23,27,62
8/19/2003,17,0,14,21,52
8/20/2003,32,0,29,13,74
8/21/2003,28,0,19,26,73
8/22/2003,11,0,25,13,49
8/23/2003,28,0,14,13,55
8/24/2003,21,0,20,14,55
8/25/2003,23,0,23,18,64
8/26/2003,32,0,13,11,56
8/27/2003,27,0,20,17,64
8/28/2003,26,0,21,30,77
8/29/2003,31,0,12,23,66
8/30/2003,25,0,22,33,80
8/31/2003,22,0,21,29,72
9/1/2003,19,0,17,23,59
9/2/2003,30,0,12,13,55
9/3/2003,21,0,28,18,67
9/4/2003,25,0,15,18,58
9/5/2003,21,0,25,9,55
9/6/2003,32,0,9,34,75
9/7/2003,25,0,19,12,56
9/8/2003,13,0,12,28,53
9/9/2003,27,0,13,18,58
9/10/2003,23,0,9,24,56
9/11/2003,28,0,12,25,65
9/12/2003,24,0,28,10,62
9/13/2003,17,0,23,31,71
9/14/2003,24,0,22,16,62
9/15/2003,29,0,19,20,68
9/16/2003,24,0,16,30,70
9/17/2003,14,0,23,21,58
9/18/2003,21,0,18,20,59
9/19/2003,22,0,16,15,53
9/20/2003,28,0,13,13,54
9/21/2003,20,0,23,27,70
9/22/2003,20,0,15,22,57
9/23/2003,21,0,27,19,67
9/24/2003,28,0,16,20,64
9/25/2003,20,0,30,24,74
9/26/2003,21,0,17,17,55
9/27/2003,21,0,23,17,61
9/28/2003,25,0,10,17,52
9/29/2003,28,0,19,22,69
9/30/2003,25,0,32,31,88
10/1/2003,26,0,21,23,70
10/2/2003,16,0,23,3,42
10/3/2003,33,0,23,16,72
10/4/2003,12,0,23,30,65
10/5/2003,29,0,15,10,54
10/6/2003,27,0,22,11,60
10/7/2003,29,0,19,35,83
10/8/2003,26,0,14,25,65
10/9/2003,21,0,17,25,63
10/10/2003,29,0,6,22,57
10/11/2003,29,0,27,21,77
10/12/2003,21,0,29,21,71
10/13/2003,21,0,18,27,66
10/14/2003,20,0,14,12,46
10/15/2003,26,0,32,17,75
10/16/2003,21,0,27,16,64
10/17/2003,32,0,16,18,66
10/18/2003,14,0,16,22,52
10/19/2003,13,0,32,15,60
10/20/2003,20,0,21,36,77
10/21/2003,15,0,26,22,63
10/22/2003,12,0,22,9,43
10/23/2003,19,0,23,16,58
10/24/2003,23,0,22,17,62
10/25/2003,30,0,18,20,68
10/26/2003,25,0,22,23,70
10/27/2003,17,0,24,21,62
10/28/2003,35,0,23,8,66
10/29/2003,22,0,22,6,50
10/30/2003,23,0,15,13,51
10/31/2003,17,0,22,23,62
11/1/2003,24,0,27,15,66
11/2/2003,15,0,25,17,57
11/3/2003,16,0,20,25,61
11/4/2003,26,0,24,18,68
11/5/2003,23,0,26,9,58
11/6/2003,19,0,17,4,40
11/7/2003,15,0,21,29,65
11/8/2003,20,0,20,21,61
11/9/2003,28,0,24,20,72
11/10/2003,24,0,15,24,63
11/11/2003,25,0,17,13,55
11/12/2003,20,0,20,21,61
11/13/2003,32,0,8,9,49
11/14/2003,19,0,13,14,46
11/15/2003,22,0,19,21,62
11/16/2003,27,0,26,32,85
11/17/2003,20,0,18,13,51
11/18/2003,14,0,9,25,48
11/19/2003,11,0,16,25,52
11/20/2003,14,0,26,16,56
11/21/2003,27,0,14,31,72
11/22/2003,22,0,24,23,69
11/23/2003,31,0,13,29,73
11/24/2003,30,0,22,7,59
11/25/2003,19,0,20,25,64
11/26/2003,28,0,14,26,68
11/27/2003,26,0,15,25,66
11/28/2003,33,0,16,22,71
11/29/2003,20,0,17,15,52
11/30/2003,25,0,24,25,74
12/1/2003,14,0,18,21,53
12/2/2003,20,0,30,21,71
12/3/2003,22,0,27,10,59
12/4/2003,25,0,19,28,72
12/5/2003,19,0,29,11,59
12/6/2003,31,0,26,22,79
12/7/2003,25,0,12,22,59
12/8/2003,24,0,24,8,56
12/9/2003,24,0,19,28,71
12/10/2003,23,0,11,25,59
12/11/2003,19,0,27,25,71
12/12/2003,29,0,15,14,58
12/13/2003,23,0,19,29,71
12/14/2003,28,0,23,28,79
12/15/2003,16,0,25,6,47
12/16/2003,25,0,18,29,72
12/17/2003,21,0,18,17,56
12/18/2003,22,0,24,14,60
12/19/2003,15,0,28,19,62
12/20/2003,24,0,12,22,58
12/21/2003,22,0,30,17,69
12/22/2003,22,0,20,13,55
12/23/2003,22,0,27,18,67
12/24/2003,26,0,15,16,57
12/25/2003,32,0,30,32,94
12/26/2003,25,0,23,29,77
12/27/2003,23,0,17,22,62
12/28/2003,23,0,11,11,45
12/29/2003,24,0,21,22,67
12/30/2003,25,0,19,16,60
12/31/2003,25,0,24,17,66
1/1/2004,19,0,19,28,66
1/2/2004,30,0,24,28,82
1/3/2004,28,0,21,10,59
1/4/2004,24,0,30,10,64
1/5/2004,17,0,12,35,64
1/6/2004,25,0,10,21,56
1/7/2004,26,0,21,9,56
1/8/2004,25,0,15,27,67
1/9/2004,23,0,19,15,57
1/10/2004,16,0,17,10,43
1/11/2004,24,0,25,24,73
1/12/2004,22,0,20,19,61
1/13/2004,32,0,29,27,88
1/14/2004,11,0,28,20,59
1/15/2004,31,0,19,19,69
1/16/2004,23,0,28,17,68
1/17/2004,25,0,19,22,66
1/18/2004,19,0,11,4,34
1/19/2004,16,0,16,17,49
1/20/2004,25,0,23,34,82
1/21/2004,28,0,26,28,82
1/22/2004,30,0,21,21,72
1/23/2004,27,0,22,16,65
1/24/2004,22,0,29,19,70
1/25/2004,20,0,19,27,66
1/26/2004,28,0,14,15,57
1/27/2004,20,0,9,20,49
1/28/2004,15,0,21,21,57
1/29/2004,15,0,23,12,50
1/30/2004,29,0,12,17,58
1/31/2004,23,0,20,33,76
2/1/2004,20,0,33,10,63
2/2/2004,29,0,22,18,69
2/3/2004,21,0,16,11,48
2/4/2004,28,0,17,10,55
2/5/2004,17,0,22,32,71
2/6/2004,25,0,24,33,82
2/7/2004,19,0,19,25,63
2/8/2004,18,0,16,24,58
2/9/2004,21,0,13,11,45
2/10/2004,18,0,27,34,79
2/11/2004,19,0,23,27,69
2/12/2004,21,0,25,14,60
2/13/2004,31,0,21,25,77
2/14/2004,25,0,17,32,74
2/15/2004,30,0,25,16,71
2/16/2004,23,0,27,25,75
2/17/2004,20,0,24,12,56
2/18/2004,25,0,28,16,69
2/19/2004,18,0,16,13,47
2/20/2004,13,0,19,30,62
2/21/2004,17,0,20,12,49
2/22/2004,25,0,9,18,52
2/23/2004,20,0,23,10,53
2/24/2004,22,0,24,28,74
2/25/2004,22,0,22,16,60
2/26/2004,22,0,22,25,69
2/27/2004,27,0,27,23,77
2/28/2004,23,0,21,21,65
2/29/2004,20,0,17,21,58
3/1/2004,19,0,33,5,57
3/2/2004,21,0,20,37,78
3/3/2004,17,0,29,22,68
3/4/2004,25,0,14,14,53
3/5/2004,24,0,20,22,66
3/6/2004,19,0,17,7,43
3/7/2004,32,0,18,25,75
3/8/2004,20,0,12,25,57
3/9/2004,25,0,22,22,69
3/10/2004,25,0,19,25,69
3/11/2004,22,0,19,14,55
3/12/2004,31,0,18,24,73
3/13/2004,25,0,16,3,44
3/14/2004,27,0,13,21,61
3/15/2004,24,0,20,30,74
3/16/2004,26,0,18,14,58
3/17/2004,15,0,20,26,61
3/18/2004,26,0,26,31,83
3/19/2004,20,0,17,9,46
3/20/2004,21,0,16,14,51
3/21/2004,28,0,25,16,69
3/22/2004,16,0,21,5,42
3/23/2004,19,0,21,14,54
3/24/2004,29,0,11,25,65
3/25/2004,32,0,20,10,62
3/26/2004,22,0,11,26,59
3/27/2004,25,0,23,23,71
3/28/2004,27,0,29,16,72
3/29/2004,22,0,19,18,59
3/30/2004,33,0,23,19,75
3/31/2004,18,0,14,16,48
4/1/2004,20,0,13,22,55
4/2/2004,33,0,16,24,73
4/3/2004,25,0,16,14,55
4/4/2004,31,0,17,27,75
4/5/2004,14,0,26,17,57
4/6/2004,33,0,29,11,73
4/7/2004,27,0,30,26,83
4/8/2004,29,0,20,26,75
4/9/2004,23,0,17,21,61
4/10/2004,27,0,13,18,58
4/11/2004,18,0,25,16,59
4/12/2004,22,0,21,26,69
4/13/2004,20,0,16,14,50
4/14/2004,15,0,21,17,53
4/15/2004,29,0,16,14,59
4/16/2004,19,0,25,13,57
4/17/2004,14,0,20,28,62
4/18/2004,28,0,33,13,74
4/19/2004,19,0,21,22,62
4/20/2004,21,0,17,12,50
4/21/2004,27,0,13,21,61
4/22/2004,23,0,18,27,68
4/23/2004,25,0,16,21,62
4/24/2004,18,0,26,25,69
4/25/2004,26,0,22,19,67
4/26/2004,19,0,18,11,48
4/27/2004,17,0,18,11,46
4/28/2004,29,0,20,24,73
4/29/2004,30,0,10,11,51
4/30/2004,28,0,21,18,67
5/1/2004,23,0,19,26,68
5/2/2004,35,0,19,20,74
5/3/2004,20,0,22,12,54
5/4/2004,23,0,25,24,72
5/5/2004,29,0,19,29,77
5/6/2004,30,0,28,20,78
5/7/2004,16,0,10,18,44
5/8/2004,36,0,27,13,76
5/9/2004,29,0,17,26,72
5/10/2004,29,0,26,10,65
5/11/2004,25,0,7,15,47
5/12/2004,22,0,15,12,49
5/13/2004,27,0,19,23,69
5/14/2004,13,0,28,27,68
5/15/2004,25,0,15,17,57
5/16/2004,22,0,15,6,43
5/17/2004,33,0,27,15,75
5/18/2004,16,0,19,27,62
5/19/2004,24,0,21,13,58
5/20/2004,30,0,26,20,76
5/21/2004,33,0,17,19,69
5/22/2004,21,0,16,9,46
5/23/2004,24,0,24,16,64
5/24/2004,21,0,10,25,56
5/25/2004,25,0,19,19,63
5/26/2004,28,0,28,12,68
5/27/2004,30,0,24,31,85
5/28/2004,19,0,12,31,62
5/29/2004,24,0,15,30,69
5/30/2004,24,0,22,17,63
5/31/2004,21,0,16,28,65
6/1/2004,20,0,30,19,69
6/2/2004,16,0,17,25,58
6/3/2004,27,0,19,19,65
6/4/2004,25,0,29,23,77
6/5/2004,25,0,9,12,46
6/6/2004,22,0,19,16,57
6/7/2004,20,0,18,18,56
6/8/2004,27,0,27,32,86
6/9/2004,23,0,16,28,67
6/10/2004,27,0,11,13,51
6/11/2004,27,0,24,18,69
6/12/2004,22,0,23,18,63
6/13/2004,26,0,21,34,81
6/14/2004,16,0,22,15,53
6/15/2004,12,0,27,17,56
6/16/2004,11,0,28,26,65
6/17/2004,22,0,26,26,74
6/18/2004,16,0,23,30,69
6/19/2004,22,0,10,12,44
6/20/2004,22,0,10,19,51
6/21/2004,16,0,13,3,32
6/22/2004,32,0,21,16,69
6/23/2004,33,0,18,16,67
6/24/2004,20,0,24,23,67
6/25/2004,26,0,19,16,61
6/26/2004,18,0,12,11,41
6/27/2004,24,0,12,36,72
6/28/2004,20,0,18,8,46
6/29/2004,17,0,29,14,60
6/30/2004,33,0,11,28,72
7/1/2004,28,0,14,12,54
7/2/2004,15,0,19,20,54
7/3/2004,27,0,22,9,58
7/4/2004,17,0,31,20,68
7/5/2004,19,0,18,19,56
7/6/2004,27,0,19,20,66
7/7/2004,21,0,18,21,60
7/8/2004,32,0,26,16,74
7/9/2004,20,0,22,15,57
7/10/2004,21,0,27,15,63
7/11/2004,25,0,16,16,57
7/12/2004,23,0,18,21,62
7/13/2004,22,0,18,17,57
7/14/2004,18,0,22,26,66
7/15/2004,21,0,27,25,73
7/16/2004,22,0,29,22,73
7/17/2004,29,0,24,18,71
7/18/2004,27,0,30,13,70
7/19/2004,25,0,10,31,66
7/20/2004,23,0,23,21,67
7/21/2004,17,0,24,29,70
7/22/2004,25,0,19,8,52
7/23/2004,14,0,25,16,55
7/24/2004,20,0,23,27,70
7/25/2004,14,0,19,31,64
7/26/2004,18,0,13,31,62
7/27/2004,28,0,23,16,67
7/28/2004,18,0,23,18,59
7/29/2004,24,0,14,21,59
7/30/2004,23,0,25,10,58
7/31/2004,20,0,15,20,55
8/1/2004,29,0,22,20,71
8/2/2004,22,0,21,23,66
8/3/2004,29,0,15,7,51
8/4/2004,20,0,22,20,62
8/5/2004,23,0,19,14,56
8/6/2004,24,0,17,24,65
8/7/2004,23,0,23,7,53
8/8/2004,21,0,24,14,59
8/9/2004,31,0,29,15,75
8/10/2004,24,0,23,31,78
8/11/2004,24,0,27,19,70
8/12/2004,30,0,20,22,72
8/13/2004,30,0,15,16,61
8/14/2004,19,0,23,20,62
8/15/2004,17,0,20,19,56
8/16/2004,27,0,18,32,77
8/17/2004,30,0,12,16,58
8/18/2004,22,0,30,28,80
8/19/2004,22,0,13,7,42
8/20/2004,31,0,27,17,75
8/21/2004,27,0,17,24,68
8/22/2004,27,0,24,29,80
8/23/2004,22,0,27,20,69
8/24/2004,23,0,27,29,79
8/25/2004,27,0,18,21,66
8/26/2004,20,0,25,14,59
8/27/2004,23,0,27,21,71
8/28/2004,28,0,25,11,64
8/29/2004,22,0,26,35,83
8/30/2004,31,0,20,8,59
8/31/2004,18,0,22,17,57
9/1/2004,19,0,15,28,62
9/2/2004,29,0,14,12,55
9/3/2004,25,0,34,19,78
9/4/2004,27,0,9,35,71
9/5/2004,28,0,17,11,56
9/6/2004,22,0,18,9,49
9/7/2004,23,0,19,26,68
9/8/2004,15,0,11,19,45
9/9/2004,16,0,16,30,62
9/10/2004,20,0,18,29,67
9/11/2004,23,0,29,21,73
9/12/2004,29,0,20,27,76
9/13/2004,21,0,16,24,61
9/14/2004,21,0,24,38,83
9/15/2004,21,0,22,17,60
9/16/2004,18,0,13,6,37
9/17/2004,25,0,20,20,65
9/18/2004,16,0,19,22,57
9/19/2004,21,0,12,16,49
9/20/2004,22,0,16,22,60
9/21/2004,25,0,18,31,74
9/22/2004,13,0,14,19,46
9/23/2004,33,0,20,14,67
9/24/2004,23,0,23,21,67
9/25/2004,24,0,25,31,80
9/26/2004,24,0,23,16,63
9/27/2004,22,0,10,24,56
9/28/2004,28,0,19,24,71
9/29/2004,27,0,27,26,80
9/30/2004,16,0,13,23,52
10/1/2004,28,0,31,14,73
10/2/2004,14,0,20,28,62
10/3/2004,20,0,23,34,77
10/4/2004,12,0,23,13,48
10/5/2004,23,0,24,17,64
10/6/2004,23,0,25,16,64
10/7/2004,13,0,14,16,43
10/8/2004,23,0,23,17,63
10/9/2004,16,0,14,16,46
10/10/2004,30,0,11,22,63
10/11/2004,27,0,24,8,59
10/12/2004,27,0,16,16,59
10/13/2004,28,0,18,13,59
10/14/2004,19,0,20,28,67
10/15/2004,30,0,18,21,69
10/16/2004,28,0,22,15,65
10/17/2004,25,0,20,12,57
10/18/2004,11,0,25,16,52
10/19/2004,22,0,17,11,50
10/20/2004,15,0,19,32,66
10/21/2004,22,0,16,28,66
10/22/2004,12,0,19,15,46
10/23/2004,18,0,18,19,55
10/24/2004,21,0,26,7,54
10/25/2004,20,0,20,24,64
10/26/2004,28,0,24,14,66
10/27/2004,32,0,19,27,78
10/28/2004,24,0,24,21,69
10/29/2004,28,0,19,8,55
10/30/2004,24,0,25,16,65
10/31/2004,19,0,11,19,49
11/1/2004,30,0,21,15,66
11/2/2004,23,0,28,25,76
11/3/2004,26,0,27,20,73
11/4/2004,22,0,30,22,74
11/5/2004,21,0,14,11,46
11/6/2004,29,0,18,38,85
11/7/2004,27,0,16,20,63
11/8/2004,29,0,26,17,72
11/9/2004,19,0,16,13,48
11/10/2004,25,0,13,23,61
11/11/2004,20,0,24,28,72
11/12/2004,20,0,18,22,60
11/13/2004,27,0,27,28,82
11/14/2004,21,0,25,32,78
11/15/2004,22,0,15,35,72
11/16/2004,25,0,24,32,81
11/17/2004,33,0,18,14,65
11/18/2004,20,0,15,36,71
11/19/2004,30,0,21,21,72
11/20/2004,27,0,22,23,72
11/21/2004,18,0,16,5,39
11/22/2004,22,0,31,15,68
11/23/2004,16,0,29,32,77
11/24/2004,33,0,12,17,62
11/25/2004,20,0,17,28,65
11/26/2004,27,0,14,33,74
11/27/2004,23,0,17,22,62
11/28/2004,17,0,14,5,36
11/29/2004,15,0,16,32,63
11/30/2004,12,0,22,16,50
12/1/2004,19,0,9,24,52
12/2/2004,15,0,22,21,58
12/3/2004,25,0,21,34,80
12/4/2004,24,0,21,5,50
12/5/2004,25,0,21,26,72
12/6/2004,26,0,7,28,61
12/7/2004,17,0,14,12,43
12/8/2004,24,0,25,15,64
12/9/2004,18,0,16,23,57
12/10/2004,25,0,20,21,66
12/11/2004,25,0,19,28,72
12/12/2004,22,0,23,29,74
12/13/2004,19,0,25,19,63
12/14/2004,25,0,16,11,52
12/15/2004,24,0,20,35,79
12/16/2004,27,0,15,15,57
12/17/2004,27,0,20,27,74
12/18/2004,31,0,12,19,62
12/19/2004,26,0,30,23,79
12/20/2004,34,0,18,16,68
12/21/2004,19,0,24,26,69
12/22/2004,25,0,31,26,82
12/23/2004,24,0,20,17,61
12/24/2004,17,0,18,17,52
12/25/2004,20,0,30,13,63
12/26/2004,21,0,16,17,54
12/27/2004,23,0,15,6,44
12/28/2004,25,0,27,18,70
12/29/2004,17,0,7,14,38
12/30/2004,23,0,17,16,56
12/31/2004,23,0,29,20,72
1/1/2005,21,0,14,17,52
1/2/2005,32,0,22,25,79
1/3/2005,30,0,25,13,68
1/4/2005,25,0,22,16,63
1/5/2005,21,0,10,30,61
1/6/2005,21,0,25,26,72
1/7/2005,25,0,14,29,68
1/8/2005,31,0,19,17,67
1/9/2005,12,0,14,25,51
1/10/2005,12,0,18,23,53
1/11/2005,19,0,25,19,63
1/12/2005,18,0,26,18,62
1/13/2005,19,0,18,32,69
1/14/2005,33,0,26,19,78
1/15/2005,30,0,18,21,69
1/16/2005,23,0,29,8,60
1/17/2005,28,0,16,27,71
1/18/2005,26,0,26,15,67
1/19/2005,30,0,25,27,82
1/20/2005,30,0,17,22,69
1/21/2005,17,0,17,19,53
1/22/2005,18,0,13,17,48
1/23/2005,16,0,25,16,57
1/24/2005,15,0,24,23,62
1/25/2005,23,0,20,20,63
1/26/2005,12,0,23,22,57
1/27/2005,23,0,20,22,65
1/28/2005,18,0,25,21,64
1/29/2005,20,0,21,16,57
1/30/2005,22,0,16,26,64
1/31/2005,29,0,15,7,51
2/1/2005,26,0,21,11,58
2/2/2005,17,0,12,8,37
2/3/2005,32,0,16,20,68
2/4/2005,26,0,28,25,79
2/5/2005,23,0,17,29,69
2/6/2005,19,0,17,10,46
2/7/2005,20,0,19,15,54
2/8/2005,20,0,19,19,58
2/9/2005,24,0,17,26,67
2/10/2005,25,0,11,22,58
2/11/2005,23,0,14,13,50
2/12/2005,25,0,11,15,51
2/13/2005,23,0,18,25,66
2/14/2005,28,0,19,23,70
2/15/2005,24,0,18,10,52
2/16/2005,20,0,13,24,57
2/17/2005,16,0,29,19,64
2/18/2005,25,0,13,29,67
2/19/2005,24,0,18,11,53
2/20/2005,21,0,20,24,65
2/21/2005,24,0,25,23,72
2/22/2005,20,0,31,20,71
2/23/2005,19,0,16,14,49
2/24/2005,17,0,20,23,60
2/25/2005,16,0,14,17,47
2/26/2005,24,0,29,29,82
2/27/2005,21,0,19,10,50
2/28/2005,20,0,16,18,54
3/1/2005,19,0,16,16,51
3/2/2005,19,0,28,11,58
3/3/2005,33,0,23,19,75
3/4/2005,18,0,18,32,68
3/5/2005,18,0,20,16,54
3/6/2005,32,0,11,22,65
3/7/2005,26,0,27,30,83
3/8/2005,19,0,18,15,52
3/9/2005,27,0,18,13,58
3/10/2005,28,0,14,20,62
3/11/2005,29,0,15,26,70
3/12/2005,26,0,22,23,71
3/13/2005,27,0,13,26,66
3/14/2005,18,0,17,7,42
3/15/2005,30,0,20,18,68
3/16/2005,27,0,27,9,63
3/17/2005,18,0,20,16,54
3/18/2005,29,0,16,26,71
3/19/2005,30,0,10,28,68
3/20/2005,14,0,22,7,43
3/21/2005,18,0,23,16,57
3/22/2005,14,0,19,33,66
3/23/2005,29,0,27,4,60
3/24/2005,28,0,17,24,69
3/25/2005,26,0,22,26,74
3/26/2005,13,0,15,32,60
3/27/2005,23,0,22,23,68
3/28/2005,22,0,9,17,48
3/29/2005,33,0,26,24,83
3/30/2005,23,0,7,21,51
3/31/2005,29,0,15,26,70
4/1/2005,25,0,25,19,69
4/2/2005,17,0,24,19,60
4/3/2005,26,0,22,11,59
4/4/2005,19,0,16,17,52
4/5/2005,19,0,10,24,53
4/6/2005,20,0,20,24,64
4/7/2005,27,0,19,15,61
4/8/2005,36,0,21,22,79
4/9/2005,24,0,14,19,57
4/10/2005,18,0,13,32,63
4/11/2005,24,0,18,21,63
4/12/2005,34,0,14,24,72
4/13/2005,16,0,15,6,37
4/14/2005,26,0,19,23,68
4/15/2005,27,0,19,9,55
4/16/2005,25,0,34,25,84
4/17/2005,23,0,23,18,64
4/18/2005,20,0,23,25,68
4/19/2005,30,0,22,29,81
4/20/2005,21,0,15,5,41
4/21/2005,24,0,16,17,57
4/22/2005,15,0,27,12,54
4/23/2005,26,0,15,15,56
4/24/2005,28,0,14,5,47
4/25/2005,25,0,15,15,55
4/26/2005,24,0,18,11,53
4/27/2005,19,0,22,11,52
4/28/2005,24,0,17,29,70
4/29/2005,15,0,19,16,50
4/30/2005,24,0,28,8,60
5/1/2005,16,0,29,12,57
5/2/2005,28,0,24,19,71
5/3/2005,20,0,10,31,61
5/4/2005,23,0,26,21,70
5/5/2005,21,0,13,10,44
5/6/2005,25,0,24,14,63
5/7/2005,24,0,25,22,71
5/8/2005,32,0,27,19,78
5/9/2005,22,0,23,21,66
5/10/2005,34,0,27,20,81
5/11/2005,24,0,19,25,68
5/12/2005,25,0,15,13,53
5/13/2005,30,0,19,13,62
5/14/2005,32,0,27,20,79
5/15/2005,21,0,26,16,63
5/16/2005,21,0,29,29,79
5/17/2005,16,0,22,18,56
5/18/2005,27,0,26,15,68
5/19/2005,23,0,14,17,54
5/20/2005,25,0,23,14,62
5/21/2005,24,0,28,30,82
5/22/2005,18,0,20,22,60
5/23/2005,23,0,17,18,58
5/24/2005,28,0,20,37,85
5/25/2005,28,0,16,17,61
5/26/2005,19,0,20,26,65
5/27/2005,33,0,25,29,87
5/28/2005,20,0,27,15,62
5/29/2005,28,0,27,18,73
5/30/2005,10,0,15,26,51
5/31/2005,26,0,28,15,69
6/1/2005,26,0,19,26,71
6/2/2005,19,0,19,22,60
6/3/2005,21,0,21,8,50
6/4/2005,25,0,23,8,56
6/5/2005,14,0,31,4,49
6/6/2005,22,0,22,22,66
6/7/2005,29,0,29,26,84
6/8/2005,28,0,17,21,66
6/9/2005,31,0,18,14,63
6/10/2005,24,0,25,18,67
6/11/2005,28,0,27,14,69
6/12/2005,19,0,19,17,55
6/13/2005,28,0,20,28,76
6/14/2005,20,0,19,18,57
6/15/2005,33,0,21,19,73
6/16/2005,31,0,28,16,75
6/17/2005,30,0,20,17,67
6/18/2005,24,0,25,28,77
6/19/2005,27,0,10,28,65
6/20/2005,25,0,21,27,73
6/21/2005,19,0,22,25,66
6/22/2005,19,0,19,26,64
6/23/2005,23,0,25,16,64
6/24/2005,21,0,28,21,70
6/25/2005,28,0,23,23,74
6/26/2005,23,0,24,23,70
6/27/2005,25,0,27,24,76
6/28/2005,22,0,19,25,66
6/29/2005,25,0,20,22,67
6/30/2005,18,0,26,23,67
7/1/2005,26,0,26,15,67
7/2/2005,28,0,23,15,66
7/3/2005,31,0,26,15,72
7/4/2005,34,0,14,4,52
7/5/2005,26,0,18,21,65
7/6/2005,30,0,29,25,84
7/7/2005,22,0,19,17,58
7/8/2005,19,0,7,16,42
7/9/2005,23,0,21,26,70
7/10/2005,19,0,18,28,65
7/11/2005,24,0,17,20,61
7/12/2005,26,0,22,19,67
7/13/2005,32,0,25,30,87
7/14/2005,23,0,24,18,65
7/15/2005,22,0,23,27,72
7/16/2005,22,0,29,25,76
7/17/2005,32,0,21,10,63
7/18/2005,22,0,17,12,51
7/19/2005,19,0,22,10,51
7/20/2005,32,0,28,7,67
7/21/2005,18,0,27,19,64
7/22/2005,26,0,22,19,67
7/23/2005,18,0,22,14,54
7/24/2005,31,0,22,18,71
7/25/2005,21,0,31,14,66
7/26/2005,14,0,29,23,66
7/27/2005,21,0,27,17,65
7/28/2005,26,0,20,17,63
7/29/2005,25,0,22,30,77
7/30/2005,21,0,16,23,60
7/31/2005,20,0,24,16,60
8/1/2005,22,0,20,29,71
8/2/2005,15,0,20,27,62
8/3/2005,19,0,27,18,64
8/4/2005,28,0,16,23,67
8/5/2005,24,0,21,25,70
8/6/2005,29,0,12,29,70
8/7/2005,26,0,11,16,53
8/8/2005,26,0,25,29,80
8/9/2005,23,0,24,6,53
8/10/2005,25,0,17,22,64
8/11/2005,28,0,20,9,57
8/12/2005,19,0,24,39,82
8/13/2005,22,0,18,9,49
8/14/2005,19,0,20,18,57
8/15/2005,15,0,17,19,51
8/16/2005,17,0,18,28,63
8/17/2005,26,0,21,15,62
8/18/2005,20,0,30,12,62
8/19/2005,26,0,18,16,60
8/20/2005,16,0,12,13,41
8/21/2005,22,0,22,15,59
8/22/2005,29,0,25,24,78
8/23/2005,20,0,20,15,55
8/24/2005,23,0,9,26,58
8/25/2005,22,0,12,7,41
8/26/2005,17,0,17,19,53
8/27/2005,33,0,22,8,63
8/28/2005,14,0,25,11,50
8/29/2005,16,0,19,18,53
8/30/2005,17,0,9,13,39
8/31/2005,23,0,18,26,67
9/1/2005,24,0,30,25,79
9/2/2005,33,0,18,10,61
9/3/2005,20,0,18,10,48
9/4/2005,18,0,22,10,50
9/5/2005,25,0,14,29,68
9/6/2005,20,0,21,18,59
9/7/2005,27,0,26,14,67
9/8/2005,28,0,17,36,81
9/9/2005,29,0,24,15,68
9/10/2005,20,0,20,19,59
9/11/2005,20,0,19,25,64
9/12/2005,21,0,21,28,70
9/13/2005,18,0,22,22,62
9/14/2005,22,0,19,24,65
9/15/2005,23,0,24,18,65
9/16/2005,30,0,18,11,59
9/17/2005,27,0,17,24,68
9/18/2005,19,0,12,27,58
9/19/2005,23,0,24,14,61
9/20/2005,23,0,16,27,66
9/21/2005,23,0,25,12,60
9/22/2005,20,0,28,20,68
9/23/2005,25,0,15,14,54
9/24/2005,21,0,23,12,56
9/25/2005,22,0,14,25,61
9/26/2005,31,0,13,24,68
9/27/2005,19,0,13,12,44
9/28/2005,20,0,26,17,63
9/29/2005,18,0,19,13,50
9/30/2005,25,0,17,13,55
10/1/2005,28,0,26,17,71
10/2/2005,21,0,13,14,48
10/3/2005,17,0,24,8,49
10/4/2005,25,0,23,20,68
10/5/2005,27,0,14,19,60
10/6/2005,34,0,16,30,80
10/7/2005,24,0,19,24,67
10/8/2005,32,0,32,13,77
10/9/2005,26,0,19,20,65
10/10/2005,19,0,26,5,50
10/11/2005,16,0,24,18,58
10/12/2005,26,0,13,32,71
10/13/2005,30,0,28,17,75
10/14/2005,26,0,24,5,55
10/15/2005,25,0,28,4,57
10/16/2005,28,0,21,12,61
10/17/2005,29,0,24,17,70
10/18/2005,20,0,26,18,64
10/19/2005,15,0,31,31,77
10/20/2005,28,0,27,15,70
10/21/2005,23,0,21,20,64
10/22/2005,17,0,31,30,78
10/23/2005,19,0,26,19,64
10/24/2005,20,0,25,14,59
10/25/2005,12,0,21,20,53
10/26/2005,19,0,16,21,56
10/27/2005,34,0,22,19,75
10/28/2005,20,0,20,22,62
10/29/2005,22,0,16,17,55
10/30/2005,20,0,20,28,68
10/31/2005,20,0,23,25,68
11/1/2005,26,0,22,16,64
11/2/2005,16,0,17,24,57
11/3/2005,23,0,18,12,53
11/4/2005,22,0,20,10,52
11/5/2005,13,0,18,16,47
11/6/2005,27,0,17,11,55
11/7/2005,23,0,25,34,82
11/8/2005,20,0,28,20,68
11/9/2005,15,0,15,25,55
11/10/2005,30,0,16,19,65
11/11/2005,33,0,22,37,92
11/12/2005,31,0,21,26,78
11/13/2005,17,0,26,18,61
11/14/2005,23,0,10,17,50
11/15/2005,24,0,20,25,69
11/16/2005,23,0,21,19,63
11/17/2005,28,0,25,12,65
11/18/2005,28,0,12,34,74
11/19/2005,21,0,25,7,53
11/20/2005,21,0,22,26,69
11/21/2005,15,0,25,15,55
11/22/2005,16,0,15,13,44
11/23/2005,24,0,14,19,57
11/24/2005,34,0,25,27,86
11/25/2005,28,0,22,22,72
11/26/2005,32,0,23,29,84
11/27/2005,17,0,19,18,54
11/28/2005,29,0,24,18,71
11/29/2005,18,0,18,16,52
11/30/2005,27,0,11,28,66
12/1/2005,28,0,11,29,68
12/2/2005,22,0,27,23,72
12/3/2005,25,0,17,33,75
12/4/2005,18,0,23,12,53
12/5/2005,17,0,11,34,62
12/6/2005,24,0,25,14,63
12/7/2005,28,0,17,27,72
12/8/2005,24,0,27,22,73
12/9/2005,27,0,24,15,66
12/10/2005,23,0,17,25,65
12/11/2005,18,0,18,19,55
12/12/2005,25,0,14,29,68
12/13/2005,23,0,29,28,80
12/14/2005,30,0,22,19,71
12/15/2005,23,0,10,10,43
12/16/2005,17,0,24,24,65
12/17/2005,13,0,20,15,48
12/18/2005,24,0,22,17,63
12/19/2005,28,0,22,25,75
12/20/2005,28,0,16,17,61
12/21/2005,23,0,28,27,78
12/22/2005,16,0,16,23,55
12/23/2005,12,0,18,30,60
12/24/2005,24,0,12,23,59
12/25/2005,17,0,13,18,48
12/26/2005,20,0,17,7,44
12/27/2005,19,0,15,32,66
12/28/2005,25,0,12,23,60
12/29/2005,31,0,13,24,68
12/30/2005,29,0,13,9,51
12/31/2005,24,0,8,18,50
1/1/2006,34,0,20,10,64
1/2/2006,30,0,30,31,91
1/3/2006,28,0,16,17,61
1/4/2006,21,0,24,20,65
1/5/2006,18,0,12,26,56
1/6/2006,24,0,7,10,41
1/7/2006,16,0,24,22,62
1/8/2006,21,0,16,18,55
1/9/2006,22,0,13,27,62
1/10/2006,13,0,23,12,48
1/11/2006,17,0,24,17,58
1/12/2006,24,0,24,17,65
1/13/2006,24,0,20,22,66
1/14/2006,23,0,23,25,71
1/15/2006,29,0,15,22,66
1/16/2006,24,0,11,12,47
1/17/2006,30,0,23,27,80
1/18/2006,28,0,21,16,65
1/19/2006,23,0,23,11,57
1/20/2006,19,0,20,18,57
1/21/2006,24,0,23,25,72
1/22/2006,28,0,21,17,66
1/23/2006,23,0,26,26,75
1/24/2006,19,0,23,7,49
1/25/2006,20,0,14,9,43
1/26/2006,13,0,20,33,66
1/27/2006,21,0,21,1,43
1/28/2006,25,0,28,14,67
1/29/2006,27,0,16,35,78
1/30/2006,25,0,12,17,54
1/31/2006,21,0,26,33,80
2/1/2006,15,0,25,25,65
2/2/2006,20,0,16,31,67
2/3/2006,17,0,19,12,48
2/4/2006,18,0,23,32,73
2/5/2006,23,0,11,19,53
2/6/2006,20,0,13,5,38
2/7/2006,30,0,30,26,86
2/8/2006,24,0,27,16,67
2/9/2006,16,0,18,22,56
2/10/2006,23,0,10,13,46
2/11/2006,25,0,27,16,68
2/12/2006,17,0,19,16,52
2/13/2006,30,0,16,30,76
2/14/2006,18,0,19,29,66
2/15/2006,22,0,20,22,64
2/16/2006,33,0,14,20,67
2/17/2006,27,0,19,8,54
2/18/2006,24,0,25,16,65
2/19/2006,29,0,15,23,67
2/20/2006,26,0,20,28,74
2/21/2006,22,0,24,21,67
2/22/2006,24,0,27,24,75
2/23/2006,14,0,25,4,43
2/24/2006,22,0,17,17,56
2/25/2006,20,0,16,15,51
2/26/2006,23,0,32,19,74
2/27/2006,18,0,23,17,58
2/28/2006,27,0,20,14,61
3/1/2006,15,0,25,17,57
3/2/2006,25,0,19,22,66
3/3/2006,29,0,21,21,71
3/4/2006,15,0,16,15,46
3/5/2006,25,0,22,24,71
3/6/2006,20,0,32,18,70
3/7/2006,19,0,22,20,61
3/8/2006,11,0,19,11,41
3/9/2006,26,0,16,9,51
3/10/2006,29,0,18,18,65
3/11/2006,27,0,20,21,68
3/12/2006,23,0,15,29,67
3/13/2006,18,0,19,20,57
3/14/2006,34,0,20,30,84
3/15/2006,26,0,24,25,75
3/16/2006,34,0,17,31,82
3/17/2006,21,0,30,29,80
3/18/2006,25,0,28,25,78
3/19/2006,20,0,16,18,54
3/20/2006,25,0,21,14,60
3/21/2006,17,0,21,34,72
3/22/2006,23,0,16,29,68
3/23/2006,19,0,19,22,60
3/24/2006,26,0,24,21,71
3/25/2006,18,0,30,11,59
3/26/2006,26,0,29,29,84
3/27/2006,21,0,25,20,66
3/28/2006,31,0,19,13,63
3/29/2006,31,0,13,26,70
3/30/2006,18,0,12,24,54
3/31/2006,21,0,18,32,71
4/1/2006,26,0,27,28,81
4/2/2006,29,0,27,18,74
4/3/2006,31,0,28,25,84
4/4/2006,21,0,26,36,83
4/5/2006,29,0,27,24,80
4/6/2006,15,0,19,19,53
4/7/2006,21,0,18,25,64
4/8/2006,17,0,30,15,62
4/9/2006,22,0,15,4,41
4/10/2006,21,0,17,22,60
4/11/2006,21,0,31,14,66
4/12/2006,16,0,19,26,61
4/13/2006,25,0,27,22,74
4/14/2006,34,0,25,15,74
4/15/2006,20,0,27,11,58
4/16/2006,24,0,32,9,65
4/17/2006,20,0,8,15,43
4/18/2006,14,0,17,31,62
4/19/2006,21,0,14,21,56
4/20/2006,29,0,30,17,76
4/21/2006,11,0,23,18,52
4/22/2006,31,0,21,25,77
4/23/2006,25,0,21,7,53
4/24/2006,23,0,21,18,62
4/25/2006,29,0,26,6,61
4/26/2006,24,0,21,33,78
4/27/2006,16,0,19,13,48
4/28/2006,18,0,21,16,55
4/29/2006,24,0,18,14,56
4/30/2006,21,0,20,17,58
5/1/2006,19,0,17,27,63
5/2/2006,15,0,12,14,41
5/3/2006,18,0,23,14,55
5/4/2006,25,0,19,29,73
5/5/2006,22,0,17,25,64
5/6/2006,23,0,28,8,59
5/7/2006,21,0,24,17,62
5/8/2006,16,0,15,21,52
5/9/2006,20,0,20,10,50
5/10/2006,14,0,30,11,55
5/11/2006,23,0,21,21,65
5/12/2006,22,0,18,29,69
5/13/2006,22,0,20,18,60
5/14/2006,18,0,28,28,74
5/15/2006,29,0,18,19,66
5/16/2006,18,0,23,22,63
5/17/2006,33,0,29,20,82
5/18/2006,24,0,21,14,59
5/19/2006,15,0,13,34,62
5/20/2006,24,0,20,22,66
5/21/2006,20,0,17,34,71
5/22/2006,14,0,21,9,44
5/23/2006,29,0,24,33,86
5/24/2006,19,0,23,12,54
5/25/2006,28,0,24,22,74
5/26/2006,31,0,12,31,74
5/27/2006,23,0,15,20,58
5/28/2006,29,0,20,20,69
5/29/2006,31,0,19,17,67
5/30/2006,26,0,19,29,74
5/31/2006,25,0,31,17,73
6/1/2006,19,0,20,24,63
6/2/2006,19,0,14,22,55
6/3/2006,30,0,24,12,66
6/4/2006,30,0,29,25,84
6/5/2006,24,0,11,21,56
6/6/2006,23,0,21,22,66
6/7/2006,28,0,20,13,61
6/8/2006,22,0,15,25,62
6/9/2006,15,0,8,18,41
6/10/2006,26,0,12,8,46
6/11/2006,24,0,17,26,67
6/12/2006,26,0,14,17,57
6/13/2006,15,0,17,10,42
6/14/2006,31,0,23,22,76
6/15/2006,30,0,14,21,65
6/16/2006,22,0,20,27,69
6/17/2006,22,0,26,18,66
6/18/2006,20,0,17,20,57
6/19/2006,28,0,26,28,82
6/20/2006,25,0,21,14,60
6/21/2006,22,0,29,14,65
6/22/2006,34,0,21,15,70
6/23/2006,22,0,22,27,71
6/24/2006,24,0,14,19,57
6/25/2006,11,0,28,6,45
6/26/2006,23,0,22,8,53
6/27/2006,29,0,21,11,61
6/28/2006,21,0,13,18,52
6/29/2006,32,0,19,12,63
6/30/2006,24,0,22,3,49
7/1/2006,16,0,19,31,66
7/2/2006,29,0,10,22,61
7/3/2006,25,0,27,19,71
7/4/2006,18,0,18,26,62
7/5/2006,24,0,19,20,63
7/6/2006,16,0,26,12,54
7/7/2006,23,0,28,16,67
7/8/2006,28,0,21,24,73
7/9/2006,24,0,27,34,85
7/10/2006,27,0,20,12,59
7/11/2006,20,0,23,27,70
7/12/2006,26,0,27,14,67
7/13/2006,19,0,15,34,68
7/14/2006,13,0,12,27,52
7/15/2006,20,0,26,23,69
7/16/2006,29,0,10,26,65
7/17/2006,21,0,14,18,53
7/18/2006,20,0,22,23,65
7/19/2006,17,0,23,21,61
7/20/2006,29,0,19,10,58
7/21/2006,30,0,16,19,65
7/22/2006,18,0,26,22,66
7/23/2006,15,0,26,3,44
7/24/2006,22,0,13,14,49
7/25/2006,23,0,21,19,63
7/26/2006,32,0,17,25,74
7/27/2006,23,0,21,27,71
7/28/2006,27,0,19,24,70
7/29/2006,29,0,23,19,71
7/30/2006,24,0,24,17,65
7/31/2006,18,0,19,28,65
8/1/2006,19,0,28,17,64
8/2/2006,17,0,13,18,48
8/3/2006,28,0,26,25,79
8/4/2006,19,0,7,30,56
8/5/2006,18,0,24,23,65
8/6/2006,21,0,10,15,46
8/7/2006,26,0,18,16,60
8/8/2006,20,0,21,13,54
8/9/2006,24,0,24,13,61
8/10/2006,21,0,24,29,74
8/11/2006,27,0,29,12,68
8/12/2006,31,0,21,25,77
8/13/2006,17,0,16,20,53
8/14/2006,22,0,14,23,59
8/15/2006,23,0,11,22,56
8/16/2006,29,0,26,26,81
8/17/2006,29,0,22,17,68
8/18/2006,22,0,29,26,77
8/19/2006,20,0,30,39,89
8/20/2006,19,0,28,5,52
8/21/2006,23,0,20,13,56
8/22/2006,19,0,16,28,63
8/23/2006,20,0,16,14,50
8/24/2006,30,0,18,14,62
8/25/2006,31,0,23,24,78
8/26/2006,14,0,14,25,53
8/27/2006,26,0,17,19,62
8/28/2006,19,0,23,26,68
8/29/2006,18,0,24,29,71
8/30/2006,24,0,12,10,46
8/31/2006,27,0,19,22,68
9/1/2006,17,0,23,10,50
9/2/2006,25,0,24,28,77
9/3/2006,16,0,15,26,57
9/4/2006,30,0,20,17,67
9/5/2006,23,0,21,25,69
9/6/2006,18,0,19,32,69
9/7/2006,22,0,18,14,54
9/8/2006,24,0,24,15,63
9/9/2006,18,0,18,27,63
9/10/2006,15,0,19,26,60
9/11/2006,24,0,24,18,66
9/12/2006,14,0,11,23,48
9/13/2006,24,0,24,14,62
9/14/2006,23,0,23,20,66
9/15/2006,19,0,13,24,56
9/16/2006,18,0,27,34,79
9/17/2006,30,0,13,10,53
9/18/2006,23,0,21,18,62
9/19/2006,19,0,26,9,54
9/20/2006,27,0,17,9,53
9/21/2006,32,0,20,25,77
9/22/2006,25,0,16,20,61
9/23/2006,29,0,20,12,61
9/24/2006,29,0,27,30,86
9/25/2006,15,0,22,18,55
9/26/2006,22,0,19,20,61
9/27/2006,22,0,29,22,73
9/28/2006,21,0,20,20,61
9/29/2006,21,0,22,23,66
9/30/2006,17,0,19,9,45
10/1/2006,18,0,23,15,56
10/2/2006,21,0,15,4,40
10/3/2006,18,0,22,20,60
10/4/2006,27,0,24,9,60
10/5/2006,19,0,20,20,59
10/6/2006,19,0,25,23,67
10/7/2006,23,0,29,26,78
10/8/2006,30,0,8,30,68
10/9/2006,22,0,11,13,46
10/10/2006,15,0,28,13,56
10/11/2006,29,0,20,27,76
10/12/2006,28,0,24,20,72
10/13/2006,11,0,15,29,55
10/14/2006,19,0,24,19,62
10/15/2006,22,0,11,37,70
10/16/2006,21,0,29,5,55
10/17/2006,15,0,17,16,48
10/18/2006,19,0,22,21,62
10/19/2006,17,0,18,12,47
10/20/2006,22,0,24,19,65
10/21/2006,29,0,15,23,67
10/22/2006,28,0,12,26,66
10/23/2006,13,0,13,24,50
10/24/2006,19,0,26,21,66
10/25/2006,25,0,26,30,81
10/26/2006,21,0,22,22,65
10/27/2006,21,0,13,21,55
10/28/2006,32,0,17,16,65
10/29/2006,25,0,20,15,60
10/30/2006,21,0,15,18,54
10/31/2006,32,0,22,10,64
11/1/2006,19,0,10,14,43
11/2/2006,19,0,16,31,66
11/3/2006,22,0,18,29,69
11/4/2006,26,0,23,27,76
11/5/2006,23,0,18,14,55
11/6/2006,22,0,18,8,48
11/7/2006,18,0,16,20,54
11/8/2006,19,0,19,33,71
11/9/2006,19,0,15,24,58
11/10/2006,24,0,19,19,62
11/11/2006,29,0,21,16,66
11/12/2006,24,0,24,18,66
11/13/2006,29,0,23,21,73
11/14/2006,33,0,29,12,74
11/15/2006,22,0,22,34,78
11/16/2006,14,0,6,40,60
11/17/2006,18,0,18,31,67
11/18/2006,23,0,9,18,50
11/19/2006,15,0,17,15,47
11/20/2006,18,0,11,26,55
11/21/2006,24,0,19,29,72
11/22/2006,24,0,12,13,49
11/23/2006,29,0,20,22,71
11/24/2006,22,0,18,10,50
11/25/2006,15,0,17,16,48
11/26/2006,16,0,18,28,62
11/27/2006,22,0,17,26,65
11/28/2006,24,0,20,10,54
11/29/2006,28,0,15,13,56
11/30/2006,26,0,25,24,75
12/1/2006,15,0,22,18,55
12/2/2006,26,0,25,22,73
12/3/2006,26,0,15,25,66
12/4/2006,31,0,20,16,67
12/5/2006,13,0,16,23,52
12/6/2006,16,0,17,15,48
12/7/2006,28,0,30,12,70
12/8/2006,23,0,17,19,59
12/9/2006,24,0,15,15,54
12/10/2006,34,0,26,36,96
12/11/2006,17,0,18,22,57
12/12/2006,23,0,25,21,69
12/13/2006,27,0,17,27,71
12/14/2006,22,0,17,24,63
12/15/2006,14,0,29,10,53
12/16/2006,22,0,7,12,41
12/17/2006,31,0,22,30,83
12/18/2006,14,0,7,17,38
12/19/2006,17,0,18,24,59
12/20/2006,21,0,28,24,73
12/21/2006,33,0,21,19,73
12/22/2006,27,0,23,26,76
12/23/2006,32,0,21,22,75
12/24/2006,22,0,20,15,57
12/25/2006,23,0,23,27,73
12/26/2006,17,0,14,13,44
12/27/2006,24,0,20,15,59
12/28/2006,21,0,10,31,62
12/29/2006,27,0,19,23,69
12/30/2006,24,0,22,21,67
12/31/2006,29,0,21,7,57
1/1/2007,28,0,30,14,72
1/2/2007,28,0,30,30,88
1/3/2007,31,0,12,22,65
1/4/2007,22,0,12,28,62
1/5/2007,28,0,19,23,70
1/6/2007,23,0,14,11,48
1/7/2007,26,0,26,6,58
1/8/2007,30,0,17,15,62
1/9/2007,26,0,23,15,64
1/10/2007,20,0,32,7,59
1/11/2007,27,0,24,28,79
1/12/2007,21,0,21,20,62
1/13/2007,24,0,14,23,61
1/14/2007,20,0,22,19,61
1/15/2007,22,0,19,18,59
1/16/2007,24,0,21,24,69
1/17/2007,25,0,32,31,88
1/18/2007,23,0,18,36,77
1/19/2007,32,0,22,14,68
1/20/2007,19,0,16,20,55
1/21/2007,20,0,22,9,51
1/22/2007,24,0,18,17,59
1/23/2007,19,0,21,11,51
1/24/2007,21,0,15,27,63
1/25/2007,22,0,16,17,55
1/26/2007,31,0,16,22,69
1/27/2007,20,0,23,19,62
1/28/2007,22,0,18,34,74
1/29/2007,24,0,15,11,50
1/30/2007,19,0,18,25,62
1/31/2007,28,0,8,32,68
2/1/2007,24,0,21,22,67
2/2/2007,25,0,17,24,66
2/3/2007,34,0,28,9,71
2/4/2007,21,0,17,15,53
2/5/2007,19,0,25,16,60
2/6/2007,22,0,21,23,66
2/7/2007,32,0,16,11,59
2/8/2007,27,0,22,15,64
2/9/2007,22,0,19,20,61
2/10/2007,30,0,24,27,81
2/11/2007,18,0,12,20,50
2/12/2007,31,0,16,33,80
2/13/2007,25,0,14,21,60
2/14/2007,17,0,26,26,69
2/15/2007,27,0,12,3,42
2/16/2007,21,0,17,9,47
2/17/2007,15,0,14,24,53
2/18/2007,19,0,22,10,51
2/19/2007,29,0,17,24,70
2/20/2007,34,0,28,34,96
2/21/2007,29,0,18,20,67
2/22/2007,31,0,19,21,71
2/23/2007,24,0,21,21,66
2/24/2007,18,0,29,17,64
2/25/2007,18,0,21,19,58
2/26/2007,27,0,16,15,58
2/27/2007,28,0,27,13,68
2/28/2007,23,0,19,24,66
3/1/2007,23,0,23,13,59
3/2/2007,26,0,9,29,64
3/3/2007,28,0,22,6,56
3/4/2007,10,0,16,28,54
3/5/2007,25,0,22,19,66
3/6/2007,21,0,25,18,64
3/7/2007,22,0,24,29,75
3/8/2007,16,0,26,12,54
3/9/2007,29,0,11,11,51
3/10/2007,22,0,19,28,69
3/11/2007,17,0,21,19,57
3/12/2007,29,0,21,34,84
3/13/2007,13,0,15,24,52
3/14/2007,23,0,10,3,36
3/15/2007,23,0,17,9,49
3/16/2007,17,0,27,29,73
3/17/2007,27,0,26,13,66
3/18/2007,30,0,18,29,77
3/19/2007,21,0,29,23,73
3/20/2007,19,0,16,24,59
3/21/2007,23,0,21,35,79
3/22/2007,25,0,22,34,81
3/23/2007,24,0,21,8,53
3/24/2007,27,0,18,22,67
3/25/2007,22,0,20,16,58
3/26/2007,30,0,26,18,74
3/27/2007,23,0,27,31,81
3/28/2007,20,0,23,18,61
3/29/2007,20,0,10,13,43
3/30/2007,22,0,16,4,42
3/31/2007,26,0,12,7,45
4/1/2007,16,0,22,22,60
4/2/2007,21,0,28,19,68
4/3/2007,25,0,31,18,74
4/4/2007,19,0,23,24,66
4/5/2007,25,0,14,34,73
4/6/2007,27,0,22,23,72
4/7/2007,21,0,17,17,55
4/8/2007,25,0,17,14,56
4/9/2007,27,0,30,26,83
4/10/2007,26,0,28,14,68
4/11/2007,27,0,14,29,70
4/12/2007,30,0,25,6,61
4/13/2007,26,0,21,23,70
4/14/2007,24,0,22,19,65
4/15/2007,18,0,21,16,55
4/16/2007,22,0,18,34,74
4/17/2007,13,0,27,13,53
4/18/2007,26,0,24,27,77
4/19/2007,25,0,23,9,57
4/20/2007,11,0,13,13,37
4/21/2007,26,0,19,14,59
4/22/2007,23,0,11,33,67
4/23/2007,17,0,14,14,45
4/24/2007,21,0,16,25,62
4/25/2007,25,0,10,13,48
4/26/2007,27,0,25,24,76
4/27/2007,16,0,19,27,62
4/28/2007,19,0,22,26,67
4/29/2007,24,0,15,20,59
4/30/2007,24,0,23,24,71
5/1/2007,24,0,32,26,82
5/2/2007,18,0,19,22,59
5/3/2007,32,0,14,12,58
5/4/2007,27,0,16,15,58
5/5/2007,34,0,25,17,76
5/6/2007,30,0,14,20,64
5/7/2007,24,0,18,22,64
5/8/2007,27,0,19,6,52
5/9/2007,24,0,12,16,52
5/10/2007,20,0,17,18,55
5/11/2007,21,0,22,15,58
5/12/2007,28,0,26,36,90
5/13/2007,16,0,17,20,53
5/14/2007,20,0,24,11,55
5/15/2007,23,0,26,18,67
5/16/2007,29,0,20,26,75
5/17/2007,17,0,15,26,58
5/18/2007,16,0,29,25,70
5/19/2007,19,0,21,21,61
5/20/2007,24,0,12,17,53
5/21/2007,21,0,26,31,78
5/22/2007,22,0,30,15,67
5/23/2007,22,0,33,30,85
5/24/2007,33,0,30,12,75
5/25/2007,27,0,10,13,50
5/26/2007,16,0,20,11,47
5/27/2007,23,0,12,21,56
5/28/2007,15,0,22,22,59
5/29/2007,18,0,27,12,57
5/30/2007,19,0,20,30,69
5/31/2007,22,0,28,23,73
6/1/2007,21,0,19,27,67
6/2/2007,24,0,22,22,68
6/3/2007,17,0,29,18,64
6/4/2007,19,0,23,21,63
6/5/2007,13,0,25,16,54
6/6/2007,15,0,22,13,50
6/7/2007,21,0,29,18,68
6/8/2007,21,0,18,9,48
6/9/2007,27,0,20,12,59
6/10/2007,24,0,21,18,63
6/11/2007,15,0,25,14,54
6/12/2007,27,0,10,7,44
6/13/2007,21,0,23,26,70
6/14/2007,23,0,27,20,70
6/15/2007,21,0,10,24,55
6/16/2007,21,0,15,21,57
6/17/2007,19,0,20,15,54
6/18/2007,27,0,8,34,69
6/19/2007,16,0,13,34,63
6/20/2007,18,0,28,26,72
6/21/2007,28,0,13,12,53
6/22/2007,20,0,27,15,62
6/23/2007,26,0,23,22,71
6/24/2007,24,0,12,22,58
6/25/2007,16,0,28,31,75
6/26/2007,17,0,27,22,66
6/27/2007,21,0,24,33,78
6/28/2007,22,0,20,21,63
6/29/2007,24,0,16,31,71
6/30/2007,19,0,28,29,76
7/1/2007,17,0,13,15,45
7/2/2007,19,0,14,27,60
7/3/2007,26,0,17,12,55
7/4/2007,16,0,19,28,63
7/5/2007,22,0,12,32,66
7/6/2007,17,0,21,17,55
7/7/2007,32,0,14,15,61
7/8/2007,22,0,20,9,51
7/9/2007,12,0,16,15,43
7/10/2007,25,0,26,36,87
7/11/2007,19,0,19,28,66
7/12/2007,26,0,19,17,62
7/13/2007,23,0,23,12,58
7/14/2007,23,0,22,14,59
7/15/2007,22,0,23,20,65
7/16/2007,27,0,10,32,69
7/17/2007,24,0,9,3,36
7/18/2007,23,0,21,15,59
7/19/2007,27,0,20,22,69
7/20/2007,16,0,19,23,58
7/21/2007,19,0,21,17,57
7/22/2007,17,0,28,25,70
7/23/2007,31,0,28,17,76
7/24/2007,22,0,14,28,64
7/25/2007,29,0,14,20,63
7/26/2007,15,0,23,33,71
7/27/2007,29,0,30,20,79
7/28/2007,30,0,29,18,77
7/29/2007,26,0,19,20,65
7/30/2007,21,0,20,21,62
7/31/2007,22,0,26,16,64
8/1/2007,24,0,21,29,74
8/2/2007,18,0,18,17,53
8/3/2007,21,0,23,15,59
8/4/2007,28,0,25,9,62
8/5/2007,24,0,23,19,66
8/6/2007,17,0,29,21,67
8/7/2007,27,0,12,12,51
8/8/2007,26,0,21,16,63
8/9/2007,20,0,14,12,46
8/10/2007,27,0,23,21,71
8/11/2007,17,0,22,24,63
8/12/2007,19,0,24,32,75
8/13/2007,25,0,15,13,53
8/14/2007,21,0,11,23,55
8/15/2007,25,0,9,23,57
8/16/2007,30,0,23,25,78
8/17/2007,29,0,21,17,67
8/18/2007,26,0,19,27,72
8/19/2007,13,0,19,31,63
8/20/2007,19,0,23,14,56
8/21/2007,20,0,17,15,52
8/22/2007,13,0,13,3,29
8/23/2007,24,0,19,14,57
8/24/2007,24,0,26,25,75
8/25/2007,31,0,22,26,79
8/26/2007,17,0,19,11,47
8/27/2007,24,0,30,13,67
8/28/2007,16,0,22,25,63
8/29/2007,22,0,20,21,63
8/30/2007,29,0,31,31,91
8/31/2007,19,0,12,9,40
9/1/2007,19,0,15,37,71
9/2/2007,26,0,12,5,43
9/3/2007,30,0,19,27,76
9/4/2007,32,0,19,29,80
9/5/2007,19,0,20,17,56
9/6/2007,29,0,23,8,60
9/7/2007,26,0,17,11,54
9/8/2007,21,0,20,13,54
9/9/2007,23,0,16,23,62
9/10/2007,25,0,17,24,66
9/11/2007,16,0,18,7,41
9/12/2007,26,0,14,23,63
9/13/2007,22,0,12,22,56
9/14/2007,28,0,26,17,71
9/15/2007,20,0,23,8,51
9/16/2007,31,0,27,20,78
9/17/2007,29,0,26,16,71
9/18/2007,28,0,15,8,51
9/19/2007,22,0,8,29,59
9/20/2007,16,0,26,20,62
9/21/2007,25,0,25,31,81
9/22/2007,27,0,21,26,74
9/23/2007,30,0,19,22,71
9/24/2007,12,0,14,17,43
9/25/2007,22,0,28,22,72
9/26/2007,20,0,28,22,70
9/27/2007,18,0,18,9,45
9/28/2007,26,0,15,10,51
9/29/2007,20,0,19,20,59
9/30/2007,22,0,19,18,59
10/1/2007,20,0,27,28,75
10/2/2007,26,0,16,22,64
10/3/2007,17,0,19,15,51
10/4/2007,22,0,17,21,60
10/5/2007,23,0,29,16,68
10/6/2007,25,0,19,16,60
10/7/2007,13,0,25,13,51
10/8/2007,32,0,24,18,74
10/9/2007,21,0,18,14,53
10/10/2007,13,0,24,37,74
10/11/2007,13,0,25,29,67
10/12/2007,24,0,24,19,67
10/13/2007,34,0,19,12,65
10/14/2007,17,0,25,13,55
10/15/2007,22,0,11,5,38
10/16/2007,17,0,13,12,42
10/17/2007,15,0,17,19,51
10/18/2007,28,0,15,23,66
10/19/2007,19,0,9,27,55
10/20/2007,19,0,21,22,62
10/21/2007,26,0,24,30,80
10/22/2007,18,0,19,25,62
10/23/2007,25,0,17,13,55
10/24/2007,18,0,18,20,56
10/25/2007,33,0,18,22,73
10/26/2007,29,0,24,22,75
10/27/2007,26,0,23,30,79
10/28/2007,17,0,19,13,49
10/29/2007,24,0,15,31,70
10/30/2007,26,0,19,15,60
10/31/2007,25,0,23,12,60
11/1/2007,24,0,25,19,68
11/2/2007,26,0,24,24,74
11/3/2007,22,0,19,27,68
11/4/2007,28,0,24,11,63
11/5/2007,29,0,14,7,50
11/6/2007,29,0,23,13,65
11/7/2007,27,0,18,20,65
11/8/2007,17,0,24,29,70
11/9/2007,20,0,23,15,58
11/10/2007,28,0,31,16,75
11/11/2007,18,0,23,16,57
11/12/2007,31,0,27,27,85
11/13/2007,23,0,16,8,47
11/14/2007,32,0,18,11,61
11/15/2007,21,0,22,17,60
11/16/2007,26,0,24,16,66
11/17/2007,20,0,20,18,58
11/18/2007,14,0,12,10,36
11/19/2007,19,0,13,34,66
11/20/2007,24,0,24,22,70
11/21/2007,26,0,9,27,62
11/22/2007,28,0,23,13,64
11/23/2007,24,0,9,26,59
11/24/2007,23,0,16,26,65
11/25/2007,29,0,19,16,64
11/26/2007,16,0,13,22,51
11/27/2007,15,0,26,12,53
11/28/2007,16,0,18,10,44
11/29/2007,21,0,23,31,75
11/30/2007,33,0,25,25,83
12/1/2007,24,0,17,32,73
12/2/2007,29,0,29,19,77
12/3/2007,24,0,31,24,79
12/4/2007,18,0,29,23,70
12/5/2007,30,0,17,27,74
12/6/2007,21,0,20,25,66
12/7/2007,24,0,21,15,60
12/8/2007,21,0,21,14,56
12/9/2007,23,0,20,25,68
12/10/2007,34,0,9,25,68
12/11/2007,30,0,10,14,54
12/12/2007,24,0,21,19,64
12/13/2007,26,0,17,12,55
12/14/2007,21,0,21,26,68
12/15/2007,23,0,21,16,60
12/16/2007,19,0,30,11,60
12/17/2007,16,0,15,26,57
12/18/2007,24,0,27,6,57
12/19/2007,12,0,24,9,45
12/20/2007,19,0,29,19,67
12/21/2007,28,0,17,11,56
12/22/2007,28,0,14,31,73
12/23/2007,16,0,20,19,55
12/24/2007,22,0,21,24,67
12/25/2007,26,0,16,21,63
12/26/2007,21,0,16,23,60
12/27/2007,27,0,22,28,77
12/28/2007,26,0,26,19,71
12/29/2007,19,0,18,10,47
12/30/2007,24,0,17,27,68
12/31/2007,21,0,23,15,59
1/1/2008,24,0,14,29,67
1/2/2008,19,0,17,12,48
1/3/2008,34,0,13,17,64
1/4/2008,15,0,23,19,57
1/5/2008,10,0,26,21,57
1/6/2008,24,0,22,22,68
1/7/2008,16,0,19,15,50
1/8/2008,17,0,16,22,55
1/9/2008,20,0,33,15,68
1/10/2008,25,0,20,13,58
1/11/2008,24,0,20,13,57
1/12/2008,20,0,15,33,68
1/13/2008,18,0,10,22,50
1/14/2008,20,0,30,16,66
1/15/2008,23,0,18,19,60
1/16/2008,25,0,15,20,60
1/17/2008,26,0,18,24,68
1/18/2008,23,0,26,14,63
1/19/2008,25,0,26,38,89
1/20/2008,27,0,28,18,73
1/21/2008,29,0,18,21,68
1/22/2008,22,0,17,11,50
1/23/2008,24,0,19,12,55
1/24/2008,15,0,17,29,61
1/25/2008,13,0,22,16,51
1/26/2008,22,0,19,31,72
1/27/2008,31,0,17,21,69
1/28/2008,18,0,21,15,54
1/29/2008,28,0,19,28,75
1/30/2008,29,0,22,12,63
1/31/2008,22,0,28,13,63
2/1/2008,27,0,20,3,50
2/2/2008,23,0,23,10,56
2/3/2008,28,0,21,9,58
2/4/2008,19,0,20,28,67
2/5/2008,14,0,20,26,60
2/6/2008,23,0,18,17,58
2/7/2008,28,0,13,16,57
2/8/2008,22,0,33,23,78
2/9/2008,31,0,21,11,63
2/10/2008,19,0,14,27,60
2/11/2008,25,0,25,17,67
2/12/2008,22,0,27,21,70
2/13/2008,20,0,17,24,61
2/14/2008,29,0,21,19,69
2/15/2008,21,0,22,26,69
2/16/2008,28,0,20,21,69
2/17/2008,22,0,22,31,75
2/18/2008,31,0,20,34,85
2/19/2008,26,0,16,11,53
2/20/2008,30,0,21,37,88
2/21/2008,27,0,18,30,75
2/22/2008,23,0,23,22,68
2/23/2008,26,0,24,18,68
2/24/2008,15,0,30,15,60
2/25/2008,17,0,20,26,63
2/26/2008,14,0,15,11,40
2/27/2008,19,0,23,17,59
2/28/2008,23,0,20,15,58
2/29/2008,17,0,23,27,67
3/1/2008,20,0,11,35,66
3/2/2008,35,0,13,29,77
3/3/2008,27,0,19,19,65
3/4/2008,25,0,13,33,71
3/5/2008,29,0,21,13,63
3/6/2008,20,0,14,17,51
3/7/2008,29,0,28,17,74
3/8/2008,26,0,27,20,73
3/9/2008,24,0,27,16,67
3/10/2008,25,0,17,31,73
3/11/2008,31,0,13,20,64
3/12/2008,19,0,25,18,62
3/13/2008,23,0,16,19,58
3/14/2008,27,0,24,13,64
3/15/2008,27,0,13,10,50
3/16/2008,28,0,30,24,82
3/17/2008,30,0,14,35,79
3/18/2008,23,0,23,24,70
3/19/2008,33,0,24,17,74
3/20/2008,32,0,22,32,86
3/21/2008,17,0,24,15,56
3/22/2008,26,0,16,25,67
3/23/2008,22,0,21,26,69
3/24/2008,24,0,20,12,56
3/25/2008,25,0,28,21,74
3/26/2008,26,0,9,20,55
3/27/2008,28,0,20,22,70
3/28/2008,15,0,15,25,55
3/29/2008,23,0,15,30,68
3/30/2008,19,0,22,17,58
3/31/2008,18,0,21,16,55
4/1/2008,14,0,24,19,57
4/2/2008,22,0,11,26,59
4/3/2008,19,0,25,28,72
4/4/2008,23,0,26,13,62
4/5/2008,23,0,18,7,48
4/6/2008,23,0,27,16,66
4/7/2008,24,0,17,29,70
4/8/2008,24,0,15,20,59
4/9/2008,20,0,27,27,74
4/10/2008,28,0,13,35,76
4/11/2008,30,0,16,28,74
4/12/2008,25,0,23,26,74
4/13/2008,21,0,21,18,60
4/14/2008,23,0,24,13,60
4/15/2008,26,0,21,30,77
4/16/2008,12,0,23,20,55
4/17/2008,23,0,23,12,58
4/18/2008,31,0,29,27,87
4/19/2008,22,0,22,23,67
4/20/2008,22,0,23,28,73
4/21/2008,29,0,30,34,93
4/22/2008,23,0,16,21,60
4/23/2008,24,0,13,17,54
4/24/2008,24,0,18,17,59
4/25/2008,20,0,26,21,67
4/26/2008,21,0,14,17,52
4/27/2008,28,0,21,15,64
4/28/2008,26,0,19,30,75
4/29/2008,24,0,21,11,56
4/30/2008,20,0,27,14,61
5/1/2008,23,0,23,21,67
5/2/2008,19,0,11,11,41
5/3/2008,30,0,13,24,67
5/4/2008,25,0,18,26,69
5/5/2008,23,0,23,14,60
5/6/2008,24,0,14,17,55
5/7/2008,25,0,8,4,37
5/8/2008,18,0,26,15,59
5/9/2008,27,0,24,22,73
5/10/2008,29,0,27,28,84
5/11/2008,24,0,24,32,80
5/12/2008,19,0,14,10,43
5/13/2008,29,0,21,23,73
5/14/2008,18,0,10,23,51
5/15/2008,18,0,23,23,64
5/16/2008,31,0,16,29,76
5/17/2008,22,0,12,20,54
5/18/2008,13,0,25,19,57
5/19/2008,23,0,18,17,58
5/20/2008,27,0,16,35,78
5/21/2008,20,0,32,18,70
5/22/2008,30,0,12,10,52
5/23/2008,18,0,19,16,53
5/24/2008,16,0,17,36,69
5/25/2008,12,0,25,35,72
5/26/2008,24,0,17,7,48
5/27/2008,26,0,30,23,79
5/28/2008,24,0,21,23,68
5/29/2008,24,0,25,26,75
5/30/2008,24,0,20,22,66
5/31/2008,27,0,22,12,61
6/1/2008,11,0,18,12,41
6/2/2008,25,0,22,14,61
6/3/2008,21,0,23,17,61
6/4/2008,29,0,27,17,73
6/5/2008,24,0,16,13,53
6/6/2008,18,0,17,21,56
6/7/2008,22,0,16,1,39
6/8/2008,18,0,25,25,68
6/9/2008,20,0,27,17,64
6/10/2008,25,0,33,22,80
6/11/2008,21,0,23,12,56
6/12/2008,25,0,21,17,63
6/13/2008,17,0,21,20,58
6/14/2008,28,0,23,25,76
6/15/2008,17,0,18,18,53
6/16/2008,26,0,20,22,68
6/17/2008,19,0,12,7,38
6/18/2008,21,0,24,13,58
6/19/2008,23,0,22,26,71
6/20/2008,30,0,24,5,59
6/21/2008,22,0,22,15,59
6/22/2008,27,0,28,21,76
6/23/2008,29,0,24,26,79
6/24/2008,31,0,13,34,78
6/25/2008,27,0,23,21,71
6/26/2008,25,0,19,7,51
6/27/2008,26,0,16,14,56
6/28/2008,29,0,22,17,68
6/29/2008,19,0,16,34,69
6/30/2008,24,0,16,30,70
7/1/2008,25,0,25,32,82
7/2/2008,28,0,27,5,60
7/3/2008,27,0,17,21,65
7/4/2008,23,0,18,21,62
7/5/2008,20,0,28,12,60
7/6/2008,23,0,24,20,67
7/7/2008,16,0,20,23,59
7/8/2008,30,0,19,30,79
7/9/2008,26,0,22,14,62
7/10/2008,32,0,21,23,76
7/11/2008,29,0,28,22,79
7/12/2008,19,0,13,7,39
7/13/2008,26,0,26,40,92
7/14/2008,20,0,23,22,65
7/15/2008,23,0,27,12,62
7/16/2008,25,0,25,24,74
7/17/2008,24,0,10,37,71
7/18/2008,20,0,15,12,47
7/19/2008,20,0,20,14,54
7/20/2008,27,0,22,19,68
7/21/2008,18,0,15,26,59
7/22/2008,15,0,24,30,69
7/23/2008,27,0,21,14,62
7/24/2008,21,0,23,24,68
7/25/2008,31,0,17,24,72
7/26/2008,26,0,15,27,68
7/27/2008,27,0,23,19,69
7/28/2008,22,0,23,23,68
7/29/2008,30,0,25,16,71
7/30/2008,18,0,23,11,52
7/31/2008,33,0,28,11,72
8/1/2008,27,0,16,24,67
8/2/2008,34,0,25,13,72
8/3/2008,25,0,17,33,75
8/4/2008,22,0,25,14,61
8/5/2008,21,0,14,18,53
8/6/2008,19,0,25,18,62
8/7/2008,21,0,16,15,52
8/8/2008,22,0,20,27,69
8/9/2008,24,0,13,30,67
8/10/2008,32,0,10,6,48
8/11/2008,27,0,25,14,66
8/12/2008,17,0,29,31,77
8/13/2008,27,0,27,25,79
8/14/2008,16,0,25,22,63
8/15/2008,28,0,27,12,67
8/16/2008,25,0,18,23,66
8/17/2008,22,0,19,21,62
8/18/2008,24,0,20,20,64
8/19/2008,25,0,22,15,62
8/20/2008,23,0,6,8,37
8/21/2008,13,0,14,16,43
8/22/2008,22,0,12,30,64
8/23/2008,22,0,20,12,54
8/24/2008,17,0,25,23,65
8/25/2008,20,0,14,19,53
8/26/2008,23,0,15,18,56
8/27/2008,15,0,20,7,42
8/28/2008,18,0,21,12,51
8/29/2008,20,0,12,24,56
8/30/2008,27,0,15,24,66
8/31/2008,25,0,23,18,66
9/1/2008,26,0,22,13,61
9/2/2008,25,0,17,14,56
9/3/2008,23,0,28,30,81
9/4/2008,17,0,19,9,45
9/5/2008,27,0,19,14,60
9/6/2008,30,0,25,14,69
9/7/2008,20,0,23,10,53
9/8/2008,18,0,25,17,60
9/9/2008,19,0,17,24,60
9/10/2008,18,0,22,21,61
9/11/2008,25,0,25,29,79
9/12/2008,25,0,22,14,61
9/13/2008,21,0,18,20,59
9/14/2008,21,0,18,25,64
9/15/2008,34,0,17,12,63
9/16/2008,21,0,17,20,58
9/17/2008,19,0,30,16,65
9/18/2008,19,0,25,23,67
9/19/2008,23,0,27,27,77
9/20/2008,25,0,20,23,68
9/21/2008,18,0,10,16,44
9/22/2008,27,0,20,7,54
9/23/2008,28,0,27,20,75
9/24/2008,21,0,24,30,75
9/25/2008,16,0,14,25,55
9/26/2008,17,0,22,29,68
9/27/2008,26,0,19,14,59
9/28/2008,25,0,14,21,60
9/29/2008,27,0,30,21,78
9/30/2008,23,0,18,24,65
10/1/2008,20,0,16,27,63
10/2/2008,27,0,32,19,78
10/3/2008,21,0,15,13,49
10/4/2008,21,0,33,9,63
10/5/2008,28,0,18,9,55
10/6/2008,26,0,11,34,71
10/7/2008,18,0,12,20,50
10/8/2008,29,0,10,15,54
10/9/2008,28,0,21,31,80
10/10/2008,23,0,19,13,55
10/11/2008,17,0,14,13,44
10/12/2008,19,0,22,19,60
10/13/2008,25,0,15,29,69
10/14/2008,22,0,23,0,45
10/15/2008,30,0,11,18,59
10/16/2008,23,0,20,22,65
10/17/2008,25,0,10,17,52
10/18/2008,15,0,22,3,40
10/19/2008,14,0,19,22,55
10/20/2008,18,0,13,24,55
10/21/2008,26,0,24,27,77
10/22/2008,30,0,10,11,51
10/23/2008,22,0,26,26,74
10/24/2008,16,0,22,29,67
10/25/2008,29,0,12,23,64
10/26/2008,16,0,24,15,55
10/27/2008,24,0,18,19,61
10/28/2008,23,0,13,11,47
10/29/2008,25,0,16,20,61
10/30/2008,22,0,29,30,81
10/31/2008,24,0,19,14,57
11/1/2008,25,0,21,18,64
11/2/2008,29,0,13,21,63
11/3/2008,14,0,16,22,52
11/4/2008,21,0,20,1,42
11/5/2008,20,0,23,28,71
11/6/2008,22,0,25,24,71
11/7/2008,26,0,24,19,69
11/8/2008,28,0,21,16,65
11/9/2008,29,0,13,21,63
11/10/2008,20,0,27,23,70
11/11/2008,28,0,18,22,68
11/12/2008,26,0,23,5,54
11/13/2008,29,0,23,19,71
11/14/2008,13,0,19,20,52
11/15/2008,21,0,26,28,75
11/16/2008,19,0,29,23,71
11/17/2008,29,0,24,27,80
11/18/2008,18,0,11,17,46
11/19/2008,22,0,10,13,45
11/20/2008,17,0,17,23,57
11/21/2008,25,0,15,27,67
11/22/2008,16,0,25,21,62
11/23/2008,21,0,19,21,61
11/24/2008,20,0,14,28,62
11/25/2008,22,0,24,11,57
11/26/2008,24,0,15,37,76
11/27/2008,30,0,21,10,61
11/28/2008,35,0,28,30,93
11/29/2008,21,0,29,28,78
11/30/2008,16,0,14,12,42
12/1/2008,15,0,25,30,70
12/2/2008,24,0,15,30,69
12/3/2008,14,0,14,22,50
12/4/2008,27,0,10,6,43
12/5/2008,11,0,32,23,66
12/6/2008,24,0,26,13,63
12/7/2008,18,0,8,21,47
12/8/2008,17,0,21,15,53
12/9/2008,17,0,7,21,45
12/10/2008,29,0,27,27,83
12/11/2008,24,0,19,12,55
12/12/2008,28,0,25,17,70
12/13/2008,19,0,11,17,47
12/14/2008,19,0,17,33,69
12/15/2008,12,0,22,23,57
12/16/2008,17,0,16,1,34
12/17/2008,28,0,26,24,78
12/18/2008,24,0,17,24,65
12/19/2008,32,0,14,12,58
12/20/2008,18,0,23,14,55
12/21/2008,32,0,30,14,76
12/22/2008,23,0,18,18,59
12/23/2008,19,0,17,16,52
12/24/2008,18,0,20,24,62
12/25/2008,20,0,27,26,73
12/26/2008,26,0,22,16,64
12/27/2008,20,0,26,17,63
12/28/2008,27,0,10,27,64
12/29/2008,24,0,12,29,65
12/30/2008,14,0,22,25,61
12/31/2008,27,0,21,12,60
1/1/2009,20,0,23,20,63
1/2/2009,16,0,17,33,66
1/3/2009,22,0,23,15,60
1/4/2009,19,0,16,9,44
1/5/2009,20,0,16,17,53
1/6/2009,21,0,14,17,52
1/7/2009,23,0,21,24,68
1/8/2009,17,0,16,34,67
1/9/2009,21,0,29,22,72
1/10/2009,27,0,29,30,86
1/11/2009,24,0,13,4,41
1/12/2009,17,0,10,23,50
1/13/2009,28,0,25,10,63
1/14/2009,18,0,25,22,65
1/15/2009,27,0,21,19,67
1/16/2009,19,0,18,18,55
1/17/2009,28,0,19,6,53
1/18/2009,26,0,16,14,56
1/19/2009,26,0,15,33,74
1/20/2009,25,0,26,18,69
1/21/2009,29,0,28,21,78
1/22/2009,25,0,31,12,68
1/23/2009,13,0,18,23,54
1/24/2009,19,0,21,13,53
1/25/2009,18,0,22,30,70
1/26/2009,25,0,11,28,64
1/27/2009,20,0,26,11,57
1/28/2009,17,0,13,9,39
1/29/2009,25,0,23,20,68
1/30/2009,13,0,24,29,66
1/31/2009,24,0,12,16,52
2/1/2009,17,0,30,18,65
2/2/2009,29,0,25,19,73
2/3/2009,24,0,20,17,61
2/4/2009,15,0,17,27,59
2/5/2009,21,0,19,28,68
2/6/2009,18,0,25,28,71
2/7/2009,18,0,15,11,44
2/8/2009,22,0,13,32,67
2/9/2009,28,0,16,22,66
2/10/2009,25,0,12,6,43
2/11/2009,20,0,13,18,51
2/12/2009,26,0,25,26,77
2/13/2009,13,0,17,21,51
2/14/2009,19,0,22,28,69
2/15/2009,26,0,28,28,82
2/16/2009,15,0,16,12,43
2/17/2009,19,0,23,18,60
2/18/2009,34,0,16,15,65
2/19/2009,35,0,14,14,63
2/20/2009,16,0,20,31,67
2/21/2009,21,0,19,30,70
2/22/2009,30,0,27,23,80
2/23/2009,21,0,21,18,60
2/24/2009,23,0,14,29,66
2/25/2009,28,0,24,32,84
2/26/2009,21,0,25,18,64
2/27/2009,24,0,24,32,80
2/28/2009,15,0,23,19,57
3/1/2009,36,0,9,21,66
3/2/2009,19,0,17,15,51
3/3/2009,18,0,16,23,57
3/4/2009,19,0,28,23,70
3/5/2009,26,0,10,16,52
3/6/2009,24,0,22,25,71
3/7/2009,20,0,11,30,61
3/8/2009,17,0,19,20,56
3/9/2009,25,0,16,16,57
3/10/2009,34,0,20,24,78
3/11/2009,20,0,18,30,68
3/12/2009,27,0,21,24,72
3/13/2009,32,0,17,18,67
3/14/2009,21,0,25,14,60
3/15/2009,17,0,22,30,69
3/16/2009,24,0,19,27,70
3/17/2009,18,0,19,24,61
3/18/2009,23,0,15,23,61
3/19/2009,29,0,20,19,68
3/20/2009,23,0,23,20,66
3/21/2009,20,0,18,13,51
3/22/2009,32,0,11,18,61
3/23/2009,27,0,21,12,60
3/24/2009,25,0,16,10,51
3/25/2009,21,0,19,15,55
3/26/2009,21,0,22,29,72
3/27/2009,16,0,25,17,58
3/28/2009,23,0,17,15,55
3/29/2009,25,0,21,26,72
3/30/2009,27,0,25,20,72
3/31/2009,30,0,20,16,66
4/1/2009,26,0,15,16,57
4/2/2009,28,0,11,24,63
4/3/2009,25,0,18,34,77
4/4/2009,27,0,11,16,54
4/5/2009,22,0,26,10,58
4/6/2009,12,0,20,25,57
4/7/2009,30,0,13,16,59
4/8/2009,23,0,24,14,61
4/9/2009,19,0,21,9,49
4/10/2009,28,0,22,12,62
4/11/2009,34,0,21,24,79
4/12/2009,26,0,25,32,83
4/13/2009,27,0,17,28,72
4/14/2009,24,0,30,28,82
4/15/2009,27,0,12,10,49
4/16/2009,15,0,17,26,58
4/17/2009,20,0,32,12,64
4/18/2009,26,0,21,20,67
4/19/2009,22,0,12,23,57
4/20/2009,18,0,18,16,52
4/21/2009,23,0,18,22,63
4/22/2009,22,0,21,34,77
4/23/2009,25,0,26,31,82
4/24/2009,29,0,16,18,63
4/25/2009,30,0,27,9,66
4/26/2009,27,0,22,28,77
4/27/2009,17,0,22,18,57
4/28/2009,22,0,13,15,50
4/29/2009,23,0,19,28,70
4/30/2009,24,0,21,27,72
5/1/2009,21,0,20,26,67
5/2/2009,18,0,23,24,65
5/3/2009,15,0,20,17,52
5/4/2009,29,0,16,36,81
5/5/2009,26,0,17,29,72
5/6/2009,21,0,14,8,43
5/7/2009,13,0,31,19,63
5/8/2009,22,0,8,10,40
5/9/2009,26,0,21,5,52
5/10/2009,20,0,23,26,69
5/11/2009,16,0,18,11,45
5/12/2009,19,0,12,13,44
5/13/2009,18,0,13,18,49
5/14/2009,20,0,20,24,64
5/15/2009,27,0,26,17,70
5/16/2009,16,0,16,13,45
5/17/2009,15,0,15,17,47
5/18/2009,31,0,28,29,88
5/19/2009,15,0,23,14,52
5/20/2009,21,0,15,16,52
5/21/2009,13,0,17,29,59
5/22/2009,23,0,32,32,87
5/23/2009,19,0,14,18,51
5/24/2009,28,0,20,25,73
5/25/2009,30,0,27,26,83
5/26/2009,20,0,27,26,73
5/27/2009,23,0,18,17,58
5/28/2009,24,0,29,20,73
5/29/2009,24,0,20,25,69
5/30/2009,19,0,25,18,62
5/31/2009,12,0,25,7,44
6/1/2009,22,0,12,33,67
6/2/2009,31,0,28,15,74
6/3/2009,23,0,17,20,60
6/4/2009,22,0,24,27,73
6/5/2009,22,0,22,20,64
6/6/2009,27,0,11,16,54
6/7/2009,25,0,17,10,52
6/8/2009,30,0,15,20,65
6/9/2009,24,0,20,24,68
6/10/2009,30,0,12,19,61
6/11/2009,34,0,13,18,65
6/12/2009,22,0,17,13,52
6/13/2009,26,0,28,25,79
6/14/2009,27,0,22,17,66
6/15/2009,25,0,20,18,63
6/16/2009,26,0,20,32,78
6/17/2009,24,0,22,15,61
6/18/2009,22,0,28,27,77
6/19/2009,20,0,25,32,77
6/20/2009,28,0,13,25,66
6/21/2009,18,0,26,9,53
6/22/2009,16,0,18,15,49
6/23/2009,21,0,23,10,54
6/24/2009,17,0,24,22,63
6/25/2009,25,0,11,29,65
6/26/2009,22,0,15,12,49
6/27/2009,13,0,15,10,38
6/28/2009,27,0,24,17,68
6/29/2009,19,0,24,19,62
6/30/2009,25,0,13,16,54
7/1/2009,22,0,20,24,66
7/2/2009,23,0,17,9,49
7/3/2009,28,0,15,28,71
7/4/2009,24,0,27,15,66
7/5/2009,20,0,14,26,60
7/6/2009,24,0,23,21,68
7/7/2009,22,0,21,33,76
7/8/2009,23,0,22,23,68
7/9/2009,22,0,23,17,62
7/10/2009,20,0,19,14,53
7/11/2009,30,0,19,29,78
7/12/2009,25,0,26,16,67
7/13/2009,21,0,25,15,61
7/14/2009,21,0,31,12,64
7/15/2009,24,0,26,24,74
7/16/2009,20,0,19,23,62
7/17/2009,19,0,29,24,72
7/18/2009,19,0,28,18,65
7/19/2009,23,0,16,27,66
7/20/2009,28,0,23,13,64
7/21/2009,16,0,23,16,55
7/22/2009,34,0,23,25,82
7/23/2009,28,0,21,20,69
7/24/2009,26,0,16,33,75
7/25/2009,15,0,23,25,63
7/26/2009,24,0,12,18,54
7/27/2009,29,0,32,23,84
7/28/2009,23,0,13,3,39
7/29/2009,18,0,29,10,57
7/30/2009,24,0,27,34,85
7/31/2009,24,0,25,20,69
8/1/2009,16,0,18,20,54
8/2/2009,19,0,16,20,55
8/3/2009,24,0,12,16,52
8/4/2009,22,0,28,17,67
8/5/2009,32,0,19,28,79
8/6/2009,18,0,28,31,77
8/7/2009,27,0,22,22,71
8/8/2009,29,0,31,9,69
8/9/2009,22,0,19,18,59
8/10/2009,21,0,20,21,62
8/11/2009,25,0,14,15,54
8/12/2009,30,0,21,6,57
8/13/2009,15,0,24,27,66
8/14/2009,24,0,23,19,66
8/15/2009,25,0,20,14,59
8/16/2009,29,0,26,23,78
8/17/2009,31,0,11,14,56
8/18/2009,20,0,18,14,52
8/19/2009,26,0,13,15,54
8/20/2009,14,0,21,31,66
8/21/2009,22,0,22,15,59
8/22/2009,20,0,17,29,66
8/23/2009,23,0,18,18,59
8/24/2009,28,0,17,23,68
8/25/2009,26,0,19,29,74
8/26/2009,17,0,22,4,43
8/27/2009,29,0,22,10,61
8/28/2009,26,0,18,20,64
8/29/2009,29,0,15,12,56
8/30/2009,25,0,23,37,85
8/31/2009,25,0,25,23,73
9/1/2009,19,0,19,28,66
9/2/2009,19,0,20,23,62
9/3/2009,24,0,18,8,50
9/4/2009,28,0,14,20,62
9/5/2009,33,0,18,21,72
9/6/2009,17,0,26,26,69
9/7/2009,16,0,25,12,53
9/8/2009,23,0,25,30,78
9/9/2009,26,0,21,6,53
9/10/2009,15,0,13,24,52
9/11/2009,29,0,25,12,66
9/12/2009,21,0,21,29,71
9/13/2009,28,0,15,11,54
9/14/2009,28,0,15,22,65
9/15/2009,27,0,17,15,59
9/16/2009,19,0,21,32,72
9/17/2009,17,0,15,17,49
9/18/2009,30,0,21,15,66
9/19/2009,21,0,22,29,72
9/20/2009,26,0,23,27,76
9/21/2009,34,0,21,21,76
9/22/2009,31,0,18,14,63
9/23/2009,23,0,27,18,68
9/24/2009,27,0,22,21,70
9/25/2009,17,0,21,17,55
9/26/2009,19,0,13,21,53
9/27/2009,26,0,14,21,61
9/28/2009,21,0,13,22,56
9/29/2009,17,0,22,15,54
9/30/2009,33,0,29,11,73
10/1/2009,27,0,23,23,73
10/2/2009,23,0,20,28,71
10/3/2009,26,0,17,29,72
10/4/2009,31,0,12,16,59
10/5/2009,25,0,20,26,71
10/6/2009,26,0,13,16,55
10/7/2009,18,0,25,21,64
10/8/2009,26,0,15,9,50
10/9/2009,28,0,18,17,63
10/10/2009,16,0,28,17,61
10/11/2009,21,0,24,14,59
10/12/2009,29,0,26,8,63
10/13/2009,24,0,12,12,48
10/14/2009,22,0,24,21,67
10/15/2009,21,0,27,23,71
10/16/2009,28,0,23,2,53
10/17/2009,26,0,21,30,77
10/18/2009,13,0,12,21,46
10/19/2009,21,0,21,20,62
10/20/2009,16,0,21,24,61
10/21/2009,32,0,28,12,72
10/22/2009,31,0,21,21,73
10/23/2009,24,0,19,11,54
10/24/2009,29,0,19,32,80
10/25/2009,14,0,18,28,60
10/26/2009,18,0,20,20,58
10/27/2009,28,0,26,16,70
10/28/2009,19,0,19,22,60
10/29/2009,21,0,27,16,64
10/30/2009,23,0,18,26,67
10/31/2009,18,0,17,31,66
11/1/2009,25,0,15,26,66
11/2/2009,24,0,17,18,59
11/3/2009,23,0,20,17,60
11/4/2009,17,0,24,27,68
11/5/2009,17,0,22,10,49
11/6/2009,22,0,15,4,41
11/7/2009,32,0,34,23,89
11/8/2009,20,0,8,24,52
11/9/2009,30,0,19,13,62
11/10/2009,16,0,14,20,50
11/11/2009,23,0,24,17,64
11/12/2009,22,0,17,21,60
11/13/2009,23,0,25,19,67
11/14/2009,20,0,15,25,60
11/15/2009,27,0,17,27,71
11/16/2009,25,0,17,19,61
11/17/2009,26,0,24,29,79
11/18/2009,19,0,13,31,63
11/19/2009,22,0,20,7,49
11/20/2009,30,0,25,20,75
11/21/2009,23,0,14,23,60
11/22/2009,25,0,18,28,71
11/23/2009,29,0,15,15,59
11/24/2009,20,0,20,16,56
11/25/2009,19,0,17,20,56
11/26/2009,15,0,26,9,50
11/27/2009,19,0,24,13,56
11/28/2009,20,0,20,29,69
11/29/2009,15,0,18,15,48
11/30/2009,23,0,27,24,74
12/1/2009,29,0,15,22,66
12/2/2009,15,0,30,18,63
12/3/2009,25,0,17,29,71
12/4/2009,25,0,20,27,72
12/5/2009,18,0,22,11,51
12/6/2009,33,0,13,15,61
12/7/2009,30,0,23,21,74
12/8/2009,21,0,14,21,56
12/9/2009,20,0,18,20,58
12/10/2009,24,0,14,16,54
12/11/2009,19,0,15,25,59
12/12/2009,23,0,10,31,64
12/13/2009,29,0,19,19,67
12/14/2009,30,0,25,12,67
12/15/2009,27,0,15,14,56
12/16/2009,23,0,13,20,56
12/17/2009,22,0,25,18,65
12/18/2009,17,0,14,28,59
12/19/2009,26,0,20,28,74
12/20/2009,15,0,31,23,69
12/21/2009,17,0,16,9,42
12/22/2009,24,0,21,24,69
12/23/2009,30,0,15,8,53
12/24/2009,23,0,22,19,64
12/25/2009,26,0,16,26,68
12/26/2009,13,0,25,6,44
12/27/2009,28,0,17,14,59
12/28/2009,23,0,21,24,68
12/29/2009,21,0,10,20,51
12/30/2009,16,0,11,30,57
12/31/2009,23,0,19,28,70
1/1/2010,18,0,22,19,59
1/2/2010,21,0,20,25,66
1/3/2010,25,0,19,16,60
1/4/2010,24,0,20,21,65
1/5/2010,17,0,17,18,52
1/6/2010,26,0,31,21,78
1/7/2010,29,0,25,19,73
1/8/2010,27,0,17,27,71
1/9/2010,22,0,22,25,69
1/10/2010,26,0,16,30,72
1/11/2010,23,0,28,21,72
1/12/2010,25,0,26,11,62
1/13/2010,23,0,23,25,71
1/14/2010,18,0,20,25,63
1/15/2010,19,0,30,25,74
1/16/2010,27,0,18,29,74
1/17/2010,30,0,27,17,74
1/18/2010,28,0,18,24,70
1/19/2010,28,0,24,30,82
1/20/2010,24,0,14,27,65
1/21/2010,26,0,15,17,58
1/22/2010,17,0,21,26,64
1/23/2010,16,0,19,14,49
1/24/2010,24,0,19,35,78
1/25/2010,26,0,18,21,65
1/26/2010,27,0,13,36,76
1/27/2010,22,0,23,17,62
1/28/2010,25,0,23,19,67
1/29/2010,18,0,25,19,62
1/30/2010,27,0,14,14,55
1/31/2010,23,0,17,16,56
2/1/2010,18,0,27,21,66
2/2/2010,19,0,15,17,51
2/3/2010,16,0,20,23,59
2/4/2010,19,0,19,18,56
2/5/2010,23,0,21,25,69
2/6/2010,12,0,25,26,63
2/7/2010,15,0,22,29,66
2/8/2010,25,0,21,12,58
2/9/2010,27,0,26,20,73
2/10/2010,21,0,22,17,60
2/11/2010,35,0,25,15,75
2/12/2010,17,0,14,20,51
2/13/2010,14,0,13,30,57
2/14/2010,28,0,20,22,70
2/15/2010,31,0,31,15,77
2/16/2010,22,0,17,17,56
2/17/2010,16,0,31,18,65
2/18/2010,23,0,16,18,57
2/19/2010,23,0,19,16,58
2/20/2010,20,0,24,23,67
2/21/2010,25,0,16,23,64
2/22/2010,25,0,20,16,61
2/23/2010,28,0,14,31,73
2/24/2010,17,0,20,8,45
2/25/2010,28,0,9,17,54
2/26/2010,21,0,29,12,62
2/27/2010,22,0,23,24,69
2/28/2010,17,0,25,11,53
3/1/2010,33,0,25,19,77
3/2/2010,25,0,16,36,77
3/3/2010,22,0,13,9,44
3/4/2010,21,0,15,11,47
3/5/2010,28,0,21,17,66
3/6/2010,20,0,24,17,61
3/7/2010,11,0,18,29,58
3/8/2010,18,0,27,12,57
3/9/2010,15,0,17,27,59
3/10/2010,26,0,22,10,58
3/11/2010,23,0,20,26,69
3/12/2010,26,0,15,16,57
3/13/2010,15,0,12,31,58
3/14/2010,28,0,19,21,68
3/15/2010,28,0,22,24,74
3/16/2010,19,0,19,14,52
3/17/2010,25,0,22,24,71
3/18/2010,19,0,21,24,64
3/19/2010,26,0,29,18,73
3/20/2010,24,0,20,16,60
3/21/2010,33,0,15,26,74
3/22/2010,25,0,14,27,66
3/23/2010,22,0,27,25,74
3/24/2010,19,0,19,33,71
3/25/2010,25,0,21,12,58
3/26/2010,24,0,23,18,65
3/27/2010,25,0,12,10,47
3/28/2010,26,0,10,21,57
3/29/2010,31,0,23,26,80
3/30/2010,16,0,18,25,59
3/31/2010,15,0,26,8,49
4/1/2010,25,0,18,28,71
4/2/2010,22,0,19,15,56
4/3/2010,24,0,13,23,60
4/4/2010,21,0,25,29,75
4/5/2010,19,0,17,21,57
4/6/2010,25,0,18,16,59
4/7/2010,27,0,19,23,69
4/8/2010,19,0,26,29,74
4/9/2010,30,0,21,2,53
4/10/2010,18,0,15,19,52
4/11/2010,10,0,24,5,39
4/12/2010,19,0,23,11,53
4/13/2010,26,0,26,12,64
4/14/2010,20,0,14,23,57
4/15/2010,28,0,20,10,58
4/16/2010,26,0,18,18,62
4/17/2010,14,0,30,28,72
4/18/2010,17,0,26,25,68
4/19/2010,23,0,23,24,70
4/20/2010,28,0,23,22,73
4/21/2010,21,0,17,9,47
4/22/2010,33,0,14,22,69
4/23/2010,16,0,18,25,59
4/24/2010,28,0,14,35,77
4/25/2010,30,0,21,26,77
4/26/2010,24,0,19,23,66
4/27/2010,15,0,14,15,44
4/28/2010,25,0,10,10,45
4/29/2010,21,0,17,12,50
4/30/2010,14,0,24,23,61
5/1/2010,26,0,12,28,66
5/2/2010,26,0,24,21,71
5/3/2010,29,0,26,21,76
5/4/2010,25,0,24,35,84
5/5/2010,29,0,20,20,69
5/6/2010,19,0,26,29,74
5/7/2010,25,0,15,21,61
5/8/2010,29,0,21,28,78
5/9/2010,13,0,27,25,65
5/10/2010,23,0,22,20,65
5/11/2010,26,0,15,28,69
5/12/2010,17,0,21,21,59
5/13/2010,20,0,22,14,56
5/14/2010,21,0,28,10,59
5/15/2010,31,0,16,13,60
5/16/2010,28,0,12,24,64
5/17/2010,20,0,23,24,67
5/18/2010,21,0,22,26,69
5/19/2010,21,0,27,24,72
5/20/2010,19,0,15,25,59
5/21/2010,25,0,23,5,53
5/22/2010,15,0,30,16,61
5/23/2010,21,0,29,25,75
5/24/2010,16,0,13,24,53
5/25/2010,18,0,10,8,36
5/26/2010,14,0,14,19,47
5/27/2010,34,0,26,32,92
5/28/2010,28,0,14,26,68
5/29/2010,20,0,16,26,62
5/30/2010,23,0,23,21,67
5/31/2010,20,0,27,20,67
6/1/2010,27,0,23,21,71
6/2/2010,26,0,29,13,68
6/3/2010,28,0,23,14,65
6/4/2010,18,0,27,12,57
6/5/2010,24,0,17,20,61
6/6/2010,18,0,13,21,52
6/7/2010,19,0,24,29,72
6/8/2010,26,0,22,30,78
6/9/2010,24,0,20,10,54
6/10/2010,31,0,30,16,77
6/11/2010,27,0,27,20,74
6/12/2010,30,0,24,17,71
6/13/2010,22,0,20,15,57
6/14/2010,26,0,12,8,46
6/15/2010,28,0,13,22,63
6/16/2010,24,0,17,14,55
6/17/2010,31,0,23,27,81
6/18/2010,23,0,9,20,52
6/19/2010,28,0,22,5,55
6/20/2010,24,0,21,24,69
6/21/2010,24,0,17,23,64
6/22/2010,18,0,16,21,55
6/23/2010,25,0,16,8,49
6/24/2010,25,0,21,33,79
6/25/2010,21,0,26,18,65
6/26/2010,19,0,21,21,61
6/27/2010,25,0,22,26,73
6/28/2010,21,0,20,23,64
6/29/2010,16,0,23,8,47
6/30/2010,20,0,18,22,60
7/1/2010,21,0,24,25,70
7/2/2010,19,0,22,26,67
7/3/2010,19,0,13,22,54
7/4/2010,21,0,23,24,68
7/5/2010,19,0,24,21,64
7/6/2010,26,0,25,28,79
7/7/2010,27,0,15,26,68
7/8/2010,15,0,21,20,56
7/9/2010,16,0,16,34,66
7/10/2010,21,0,10,24,55
7/11/2010,30,0,28,10,68
7/12/2010,29,0,30,33,92
7/13/2010,31,0,12,18,61
7/14/2010,21,0,29,20,70
7/15/2010,22,0,24,0,46
7/16/2010,34,0,16,16,66
7/17/2010,27,0,22,26,75
7/18/2010,19,0,17,9,45
7/19/2010,20,0,15,30,65
7/20/2010,18,0,12,20,50
7/21/2010,20,0,26,30,76
7/22/2010,21,0,26,20,67
7/23/2010,19,0,11,18,48
7/24/2010,20,0,16,15,51
7/25/2010,25,0,26,17,68
7/26/2010,27,0,21,12,60
7/27/2010,19,0,26,11,56
7/28/2010,20,0,18,23,61
7/29/2010,18,0,11,18,47
7/30/2010,20,0,17,25,62
7/31/2010,28,0,20,12,60
8/1/2010,20,0,12,24,56
8/2/2010,21,0,17,25,63
8/3/2010,30,0,24,22,76
8/4/2010,18,0,7,11,36
8/5/2010,26,0,21,29,76
8/6/2010,18,0,24,26,68
8/7/2010,22,0,21,35,78
8/8/2010,29,0,15,11,55
8/9/2010,18,0,16,27,61
8/10/2010,24,0,22,23,69
8/11/2010,20,0,21,26,67
8/12/2010,27,0,17,19,63
8/13/2010,20,0,13,21,54
8/14/2010,29,0,26,36,91
8/15/2010,27,0,21,14,62
8/16/2010,26,0,11,19,56
8/17/2010,21,0,19,21,61
8/18/2010,27,0,23,27,77
8/19/2010,33,0,25,26,84
8/20/2010,18,0,12,14,44
8/21/2010,25,0,16,9,50
8/22/2010,28,0,20,20,68
8/23/2010,10,0,23,18,51
8/24/2010,20,0,20,7,47
8/25/2010,34,0,24,20,78
8/26/2010,17,0,15,18,50
8/27/2010,16,0,23,26,65
8/28/2010,23,0,16,16,55
8/29/2010,34,0,20,15,69
8/30/2010,28,0,25,22,75
8/31/2010,30,0,20,16,66
9/1/2010,28,0,26,11,65
9/2/2010,24,0,14,20,58
9/3/2010,29,0,27,6,62
9/4/2010,28,0,25,27,80
9/5/2010,13,0,11,23,47
9/6/2010,15,0,26,14,55
9/7/2010,33,0,20,13,66
9/8/2010,19,0,14,22,55
9/9/2010,27,0,15,26,68
9/10/2010,22,0,23,34,79
9/11/2010,16,0,34,32,82
9/12/2010,24,0,10,27,61
9/13/2010,26,0,21,28,75
9/14/2010,23,0,27,25,75
9/15/2010,22,0,14,27,63
9/16/2010,26,0,15,7,48
9/17/2010,24,0,26,18,68
9/18/2010,27,0,21,16,64
9/19/2010,21,0,23,20,64
9/20/2010,19,0,14,35,68
9/21/2010,29,0,18,14,61
9/22/2010,31,0,23,15,69
9/23/2010,25,0,18,15,58
9/24/2010,17,0,22,23,62
9/25/2010,28,0,25,25,78
9/26/2010,23,0,32,12,67
9/27/2010,26,0,20,27,73
9/28/2010,19,0,9,38,66
9/29/2010,24,0,25,11,60
9/30/2010,16,0,28,13,57
10/1/2010,30,0,18,24,72
10/2/2010,25,0,23,13,61
10/3/2010,24,0,20,17,61
10/4/2010,18,0,18,12,48
10/5/2010,27,0,17,25,69
10/6/2010,19,0,21,30,70
10/7/2010,28,0,27,29,84
10/8/2010,26,0,20,27,73
10/9/2010,15,0,23,21,59
10/10/2010,29,0,14,36,79
10/11/2010,25,0,21,27,73
10/12/2010,26,0,23,27,76
10/13/2010,20,0,26,15,61
10/14/2010,16,0,12,33,61
10/15/2010,31,0,12,21,64
10/16/2010,14,0,20,21,55
10/17/2010,24,0,15,20,59
10/18/2010,19,0,15,17,51
10/19/2010,23,0,9,18,50
10/20/2010,20,0,17,14,51
10/21/2010,28,0,26,17,71
10/22/2010,21,0,22,27,70
10/23/2010,28,0,26,13,67
10/24/2010,28,0,22,24,74
10/25/2010,26,0,22,26,74
10/26/2010,27,0,18,12,57
10/27/2010,30,0,13,22,65
10/28/2010,28,0,20,18,66
10/29/2010,19,0,16,27,62
10/30/2010,18,0,24,19,61
10/31/2010,20,0,10,6,36
11/1/2010,20,0,7,27,54
11/2/2010,20,0,25,16,61
11/3/2010,22,0,21,15,58
11/4/2010,24,0,18,17,59
11/5/2010,17,0,21,29,67
11/6/2010,19,0,23,22,64
11/7/2010,24,0,11,10,45
11/8/2010,23,0,19,29,71
11/9/2010,33,0,29,31,93
11/10/2010,26,0,25,24,75
11/11/2010,28,0,26,36,90
11/12/2010,15,0,15,13,43
11/13/2010,13,0,21,12,46
11/14/2010,22,0,14,25,61
11/15/2010,20,0,10,21,51
11/16/2010,25,0,10,28,63
11/17/2010,23,0,21,22,66
11/18/2010,20,0,27,5,52
11/19/2010,19,0,27,12,58
11/20/2010,29,0,28,15,72
11/21/2010,21,0,26,11,58
11/22/2010,28,0,17,16,61
11/23/2010,25,0,14,27,66
11/24/2010,25,0,25,22,72
11/25/2010,21,0,22,12,55
11/26/2010,23,0,19,33,75
11/27/2010,17,0,23,21,61
11/28/2010,25,0,19,20,64
11/29/2010,27,0,23,17,67
11/30/2010,18,0,17,32,67
12/1/2010,16,0,25,5,46
12/2/2010,15,0,22,1,38
12/3/2010,22,0,28,21,71
12/4/2010,24,0,23,23,70
12/5/2010,34,0,23,9,66
12/6/2010,27,0,20,14,61
12/7/2010,17,0,13,21,51
12/8/2010,25,0,13,24,62
12/9/2010,17,0,14,9,40
12/10/2010,21,0,20,14,55
12/11/2010,23,0,25,20,68
12/12/2010,20,0,13,27,60
12/13/2010,25,0,26,27,78
12/14/2010,22,0,19,24,65
12/15/2010,22,0,27,19,68
12/16/2010,31,0,18,32,81
12/17/2010,34,0,21,14,69
12/18/2010,20,0,19,8,47
12/19/2010,29,0,8,13,50
12/20/2010,29,0,14,29,72
12/21/2010,26,0,18,11,55
12/22/2010,28,0,15,31,74
12/23/2010,28,0,24,21,73
12/24/2010,30,0,19,17,66
12/25/2010,26,0,26,14,66
12/26/2010,23,0,20,20,63
12/27/2010,24,0,16,22,62
12/28/2010,21,0,21,22,64
12/29/2010,25,0,26,3,54
12/30/2010,32,0,21,18,71
12/31/2010,12,0,21,12,45
1/1/2011,20,0,26,28,74
1/2/2011,22,0,12,27,61
1/3/2011,26,0,22,19,67
1/4/2011,21,0,17,14,52
1/5/2011,24,0,13,7,44
1/6/2011,26,0,18,26,70
1/7/2011,20,0,13,22,55
1/8/2011,18,0,17,25,60
1/9/2011,24,0,22,14,60
1/10/2011,31,0,24,24,79
1/11/2011,22,0,21,30,73
1/12/2011,29,0,14,25,68
1/13/2011,20,0,20,29,69
1/14/2011,23,0,11,24,58
1/15/2011,28,0,31,15,74
1/16/2011,23,0,24,19,66
1/17/2011,26,0,15,13,54
1/18/2011,19,0,23,32,74
1/19/2011,16,0,16,14,46
1/20/2011,20,0,23,29,72
1/21/2011,27,0,22,22,71
1/22/2011,26,0,21,18,65
1/23/2011,20,0,27,22,69
1/24/2011,18,0,27,14,59
1/25/2011,26,0,25,29,80
1/26/2011,23,0,12,17,52
1/27/2011,18,0,30,25,73
1/28/2011,23,0,20,15,58
1/29/2011,29,0,23,31,83
1/30/2011,24,0,21,5,50
1/31/2011,21,0,22,25,68
2/1/2011,29,0,20,13,62
2/2/2011,20,0,19,32,71
2/3/2011,23,0,20,13,56
2/4/2011,26,0,11,10,47
2/5/2011,16,0,23,15,54
2/6/2011,35,0,22,16,73
2/7/2011,23,0,27,24,74
2/8/2011,32,0,15,16,63
2/9/2011,23,0,15,16,54
2/10/2011,18,0,29,27,74
2/11/2011,22,0,18,16,56
2/12/2011,26,0,28,11,65
2/13/2011,19,0,21,21,61
2/14/2011,26,0,23,16,65
2/15/2011,35,0,17,20,72
2/16/2011,24,0,28,27,79
2/17/2011,25,0,17,34,76
2/18/2011,20,0,24,11,55
2/19/2011,16,0,8,19,43
2/20/2011,20,0,22,15,57
2/21/2011,30,0,14,22,66
2/22/2011,30,0,16,22,68
2/23/2011,30,0,19,20,69
2/24/2011,25,0,18,20,63
2/25/2011,24,0,20,17,61
2/26/2011,24,0,27,26,77
2/27/2011,28,0,22,30,80
2/28/2011,26,0,25,29,80
3/1/2011,24,0,23,27,74
3/2/2011,18,0,13,25,56
3/3/2011,19,0,13,14,46
3/4/2011,27,0,28,1,56
3/5/2011,29,0,16,31,76
3/6/2011,21,0,15,12,48
3/7/2011,21,0,16,27,64
3/8/2011,31,0,16,8,55
3/9/2011,19,0,21,14,54
3/10/2011,21,0,25,10,56
3/11/2011,28,0,14,22,64
3/12/2011,31,0,18,17,66
3/13/2011,20,0,25,20,65
3/14/2011,15,0,27,27,69
3/15/2011,23,0,19,16,58
3/16/2011,25,0,22,20,67
3/17/2011,11,0,16,28,55
3/18/2011,30,0,20,16,66
3/19/2011,25,0,11,18,54
3/20/2011,33,0,21,25,79
3/21/2011,16,0,30,17,63
3/22/2011,20,0,15,13,48
3/23/2011,26,0,19,3,48
3/24/2011,22,0,23,25,70
3/25/2011,34,0,26,16,76
3/26/2011,15,0,24,19,58
3/27/2011,19,0,18,4,41
3/28/2011,28,0,12,26,66
3/29/2011,25,0,23,13,61
3/30/2011,27,0,28,12,67
3/31/2011,16,0,22,25,63
4/1/2011,30,0,18,13,61
4/2/2011,28,0,17,19,64
4/3/2011,20,0,24,12,56
4/4/2011,22,0,14,13,49
4/5/2011,27,0,25,16,68
4/6/2011,26,0,15,20,61
4/7/2011,16,0,22,16,54
4/8/2011,21,0,27,25,73
4/9/2011,21,0,22,15,58
4/10/2011,19,0,17,34,70
4/11/2011,20,0,20,20,60
4/12/2011,23,0,28,27,78
4/13/2011,30,0,12,19,61
4/14/2011,19,0,20,20,59
4/15/2011,19,0,18,12,49
4/16/2011,15,0,19,26,60
4/17/2011,19,0,24,19,62
4/18/2011,31,0,17,10,58
4/19/2011,24,0,17,23,64
4/20/2011,13,0,23,10,46
4/21/2011,24,0,15,34,73
4/22/2011,23,0,14,15,52
4/23/2011,27,0,19,8,54
4/24/2011,27,0,15,19,61
4/25/2011,21,0,19,12,52
4/26/2011,29,0,24,12,65
4/27/2011,28,0,21,19,68
4/28/2011,34,0,14,21,69
4/29/2011,33,0,25,8,66
4/30/2011,17,0,8,16,41
5/1/2011,22,0,22,23,67
5/2/2011,28,0,18,19,65
5/3/2011,35,0,17,22,74
5/4/2011,28,0,15,27,70
5/5/2011,23,0,20,23,66
5/6/2011,29,0,20,23,72
5/7/2011,17,0,18,18,53
5/8/2011,23,0,13,25,61
5/9/2011,26,0,22,9,57
5/10/2011,21,0,16,10,47
5/11/2011,14,0,15,8,37
5/12/2011,15,0,21,29,65
5/13/2011,24,0,15,28,67
5/14/2011,12,0,12,31,55
5/15/2011,19,0,18,32,69
5/16/2011,29,0,17,10,56
5/17/2011,22,0,28,18,68
5/18/2011,23,0,18,16,57
5/19/2011,25,0,20,25,70
5/20/2011,23,0,29,20,72
5/21/2011,21,0,22,25,68
5/22/2011,22,0,19,26,67
5/23/2011,21,0,18,20,59
5/24/2011,29,0,18,30,77
5/25/2011,23,0,19,17,59
5/26/2011,20,0,14,29,63
5/27/2011,31,0,26,25,82
5/28/2011,27,0,24,20,71
5/29/2011,16,0,18,22,56
5/30/2011,19,0,16,21,56
5/31/2011,16,0,18,20,54
6/1/2011,28,0,12,31,71
6/2/2011,16,0,24,20,60
6/3/2011,17,0,14,30,61
6/4/2011,21,0,29,28,78
6/5/2011,15,0,25,25,65
6/6/2011,13,0,19,18,50
6/7/2011,29,0,15,13,57
6/8/2011,27,0,17,19,63
6/9/2011,16,0,15,21,52
6/10/2011,14,0,16,26,56
6/11/2011,31,0,20,3,54
6/12/2011,19,0,17,25,61
6/13/2011,13,0,16,15,44
6/14/2011,22,0,18,28,68
6/15/2011,23,0,15,11,49
6/16/2011,23,0,18,16,57
6/17/2011,27,0,19,5,51
6/18/2011,26,0,21,30,77
6/19/2011,19,0,10,28,57
6/20/2011,16,0,19,22,57
6/21/2011,19,0,20,7,46
6/22/2011,20,0,20,20,60
6/23/2011,17,0,17,25,59
6/24/2011,24,0,32,22,78
6/25/2011,27,0,18,11,56
6/26/2011,19,0,12,12,43
6/27/2011,29,0,15,33,77
6/28/2011,18,0,22,10,50
6/29/2011,30,0,18,10,58
6/30/2011,27,0,21,29,77
7/1/2011,22,0,13,22,57
7/2/2011,20,0,22,23,65
7/3/2011,24,0,27,24,75
7/4/2011,21,0,11,11,43
7/5/2011,14,0,17,18,49
7/6/2011,24,0,20,21,65
7/7/2011,23,0,24,12,59
7/8/2011,13,0,28,11,52
7/9/2011,17,0,20,31,68
7/10/2011,13,0,20,14,47
7/11/2011,22,0,14,22,58
7/12/2011,21,0,21,33,75
7/13/2011,15,0,26,37,78
7/14/2011,27,0,19,22,68
7/15/2011,29,0,19,32,80
7/16/2011,34,0,14,10,58
7/17/2011,32,0,19,15,66
7/18/2011,30,0,22,23,75
7/19/2011,28,0,26,25,79
7/20/2011,27,0,8,11,46
7/21/2011,17,0,21,25,63
7/22/2011,13,0,23,14,50
7/23/2011,22,0,22,19,63
7/24/2011,16,0,22,8,46
7/25/2011,16,0,23,13,52
7/26/2011,23,0,22,26,71
7/27/2011,24,0,24,30,78
7/28/2011,27,0,30,25,82
7/29/2011,23,0,28,19,70
7/30/2011,20,0,11,34,65
7/31/2011,24,0,23,30,77
8/1/2011,16,0,9,17,42
8/2/2011,23,0,25,18,66
8/3/2011,25,0,24,23,72
8/4/2011,31,0,29,13,73
8/5/2011,28,0,13,9,50
8/6/2011,22,0,21,9,52
8/7/2011,18,0,23,25,66
8/8/2011,21,0,18,16,55
8/9/2011,21,0,22,28,71
8/10/2011,28,0,29,16,73
8/11/2011,30,0,31,18,79
8/12/2011,19,0,28,18,65
8/13/2011,26,0,22,7,55
8/14/2011,20,0,29,26,75
8/15/2011,21,0,19,25,65
8/16/2011,15,0,19,17,51
8/17/2011,27,0,19,21,67
8/18/2011,21,0,23,27,71
8/19/2011,34,0,14,27,75
8/20/2011,17,0,17,36,70
8/21/2011,21,0,13,15,49
8/22/2011,31,0,19,27,77
8/23/2011,16,0,20,8,44
8/24/2011,27,0,30,33,90
8/25/2011,21,0,14,26,61
8/26/2011,23,0,23,15,61
8/27/2011,26,0,23,18,67
8/28/2011,35,0,16,5,56
8/29/2011,18,0,11,25,54
8/30/2011,17,0,22,9,48
8/31/2011,28,0,11,16,55
9/1/2011,31,0,15,23,69
9/2/2011,20,0,22,19,61
9/3/2011,18,0,12,17,47
9/4/2011,16,0,29,28,73
9/5/2011,20,0,26,25,71
9/6/2011,19,0,16,13,48
9/7/2011,24,0,16,25,65
9/8/2011,24,0,21,27,72
9/9/2011,29,0,17,11,57
9/10/2011,19,0,33,29,81
9/11/2011,18,0,25,17,60
9/12/2011,23,0,18,11,52
9/13/2011,26,0,18,23,67
9/14/2011,24,0,27,21,72
9/15/2011,20,0,25,16,61
9/16/2011,26,0,20,11,57
9/17/2011,29,0,26,18,73
9/18/2011,32,0,14,25,71
9/19/2011,23,0,22,26,71
9/20/2011,14,0,16,35,65
9/21/2011,22,0,17,17,56
9/22/2011,18,0,11,18,47
9/23/2011,25,0,34,21,80
9/24/2011,20,0,16,24,60
9/25/2011,32,0,23,20,75
9/26/2011,28,0,19,6,53
9/27/2011,23,0,26,12,61
9/28/2011,30,0,24,13,67
9/29/2011,22,0,30,23,75
9/30/2011,24,0,19,21,64
10/1/2011,23,0,11,13,47
10/2/2011,20,0,19,29,68
10/3/2011,28,0,16,9,53
10/4/2011,23,0,20,24,67
10/5/2011,25,0,21,7,53
10/6/2011,27,0,26,14,67
10/7/2011,19,0,14,13,46
10/8/2011,24,0,13,13,50
10/9/2011,21,0,9,21,51
10/10/2011,19,0,24,10,53
10/11/2011,25,0,27,19,71
10/12/2011,22,0,13,18,53
10/13/2011,27,0,20,17,64
10/14/2011,27,0,23,13,63
10/15/2011,24,0,18,27,69
10/16/2011,25,0,17,19,61
10/17/2011,18,0,23,26,67
10/18/2011,28,0,14,32,74
10/19/2011,28,0,23,26,77
10/20/2011,18,0,24,22,64
10/21/2011,25,0,15,29,69
10/22/2011,29,0,22,9,60
10/23/2011,28,0,13,11,52
10/24/2011,23,0,19,20,62
10/25/2011,17,0,21,22,60
10/26/2011,18,0,25,16,59
10/27/2011,22,0,24,18,64
10/28/2011,22,0,16,20,58
10/29/2011,23,0,19,23,65
10/30/2011,24,0,15,10,49
10/31/2011,20,0,9,37,66
11/1/2011,15,0,25,16,56
11/2/2011,23,0,22,5,50
11/3/2011,32,0,11,23,66
11/4/2011,23,0,18,18,59
11/5/2011,16,0,29,12,57
11/6/2011,14,0,9,23,46
11/7/2011,27,0,17,10,54
11/8/2011,23,0,13,14,50
11/9/2011,23,0,22,8,53
11/10/2011,25,0,24,9,58
11/11/2011,26,0,20,27,73
11/12/2011,19,0,15,32,66
11/13/2011,33,0,20,14,67
11/14/2011,27,0,20,22,69
11/15/2011,23,0,19,18,60
11/16/2011,30,0,19,22,71
11/17/2011,32,0,16,18,66
11/18/2011,25,0,25,23,73
11/19/2011,26,0,19,10,55
11/20/2011,21,0,21,21,63
11/21/2011,29,0,18,16,63
11/22/2011,19,0,18,15,52
11/23/2011,25,0,16,25,66
11/24/2011,31,0,21,8,60
11/25/2011,32,0,24,18,74
11/26/2011,25,0,20,27,72
11/27/2011,25,0,23,9,57
11/28/2011,16,0,15,16,47
11/29/2011,17,0,19,21,57
11/30/2011,28,0,23,24,75
12/1/2011,21,0,17,11,49
12/2/2011,32,0,24,16,72
12/3/2011,25,0,9,34,68
12/4/2011,21,0,10,14,45
12/5/2011,26,0,18,18,62
12/6/2011,28,0,29,4,61
12/7/2011,35,0,24,22,81
12/8/2011,18,0,23,17,58
12/9/2011,31,0,22,22,75
12/10/2011,21,0,16,29,66
12/11/2011,16,0,24,20,60
12/12/2011,31,0,20,31,82
12/13/2011,23,0,30,26,79
12/14/2011,18,0,18,21,57
12/15/2011,19,0,11,20,50
12/16/2011,31,0,25,23,79
12/17/2011,25,0,21,21,67
12/18/2011,21,0,21,11,53
12/19/2011,19,0,19,16,54
12/20/2011,20,0,31,12,63
12/21/2011,21,0,21,7,49
12/22/2011,31,0,25,15,71
12/23/2011,33,0,16,36,85
12/24/2011,19,0,17,29,65
12/25/2011,13,0,22,23,58
12/26/2011,24,0,22,26,72
12/27/2011,21,0,19,20,60
12/28/2011,19,0,15,15,49
12/29/2011,21,0,22,9,52
12/30/2011,24,0,11,17,52
12/31/2011,17,0,19,29,65
1/1/2012,16,0,21,18,55
1/2/2012,18,0,11,25,54
1/3/2012,24,0,27,19,70
1/4/2012,25,0,25,16,66
1/5/2012,19,0,14,24,57
1/6/2012,16,0,22,27,65
1/7/2012,32,0,26,37,95
1/8/2012,24,0,24,23,71
1/9/2012,18,0,19,19,56
1/10/2012,26,0,21,26,73
1/11/2012,15,0,16,18,49
1/12/2012,25,0,15,22,62
1/13/2012,29,0,26,10,65
1/14/2012,28,0,24,31,83
1/15/2012,16,0,19,6,41
1/16/2012,26,0,17,12,55
1/17/2012,30,0,27,27,84
1/18/2012,18,0,19,20,57
1/19/2012,28,0,22,19,69
1/20/2012,20,0,20,20,60
1/21/2012,22,0,19,8,49
1/22/2012,18,0,22,23,63
1/23/2012,24,0,25,17,66
1/24/2012,16,0,20,14,50
1/25/2012,20,0,23,16,59
1/26/2012,26,0,21,22,69
1/27/2012,23,0,28,22,73
1/28/2012,28,0,23,22,73
1/29/2012,30,0,21,24,75
1/30/2012,17,0,29,17,63
1/31/2012,16,0,25,23,64
2/1/2012,16,0,18,2,36
2/2/2012,20,0,20,26,66
2/3/2012,26,0,26,23,75
2/4/2012,25,0,18,25,68
2/5/2012,27,0,21,15,63
2/6/2012,21,0,24,35,80
2/7/2012,27,0,30,10,67
2/8/2012,19,0,14,11,44
2/9/2012,28,0,22,33,83
2/10/2012,30,0,19,13,62
2/11/2012,15,0,14,8,37
2/12/2012,26,0,22,25,73
2/13/2012,22,0,16,18,56
2/14/2012,12,0,22,18,52
2/15/2012,28,0,31,30,89
2/16/2012,12,0,12,35,59
2/17/2012,26,0,28,19,73
2/18/2012,27,0,25,12,64
2/19/2012,18,0,26,23,67
2/20/2012,21,0,12,25,58
2/21/2012,27,0,12,33,72
2/22/2012,25,0,21,14,60
2/23/2012,26,0,19,24,69
2/24/2012,18,0,24,18,60
2/25/2012,25,0,22,27,74
2/26/2012,19,0,19,17,55
2/27/2012,33,0,22,13,68
2/28/2012,25,0,18,22,65
2/29/2012,26,0,27,35,88
3/1/2012,21,0,28,12,61
3/2/2012,24,0,21,21,66
3/3/2012,24,0,14,32,70
3/4/2012,17,0,21,16,54
3/5/2012,21,0,22,24,67
3/6/2012,26,0,23,23,72
3/7/2012,32,0,12,21,65
3/8/2012,22,0,25,29,76
3/9/2012,30,0,16,25,71
3/10/2012,22,0,17,29,68
3/11/2012,26,0,20,25,71
3/12/2012,26,0,13,18,57
3/13/2012,26,0,22,28,76
3/14/2012,23,0,21,25,69
3/15/2012,22,0,17,16,55
3/16/2012,23,0,19,19,61
3/17/2012,17,0,18,31,66
3/18/2012,18,0,21,24,63
3/19/2012,24,0,26,25,75
3/20/2012,17,0,25,31,73
3/21/2012,28,0,17,13,58
3/22/2012,25,0,28,11,64
3/23/2012,28,0,30,23,81
3/24/2012,16,0,24,25,65
3/25/2012,18,0,12,11,41
3/26/2012,14,0,19,28,61
3/27/2012,14,0,18,24,56
3/28/2012,25,0,22,30,77
3/29/2012,30,0,19,18,67
3/30/2012,30,0,20,25,75
3/31/2012,21,0,20,15,56
4/1/2012,16,0,30,13,59
4/2/2012,20,0,22,25,67
4/3/2012,25,0,13,23,61
4/4/2012,32,0,19,14,65
4/5/2012,17,0,20,20,57
4/6/2012,21,0,14,11,46
4/7/2012,21,0,20,32,73
4/8/2012,20,0,18,10,48
4/9/2012,17,0,15,16,48
4/10/2012,18,0,10,25,53
4/11/2012,19,0,16,12,47
4/12/2012,27,0,15,18,60
4/13/2012,21,0,19,26,66
4/14/2012,12,0,20,26,58
4/15/2012,28,0,12,9,49
4/16/2012,33,0,21,24,78
4/17/2012,14,0,17,22,53
4/18/2012,27,0,25,24,76
4/19/2012,23,0,6,27,56
4/20/2012,22,0,18,20,60
4/21/2012,22,0,24,15,61
4/22/2012,17,0,20,8,45
4/23/2012,20,0,17,32,69
4/24/2012,19,0,25,19,63
4/25/2012,20,0,17,35,72
4/26/2012,27,0,23,24,74
4/27/2012,27,0,23,17,67
4/28/2012,16,0,16,15,47
4/29/2012,25,0,19,19,63
4/30/2012,30,0,20,14,64
5/1/2012,27,0,17,6,50
5/2/2012,17,0,25,20,62
5/3/2012,23,0,20,28,71
5/4/2012,26,0,24,17,67
5/5/2012,29,0,18,19,66
5/6/2012,28,0,26,24,78
5/7/2012,27,0,15,13,55
5/8/2012,20,0,12,22,54
5/9/2012,31,0,24,17,72
5/10/2012,23,0,11,28,62
5/11/2012,26,0,19,15,60
5/12/2012,27,0,24,31,82
5/13/2012,20,0,11,15,46
5/14/2012,28,0,18,21,67
5/15/2012,23,0,23,24,70
5/16/2012,33,0,18,14,65
5/17/2012,16,0,26,24,66
5/18/2012,23,0,12,10,45
5/19/2012,24,0,10,20,54
5/20/2012,28,0,23,13,64
5/21/2012,22,0,15,24,61
5/22/2012,35,0,16,14,65
5/23/2012,21,0,23,11,55
5/24/2012,27,0,19,26,72
5/25/2012,16,0,12,20,48
5/26/2012,31,0,26,22,79
5/27/2012,27,0,13,17,57
5/28/2012,27,0,16,17,60
5/29/2012,32,0,17,13,62
5/30/2012,33,0,9,34,76
5/31/2012,21,0,16,5,42
6/1/2012,23,0,17,13,53
6/2/2012,24,0,17,28,69
6/3/2012,24,0,13,18,55
6/4/2012,26,0,22,17,65
6/5/2012,28,0,18,17,63
6/6/2012,18,0,17,20,55
6/7/2012,24,0,23,27,74
6/8/2012,22,0,16,20,58
6/9/2012,12,0,18,25,55
6/10/2012,17,0,21,9,47
6/11/2012,26,0,22,29,77
6/12/2012,18,0,20,24,62
6/13/2012,21,0,23,21,65
6/14/2012,15,0,20,26,61
6/15/2012,18,0,24,19,61
6/16/2012,32,0,26,13,71
6/17/2012,30,0,12,21,63
6/18/2012,30,0,20,34,84
6/19/2012,20,0,13,5,38
6/20/2012,23,0,10,17,50
6/21/2012,14,0,31,12,57
6/22/2012,16,0,15,17,48
6/23/2012,17,0,19,15,51
6/24/2012,19,0,20,13,52
6/25/2012,27,0,24,26,77
6/26/2012,12,0,32,11,55
6/27/2012,31,0,27,28,86
6/28/2012,27,0,24,9,60
6/29/2012,25,0,28,11,64
6/30/2012,29,0,21,22,72
7/1/2012,28,0,11,21,60
7/2/2012,24,0,9,18,51
7/3/2012,23,0,19,29,71
7/4/2012,29,0,21,14,64
7/5/2012,24,0,24,13,61
7/6/2012,23,0,17,16,56
7/7/2012,26,0,20,6,52
7/8/2012,27,0,29,13,69
7/9/2012,16,0,17,7,40
7/10/2012,18,0,17,13,48
7/11/2012,27,0,15,9,51
7/12/2012,27,0,14,6,47
7/13/2012,19,0,24,16,59
7/14/2012,18,0,26,13,57
7/15/2012,28,0,12,27,67
7/16/2012,25,0,21,10,56
7/17/2012,16,0,18,20,54
7/18/2012,27,0,20,24,71
7/19/2012,28,0,22,23,73
7/20/2012,24,0,22,25,71
7/21/2012,22,0,14,23,59
7/22/2012,18,0,19,31,68
7/23/2012,18,0,18,32,68
7/24/2012,25,0,14,32,71
7/25/2012,25,0,15,19,59
7/26/2012,21,0,14,21,56
7/27/2012,25,0,11,21,57
7/28/2012,27,0,22,13,62
7/29/2012,31,0,20,22,73
7/30/2012,28,0,23,22,73
7/31/2012,18,0,16,29,63
8/1/2012,28,0,22,18,68
8/2/2012,12,0,14,27,53
8/3/2012,27,0,11,21,59
8/4/2012,28,0,24,17,69
8/5/2012,28,0,23,11,62
8/6/2012,22,0,20,29,71
8/7/2012,18,0,14,22,54
8/8/2012,33,0,23,19,75
8/9/2012,18,0,28,26,72
8/10/2012,26,0,20,27,73
8/11/2012,17,0,17,24,58
8/12/2012,25,0,13,31,69
8/13/2012,23,0,26,24,73
8/14/2012,27,0,17,13,57
8/15/2012,17,0,22,26,65
8/16/2012,14,0,19,24,57
8/17/2012,32,0,24,15,71
8/18/2012,15,0,20,18,53
8/19/2012,24,0,22,21,67
8/20/2012,18,0,13,5,36
8/21/2012,24,0,24,25,73
8/22/2012,19,0,27,15,61
8/23/2012,20,0,20,16,56
8/24/2012,30,0,29,30,89
8/25/2012,24,0,20,17,61
8/26/2012,30,0,20,21,71
8/27/2012,22,0,19,31,72
8/28/2012,30,0,17,23,70
8/29/2012,23,0,16,12,51
8/30/2012,19,0,18,22,59
8/31/2012,20,0,15,11,46
9/1/2012,15,0,21,28,64
9/2/2012,23,0,22,13,58
9/3/2012,27,0,32,5,64
9/4/2012,16,0,18,21,55
9/5/2012,21,0,12,27,60
9/6/2012,19,0,17,33,69
9/7/2012,26,0,22,21,69
9/8/2012,30,0,15,13,58
9/9/2012,14,0,12,30,56
9/10/2012,18,0,18,15,51
9/11/2012,19,0,18,17,54
9/12/2012,23,0,18,20,61
9/13/2012,26,0,22,28,76
9/14/2012,30,0,25,23,78
9/15/2012,29,0,21,11,61
9/16/2012,23,0,20,21,64
9/17/2012,14,0,17,18,49
9/18/2012,28,0,16,19,63
9/19/2012,18,0,20,2,40
9/20/2012,24,0,19,22,65
9/21/2012,19,0,18,14,51
9/22/2012,23,0,28,9,60
9/23/2012,24,0,14,20,58
9/24/2012,28,0,22,32,82
9/25/2012,27,0,25,16,68
9/26/2012,17,0,10,22,49
9/27/2012,26,0,22,33,81
9/28/2012,17,0,16,22,55
9/29/2012,25,0,26,20,71
9/30/2012,24,0,27,16,67
10/1/2012,26,0,14,28,68
10/2/2012,25,0,19,15,59
10/3/2012,24,0,12,16,52
10/4/2012,22,0,33,29,84
10/5/2012,30,0,14,19,63
10/6/2012,15,0,15,23,53
10/7/2012,19,0,23,26,68
10/8/2012,19,0,22,26,67
10/9/2012,21,0,17,17,55
10/10/2012,25,0,33,19,77
10/11/2012,24,0,22,26,72
10/12/2012,22,0,25,18,65
10/13/2012,24,0,15,14,53
10/14/2012,20,0,15,6,41
10/15/2012,33,0,21,12,66
10/16/2012,26,0,9,23,58
10/17/2012,17,0,27,18,62
10/18/2012,22,0,18,20,60
10/19/2012,29,0,18,27,74
10/20/2012,29,0,25,22,76
10/21/2012,28,0,13,9,50
10/22/2012,30,0,23,16,69
10/23/2012,23,0,19,17,59
10/24/2012,35,0,27,19,81
10/25/2012,21,0,26,38,85
10/26/2012,26,0,16,14,56
10/27/2012,28,0,12,23,63
10/28/2012,22,0,31,24,77
10/29/2012,30,0,18,17,65
10/30/2012,15,0,18,23,56
10/31/2012,24,0,25,4,53
11/1/2012,30,0,21,21,72
11/2/2012,24,0,22,25,71
11/3/2012,30,0,24,19,73
11/4/2012,23,0,15,24,62
11/5/2012,26,0,16,24,66
11/6/2012,23,0,15,26,64
11/7/2012,24,0,17,27,68
11/8/2012,17,0,13,10,40
11/9/2012,20,0,13,32,65
11/10/2012,21,0,27,7,55
11/11/2012,25,0,25,17,67
11/12/2012,17,0,15,22,54
11/13/2012,15,0,17,27,59
11/14/2012,16,0,13,21,50
11/15/2012,28,0,19,31,78
11/16/2012,27,0,31,18,76
11/17/2012,17,0,19,22,58
11/18/2012,16,0,19,25,60
11/19/2012,16,0,21,23,60
11/20/2012,16,0,26,18,60
11/21/2012,30,0,10,26,66
11/22/2012,24,0,15,30,69
11/23/2012,29,0,19,16,64
11/24/2012,26,0,20,18,64
11/25/2012,19,0,18,15,52
11/26/2012,23,0,18,19,60
11/27/2012,29,0,21,26,76
11/28/2012,19,0,20,28,67
11/29/2012,23,0,22,18,63
11/30/2012,22,0,24,16,62
12/1/2012,23,0,25,13,61
12/2/2012,17,0,23,23,63
12/3/2012,21,0,11,14,46
12/4/2012,22,0,31,22,75
12/5/2012,27,0,11,26,64
12/6/2012,25,0,26,6,57
12/7/2012,25,0,10,16,51
12/8/2012,21,0,18,19,58
12/9/2012,22,0,24,30,76
12/10/2012,18,0,12,2,32
12/11/2012,18,0,28,17,63
12/12/2012,24,0,23,15,62
12/13/2012,19,0,26,15,60
12/14/2012,27,0,21,15,63
12/15/2012,27,0,28,20,75
12/16/2012,28,0,27,26,81
12/17/2012,21,0,18,20,59
12/18/2012,29,0,16,21,66
12/19/2012,20,0,21,30,71
12/20/2012,25,0,27,28,80
12/21/2012,29,0,18,31,78
12/22/2012,16,0,12,28,56
12/23/2012,33,0,18,27,78
12/24/2012,28,0,16,26,70
12/25/2012,24,0,12,26,62
12/26/2012,23,0,30,17,70
12/27/2012,25,0,31,35,91
12/28/2012,22,0,14,14,50
12/29/2012,21,0,21,21,63
12/30/2012,14,0,26,28,68
12/31/2012,16,0,16,22,54
1/1/2013,24,0,19,24,67
1/2/2013,16,0,18,33,67
1/3/2013,23,0,21,26,70
1/4/2013,28,0,25,21,74
1/5/2013,29,0,11,24,64
1/6/2013,24,0,22,15,61
1/7/2013,26,0,12,28,66
1/8/2013,22,0,15,24,61
1/9/2013,20,0,23,19,62
1/10/2013,32,0,27,14,73
1/11/2013,28,0,17,27,72
1/12/2013,17,0,20,28,65
1/13/2013,24,0,19,31,74
1/14/2013,19,0,23,21,63
1/15/2013,26,0,19,22,67
1/16/2013,31,0,20,15,66
1/17/2013,22,0,25,21,68
1/18/2013,19,0,29,18,66
1/19/2013,23,0,19,27,69
1/20/2013,29,0,12,23,64
1/21/2013,16,0,21,4,41
1/22/2013,22,0,15,26,63
1/23/2013,22,0,13,20,55
1/24/2013,23,0,19,14,56
1/25/2013,29,0,21,19,69
1/26/2013,27,0,29,15,71
1/27/2013,29,0,19,13,61
1/28/2013,29,0,16,5,50
1/29/2013,29,0,21,16,66
1/30/2013,19,0,24,14,57
1/31/2013,30,0,22,26,78
2/1/2013,24,0,25,26,75
2/2/2013,19,0,25,10,54
2/3/2013,31,0,13,29,73
2/4/2013,29,0,19,25,73
2/5/2013,13,0,11,17,41
2/6/2013,25,0,23,14,62
2/7/2013,26,0,11,22,59
2/8/2013,26,0,20,16,62
2/9/2013,22,0,22,26,70
2/10/2013,12,0,30,19,61
2/11/2013,29,0,24,25,78
2/12/2013,21,0,22,20,63
2/13/2013,26,0,19,14,59
2/14/2013,25,0,15,21,61
2/15/2013,21,0,16,13,50
2/16/2013,28,0,10,28,66
2/17/2013,24,0,22,18,64
2/18/2013,26,0,14,15,55
2/19/2013,29,0,8,25,62
2/20/2013,30,0,29,18,77
2/21/2013,23,0,23,10,56
2/22/2013,18,0,26,33,77
2/23/2013,21,0,19,32,72
2/24/2013,23,0,15,7,45
2/25/2013,24,0,22,17,63
2/26/2013,25,0,23,9,57
2/27/2013,21,0,15,6,42
2/28/2013,22,0,18,31,71
3/1/2013,23,0,28,9,60
3/2/2013,26,0,15,15,56
3/3/2013,31,0,24,20,75
3/4/2013,22,0,23,10,55
3/5/2013,17,0,19,18,54
3/6/2013,20,0,19,19,58
3/7/2013,18,0,29,20,67
3/8/2013,23,0,21,18,62
3/9/2013,25,0,16,32,73
3/10/2013,24,0,19,24,67
3/11/2013,23,0,21,17,61
3/12/2013,19,0,21,12,52
3/13/2013,30,0,19,28,77
3/14/2013,28,0,20,35,83
3/15/2013,23,0,31,10,64
3/16/2013,20,0,14,16,50
3/17/2013,20,0,18,12,50
3/18/2013,26,0,23,24,73
3/19/2013,19,0,21,19,59
3/20/2013,20,0,16,30,66
3/21/2013,22,0,28,28,78
3/22/2013,21,0,19,18,58
3/23/2013,21,0,28,13,62
3/24/2013,26,0,16,14,56
3/25/2013,24,0,22,22,68
3/26/2013,28,0,30,27,85
3/27/2013,22,0,13,19,54
3/28/2013,31,0,24,16,71
3/29/2013,18,0,28,6,52
3/30/2013,25,0,27,16,68
3/31/2013,28,0,29,20,77
4/1/2013,23,0,12,13,48
4/2/2013,18,0,15,20,53
4/3/2013,25,0,14,20,59
4/4/2013,24,0,11,26,61
4/5/2013,16,0,24,17,57
4/6/2013,30,0,28,33,91
4/7/2013,27,0,23,37,87
4/8/2013,19,0,16,18,53
4/9/2013,16,0,15,20,51
4/10/2013,22,0,18,13,53
4/11/2013,36,0,18,20,74
4/12/2013,24,0,21,12,57
4/13/2013,29,0,20,21,70
4/14/2013,18,0,23,17,58
4/15/2013,28,0,19,15,62
4/16/2013,18,0,15,8,41
4/17/2013,30,0,28,32,90
4/18/2013,25,0,12,13,50
4/19/2013,20,0,14,18,52
4/20/2013,17,0,25,29,71
4/21/2013,18,0,20,9,47
4/22/2013,20,0,14,18,52
4/23/2013,28,0,28,21,77
4/24/2013,25,0,12,22,59
4/25/2013,13,0,30,8,51
4/26/2013,25,0,16,15,56
4/27/2013,27,0,25,21,73
4/28/2013,23,0,15,30,68
4/29/2013,22,0,17,27,66
4/30/2013,29,0,24,23,76
5/1/2013,22,0,27,24,73
5/2/2013,19,0,25,18,62
5/3/2013,17,0,30,15,62
5/4/2013,22,0,14,12,48
5/5/2013,27,0,14,30,71
5/6/2013,14,0,21,16,51
5/7/2013,31,0,27,28,86
5/8/2013,14,0,15,20,49
5/9/2013,21,0,30,26,77
5/10/2013,25,0,18,17,60
5/11/2013,27,0,14,15,56
5/12/2013,29,0,20,16,65
5/13/2013,20,0,16,22,58
5/14/2013,15,0,30,23,68
5/15/2013,14,0,23,18,55
5/16/2013,25,0,29,25,79
5/17/2013,22,0,29,28,79
5/18/2013,23,0,25,20,68
5/19/2013,27,0,24,28,79
5/20/2013,27,0,16,20,63
5/21/2013,14,0,25,27,66
5/22/2013,32,0,18,39,89
5/23/2013,28,0,14,20,62
5/24/2013,13,0,15,12,40
5/25/2013,23,0,18,17,58
5/26/2013,25,0,20,25,70
5/27/2013,29,0,27,15,71
5/28/2013,18,0,18,15,51
5/29/2013,26,0,17,14,57
5/30/2013,18,0,9,30,57
5/31/2013,18,0,14,29,61
6/1/2013,24,0,24,25,73
6/2/2013,22,0,28,25,75
6/3/2013,14,0,12,22,48
6/4/2013,15,0,27,8,50
6/5/2013,22,0,20,24,66
6/6/2013,23,0,18,17,58
6/7/2013,17,0,24,15,56
6/8/2013,20,0,23,9,52
6/9/2013,24,0,26,25,75
6/10/2013,21,0,10,18,49
6/11/2013,28,0,23,13,64
6/12/2013,15,0,24,23,62
6/13/2013,25,0,9,29,63
6/14/2013,25,0,24,20,69
6/15/2013,16,0,16,29,61
6/16/2013,24,0,25,24,73
6/17/2013,28,0,17,30,75
6/18/2013,22,0,15,19,56
6/19/2013,24,0,16,37,77
6/20/2013,23,0,25,16,64
6/21/2013,24,0,27,37,88
6/22/2013,23,0,20,19,62
6/23/2013,23,0,27,25,75
6/24/2013,23,0,27,18,68
6/25/2013,27,0,10,12,49
6/26/2013,28,0,21,11,60
6/27/2013,12,0,10,13,35
6/28/2013,13,0,16,14,43
6/29/2013,25,0,16,28,69
6/30/2013,25,0,24,12,61
7/1/2013,27,0,22,17,66
7/2/2013,18,0,12,7,37
7/3/2013,18,0,11,15,44
7/4/2013,21,0,16,19,56
7/5/2013,21,0,18,29,68
7/6/2013,23,0,29,21,73
7/7/2013,31,0,25,7,63
7/8/2013,20,0,20,10,50
7/9/2013,22,0,21,8,51
7/10/2013,20,0,21,18,59
7/11/2013,29,0,16,33,78
7/12/2013,24,0,23,15,62
7/13/2013,22,0,22,19,63
7/14/2013,29,0,28,12,69
7/15/2013,28,0,29,25,82
7/16/2013,19,0,16,22,57
7/17/2013,27,0,11,13,51
7/18/2013,21,0,17,19,57
7/19/2013,22,0,15,29,66
7/20/2013,17,0,12,15,44
7/21/2013,26,0,16,20,62
7/22/2013,29,0,21,25,75
7/23/2013,14,0,32,20,66
7/24/2013,28,0,23,25,76
7/25/2013,28,0,16,21,65
7/26/2013,26,0,15,22,63
7/27/2013,22,0,12,29,63
7/28/2013,28,0,26,24,78
7/29/2013,20,0,26,13,59
7/30/2013,21,0,29,17,67
7/31/2013,23,0,19,21,63
8/1/2013,29,0,18,20,67
8/2/2013,17,0,17,22,56
8/3/2013,20,0,15,15,50
8/4/2013,30,0,16,16,62
8/5/2013,17,0,23,25,65
8/6/2013,20,0,21,15,56
8/7/2013,16,0,14,25,55
8/8/2013,22,0,24,19,65
8/9/2013,28,0,30,21,79
8/10/2013,20,0,16,14,50
8/11/2013,23,0,16,16,55
8/12/2013,19,0,22,23,64
8/13/2013,21,0,21,24,66
8/14/2013,20,0,28,36,84
8/15/2013,19,0,34,4,57
8/16/2013,17,0,22,12,51
8/17/2013,18,0,20,19,57
8/18/2013,26,0,13,15,54
8/19/2013,23,0,20,21,64
8/20/2013,21,0,21,24,66
8/21/2013,21,0,27,25,73
8/22/2013,23,0,20,24,67
8/23/2013,26,0,20,28,74
8/24/2013,17,0,15,16,48
8/25/2013,25,0,19,12,56
8/26/2013,27,0,14,19,60
8/27/2013,26,0,22,27,75
8/28/2013,25,0,19,17,61
8/29/2013,23,0,25,21,69
8/30/2013,21,0,26,13,60
8/31/2013,22,0,24,25,71
9/1/2013,19,0,18,14,51
9/2/2013,20,0,23,24,67
9/3/2013,15,0,16,19,50
9/4/2013,27,0,24,20,71
9/5/2013,29,0,18,17,64
9/6/2013,24,0,20,24,68
9/7/2013,30,0,22,13,65
9/8/2013,12,0,27,36,75
9/9/2013,29,0,18,18,65
9/10/2013,18,0,13,10,41
9/11/2013,16,0,30,14,60
9/12/2013,30,0,21,21,72
9/13/2013,16,0,15,27,58
9/14/2013,28,0,16,31,75
9/15/2013,23,0,30,30,83
9/16/2013,20,0,23,8,51
9/17/2013,19,0,19,21,59
9/18/2013,23,0,21,15,59
9/19/2013,22,0,21,21,64
9/20/2013,24,0,25,33,82
9/21/2013,24,0,19,18,61
9/22/2013,22,0,26,22,70
9/23/2013,27,0,15,22,64
9/24/2013,24,0,26,10,60
9/25/2013,17,0,27,12,56
9/26/2013,18,0,32,22,72
9/27/2013,24,0,19,22,65
9/28/2013,13,0,16,24,53
9/29/2013,27,0,21,11,59
9/30/2013,26,0,16,24,66
10/1/2013,24,0,26,27,77
10/2/2013,17,0,21,4,42
10/3/2013,26,0,18,11,55
10/4/2013,27,0,17,25,69
10/5/2013,20,0,21,24,65
10/6/2013,25,0,7,13,45
10/7/2013,33,0,30,17,80
10/8/2013,28,0,23,20,71
10/9/2013,11,0,12,19,42
10/10/2013,28,0,21,19,68
10/11/2013,17,0,18,19,54
10/12/2013,13,0,21,9,43
10/13/2013,33,0,16,12,61
10/14/2013,32,0,31,16,79
10/15/2013,22,0,20,31,73
10/16/2013,26,0,19,6,51
10/17/2013,29,0,19,15,63
10/18/2013,23,0,25,17,65
10/19/2013,20,0,24,12,56
10/20/2013,21,0,12,25,58
10/21/2013,18,0,11,35,64
10/22/2013,22,0,14,30,66
10/23/2013,28,0,27,26,81
10/24/2013,20,0,19,23,62
10/25/2013,26,0,18,5,49
10/26/2013,25,0,12,15,52
10/27/2013,17,0,20,4,41
10/28/2013,27,0,21,28,76
10/29/2013,19,0,14,19,52
10/30/2013,27,0,29,24,80
10/31/2013,22,0,28,15,65
11/1/2013,23,0,19,27,69
11/2/2013,26,0,19,3,48
11/3/2013,21,0,22,18,61
11/4/2013,25,0,16,11,52
11/5/2013,23,0,9,24,56
11/6/2013,29,0,12,12,53
11/7/2013,22,0,17,17,56
11/8/2013,22,0,16,6,44
11/9/2013,22,0,15,34,71
11/10/2013,25,0,17,20,62
11/11/2013,22,0,14,13,49
11/12/2013,21,0,20,19,60
11/13/2013,29,0,16,30,75
11/14/2013,19,0,21,7,47
11/15/2013,31,0,19,26,76
11/16/2013,29,0,17,24,70
11/17/2013,27,0,28,15,70
11/18/2013,21,0,28,25,74
11/19/2013,20,0,17,9,46
11/20/2013,22,0,19,20,61
11/21/2013,24,0,24,25,73
11/22/2013,26,0,23,35,84
11/23/2013,12,0,21,15,48
11/24/2013,21,0,19,17,57
11/25/2013,21,0,21,20,62
11/26/2013,20,0,14,23,57
11/27/2013,28,0,24,19,71
11/28/2013,29,0,17,22,68
11/29/2013,27,0,23,30,80
11/30/2013,33,0,25,12,70
12/1/2013,18,0,25,17,60
12/2/2013,25,0,13,20,58
12/3/2013,24,0,19,6,49
12/4/2013,19,0,27,27,73
12/5/2013,26,0,27,16,69
12/6/2013,26,0,21,12,59
12/7/2013,23,0,29,16,68
12/8/2013,12,0,17,22,51
12/9/2013,23,0,12,25,60
12/10/2013,22,0,12,19,53
12/11/2013,19,0,23,33,75
12/12/2013,27,0,24,12,63
12/13/2013,18,0,20,15,53
12/14/2013,23,0,16,24,63
12/15/2013,23,0,27,19,69
12/16/2013,23,0,27,16,66
12/17/2013,25,0,14,19,58
12/18/2013,22,0,21,11,54
12/19/2013,29,0,18,16,63
12/20/2013,19,0,20,28,67
12/21/2013,28,0,19,15,62
12/22/2013,26,0,15,23,64
12/23/2013,25,0,20,34,79
12/24/2013,26,0,11,24,61
12/25/2013,16,0,18,14,48
12/26/2013,22,0,21,20,63
12/27/2013,19,0,12,23,54
12/28/2013,25,0,19,24,68
12/29/2013,15,0,19,28,62
12/30/2013,22,0,14,10,46
12/31/2013,27,0,20,23,70
1/1/2014,16,0,16,19,51
1/2/2014,29,0,18,24,71
1/3/2014,30,0,28,22,80
1/4/2014,19,0,19,14,52
1/5/2014,26,0,26,20,72
1/6/2014,32,0,24,18,74
1/7/2014,24,0,21,3,48
1/8/2014,22,0,9,17,48
1/9/2014,30,0,17,5,52
1/10/2014,28,0,18,19,65
1/11/2014,20,0,16,21,57
1/12/2014,20,0,15,19,54
1/13/2014,30,0,26,11,67
1/14/2014,13,0,19,18,50
1/15/2014,28,0,11,13,52
1/16/2014,23,0,13,21,57
1/17/2014,23,0,20,14,57
1/18/2014,26,0,14,9,49
1/19/2014,29,0,26,25,80
1/20/2014,27,0,22,18,67
1/21/2014,27,0,22,15,64
1/22/2014,34,0,14,17,65
1/23/2014,29,0,17,10,56
1/24/2014,11,0,7,32,50
1/25/2014,13,0,23,11,47
1/26/2014,19,0,14,17,50
1/27/2014,19,0,6,7,32
1/28/2014,18,0,15,12,45
1/29/2014,19,0,15,15,49
1/30/2014,27,0,32,20,79
1/31/2014,20,0,19,35,74
2/1/2014,24,0,24,15,63
2/2/2014,24,0,16,21,61
2/3/2014,27,0,13,22,62
2/4/2014,21,0,32,23,76
2/5/2014,15,0,29,3,47
2/6/2014,26,0,22,29,77
2/7/2014,25,0,21,19,65
2/8/2014,16,0,26,16,58
2/9/2014,26,0,12,16,54
2/10/2014,30,0,15,1,46
2/11/2014,20,0,29,24,73
2/12/2014,19,0,20,27,66
2/13/2014,21,0,19,23,63
2/14/2014,20,0,24,13,57
2/15/2014,19,0,19,25,63
2/16/2014,20,0,18,22,60
2/17/2014,24,0,26,4,54
2/18/2014,30,0,20,23,73
2/19/2014,30,0,25,16,71
2/20/2014,15,0,13,27,55
2/21/2014,14,0,23,33,70
2/22/2014,21,0,18,24,63
2/23/2014,18,0,24,25,67
2/24/2014,10,0,16,25,51
2/25/2014,20,0,31,11,62
2/26/2014,23,0,16,13,52
2/27/2014,27,0,17,25,69
2/28/2014,24,0,24,25,73
3/1/2014,24,0,19,13,56
3/2/2014,24,0,23,19,66
3/3/2014,34,0,26,19,79
3/4/2014,28,0,14,11,53
3/5/2014,27,0,22,10,59
3/6/2014,24,0,28,27,79
3/7/2014,22,0,30,14,66
3/8/2014,28,0,29,18,75
3/9/2014,22,0,15,20,57
3/10/2014,24,0,15,17,56
3/11/2014,19,0,14,31,64
3/12/2014,18,0,14,21,53
3/13/2014,29,0,19,32,80
3/14/2014,27,0,20,29,76
3/15/2014,18,0,23,39,80
3/16/2014,27,0,28,15,70
3/17/2014,30,0,27,33,90
3/18/2014,21,0,17,22,60
3/19/2014,31,0,23,23,77
3/20/2014,18,0,22,15,55
3/21/2014,20,0,17,29,66
3/22/2014,26,0,19,26,71
3/23/2014,20,0,12,15,47
3/24/2014,22,0,22,18,62
3/25/2014,23,0,25,17,65
3/26/2014,21,0,16,23,60
3/27/2014,28,0,23,27,78
3/28/2014,29,0,19,19,67
3/29/2014,30,0,19,24,73
3/30/2014,12,0,21,12,45
3/31/2014,32,0,21,13,66
4/1/2014,25,0,25,22,72
4/2/2014,18,0,14,20,52
4/3/2014,15,0,17,27,59
4/4/2014,17,0,12,21,50
4/5/2014,12,0,16,22,50
4/6/2014,28,0,18,19,65
4/7/2014,17,0,26,15,58
4/8/2014,18,0,20,16,54
4/9/2014,26,0,19,12,57
4/10/2014,29,0,17,18,64
4/11/2014,26,0,21,11,58
4/12/2014,28,0,27,14,69
4/13/2014,30,0,21,22,73
4/14/2014,20,0,15,10,45
4/15/2014,24,0,13,13,50
4/16/2014,24,0,27,19,70
4/17/2014,16,0,15,13,44
4/18/2014,22,0,20,19,61
4/19/2014,27,0,18,30,75
4/20/2014,25,0,30,28,83
4/21/2014,20,0,16,4,40
4/22/2014,29,0,20,9,58
4/23/2014,15,0,28,14,57
4/24/2014,20,0,23,30,73
4/25/2014,25,0,28,18,71
4/26/2014,14,0,20,18,52
4/27/2014,31,0,22,13,66
4/28/2014,14,0,21,29,64
4/29/2014,22,0,19,21,62
4/30/2014,21,0,14,25,60
5/1/2014,21,0,21,20,62
5/2/2014,28,0,25,20,73
5/3/2014,28,0,19,27,74
5/4/2014,26,0,16,8,50
5/5/2014,19,0,22,11,52
5/6/2014,18,0,28,12,58
5/7/2014,31,0,8,19,58
5/8/2014,22,0,23,7,52
5/9/2014,16,0,19,21,56
5/10/2014,23,0,23,28,74
5/11/2014,20,0,16,14,50
5/12/2014,31,0,23,18,72
5/13/2014,18,0,17,22,57
5/14/2014,32,0,27,18,77
5/15/2014,27,0,30,15,72
5/16/2014,14,0,17,21,52
5/17/2014,28,0,27,12,67
5/18/2014,23,0,20,27,70
5/19/2014,16,0,25,18,59
5/20/2014,26,0,26,22,74
5/21/2014,30,0,20,20,70
5/22/2014,28,0,15,23,66
5/23/2014,28,0,21,23,72
5/24/2014,22,0,19,31,72
5/25/2014,24,0,26,13,63
5/26/2014,29,0,13,7,49
5/27/2014,27,0,25,25,77
5/28/2014,24,0,9,16,49
5/29/2014,22,0,24,9,55
5/30/2014,15,0,17,11,43
5/31/2014,23,0,20,16,59
6/1/2014,17,0,23,22,62
6/2/2014,15,0,30,27,72
6/3/2014,13,0,24,23,60
6/4/2014,15,0,17,16,48
6/5/2014,15,0,29,10,54
6/6/2014,22,0,16,17,55
6/7/2014,26,0,26,27,79
6/8/2014,35,0,25,27,87
6/9/2014,23,0,22,9,54
6/10/2014,22,0,29,22,73
6/11/2014,27,0,20,10,57
6/12/2014,15,0,9,20,44
6/13/2014,14,0,24,14,52
6/14/2014,29,0,27,23,79
6/15/2014,24,0,17,25,66
6/16/2014,30,0,17,23,70
6/17/2014,25,0,26,15,66
6/18/2014,24,0,20,19,63
6/19/2014,22,0,26,10,58
6/20/2014,20,0,18,22,60
6/21/2014,24,0,29,26,79
6/22/2014,19,0,22,29,70
6/23/2014,19,0,24,6,49
6/24/2014,16,0,15,4,35
6/25/2014,18,0,23,18,59
6/26/2014,17,0,25,3,45
6/27/2014,20,0,20,22,62
6/28/2014,21,0,17,27,65
6/29/2014,19,0,24,17,60
6/30/2014,33,0,20,15,68
7/1/2014,25,0,20,32,77
7/2/2014,26,0,13,14,53
7/3/2014,14,0,18,11,43
7/4/2014,29,0,23,18,70
7/5/2014,31,0,18,17,66
7/6/2014,23,0,27,13,63
7/7/2014,27,0,22,35,84
7/8/2014,24,0,23,29,76
7/9/2014,20,0,13,22,55
7/10/2014,24,0,11,23,58
7/11/2014,21,0,28,20,69
7/12/2014,24,0,25,17,66
7/13/2014,20,0,19,35,74
7/14/2014,16,0,20,17,53
7/15/2014,28,0,9,3,40
7/16/2014,27,0,26,12,65
7/17/2014,36,0,16,33,85
7/18/2014,22,0,24,13,59
7/19/2014,25,0,29,26,80
7/20/2014,26,0,24,34,84
7/21/2014,28,0,25,14,67
7/22/2014,18,0,13,24,55
7/23/2014,27,0,18,28,73
7/24/2014,19,0,16,24,59
7/25/2014,18,0,32,15,65
7/26/2014,21,0,13,32,66
7/27/2014,25,0,18,33,76
7/28/2014,13,0,10,36,59
7/29/2014,19,0,14,9,42
7/30/2014,25,0,8,17,50
7/31/2014,20,0,18,6,44
8/1/2014,17,0,28,13,58
8/2/2014,25,0,14,14,53
8/3/2014,31,0,19,18,68
8/4/2014,20,0,12,30,62
8/5/2014,26,0,25,18,69
8/6/2014,21,0,27,27,75
8/7/2014,24,0,17,18,59
8/8/2014,26,0,17,19,62
8/9/2014,12,0,14,15,41
8/10/2014,20,0,25,12,57
8/11/2014,21,0,20,10,51
8/12/2014,20,0,19,10,49
8/13/2014,26,0,23,10,59
8/14/2014,25,0,19,26,70
8/15/2014,21,0,27,16,64
8/16/2014,21,0,12,16,49
8/17/2014,20,0,24,22,66
8/18/2014,29,0,6,14,49
8/19/2014,31,0,15,18,64
8/20/2014,25,0,31,20,76
8/21/2014,22,0,19,9,50
8/22/2014,17,0,24,22,63
8/23/2014,24,0,18,9,51
8/24/2014,32,0,17,27,76
8/25/2014,23,0,20,29,72
8/26/2014,27,0,25,16,68
8/27/2014,26,0,18,28,72
8/28/2014,21,0,24,23,68
8/29/2014,18,0,13,29,60
8/30/2014,20,0,24,21,65
8/31/2014,29,0,13,5,47
9/1/2014,17,0,20,28,65
9/2/2014,25,0,17,27,69
9/3/2014,19,0,15,5,39
9/4/2014,14,0,23,19,56
9/5/2014,15,0,11,25,51
9/6/2014,23,0,13,10,46
9/7/2014,33,0,26,33,92
9/8/2014,12,0,23,30,65
9/9/2014,24,0,10,13,47
9/10/2014,28,0,19,16,63
9/11/2014,24,0,15,34,73
9/12/2014,27,0,12,20,59
9/13/2014,27,0,24,24,75
9/14/2014,17,0,23,19,59
9/15/2014,31,0,12,20,63
9/16/2014,24,0,14,21,59
9/17/2014,21,0,28,15,64
9/18/2014,22,0,23,31,76
9/19/2014,21,0,26,21,68
9/20/2014,27,0,24,18,69
9/21/2014,20,0,13,31,64
9/22/2014,11,0,16,13,40
9/23/2014,29,0,19,20,68
9/24/2014,15,0,25,24,64
9/25/2014,17,0,17,16,50
9/26/2014,27,0,24,30,81
9/27/2014,21,0,21,23,65
9/28/2014,14,0,21,28,63
9/29/2014,24,0,19,18,61
9/30/2014,22,0,14,18,54
10/1/2014,24,0,20,23,67
10/2/2014,22,0,26,10,58
10/3/2014,24,0,23,22,69
10/4/2014,22,0,17,33,72
10/5/2014,18,0,17,17,52
10/6/2014,29,0,20,26,75
10/7/2014,17,0,21,22,60
10/8/2014,28,0,22,14,64
10/9/2014,20,0,28,14,62
10/10/2014,28,0,26,20,74
10/11/2014,12,0,26,27,65
10/12/2014,17,0,16,31,64
10/13/2014,22,0,21,19,62
10/14/2014,24,0,23,36,83
10/15/2014,20,0,23,18,61
10/16/2014,21,0,12,33,66
10/17/2014,24,0,15,16,55
10/18/2014,19,0,27,26,72
10/19/2014,23,0,12,31,66
10/20/2014,25,0,22,25,72
10/21/2014,22,0,27,22,71
10/22/2014,22,0,21,10,53
10/23/2014,17,0,27,21,65
10/24/2014,21,0,17,16,54
10/25/2014,22,0,21,30,73
10/26/2014,30,0,22,18,70
10/27/2014,27,0,17,18,62
10/28/2014,31,0,18,28,77
10/29/2014,21,0,18,19,58
10/30/2014,21,0,21,16,58
10/31/2014,23,0,25,10,58
11/1/2014,25,0,14,31,70
11/2/2014,28,0,20,19,67
11/3/2014,29,0,18,33,80
11/4/2014,20,0,17,16,53
11/5/2014,21,0,25,26,72
11/6/2014,26,0,12,22,60
11/7/2014,19,0,17,26,62
11/8/2014,18,0,18,26,62
11/9/2014,27,0,24,28,79
11/10/2014,25,0,19,19,63
11/11/2014,27,0,20,14,61
11/12/2014,20,0,27,20,67
11/13/2014,34,0,21,21,76
11/14/2014,32,0,27,29,88
11/15/2014,30,0,13,27,70
11/16/2014,13,0,26,15,54
11/17/2014,23,0,31,20,74
11/18/2014,28,0,8,33,69
11/19/2014,27,0,22,14,63
11/20/2014,24,0,21,22,67
11/21/2014,26,0,13,16,55
11/22/2014,16,0,22,26,64
11/23/2014,23,0,17,23,63
11/24/2014,29,0,23,10,62
11/25/2014,25,0,13,20,58
11/26/2014,18,0,13,8,39
11/27/2014,10,0,24,26,60
11/28/2014,17,0,12,6,35
11/29/2014,27,0,22,19,68
11/30/2014,20,0,17,8,45
12/1/2014,23,0,20,12,55
12/2/2014,20,0,21,21,62
12/3/2014,21,0,23,16,60
12/4/2014,31,0,14,15,60
12/5/2014,22,0,11,32,65
12/6/2014,26,0,29,19,74
12/7/2014,22,0,10,22,54
12/8/2014,24,0,13,37,74
12/9/2014,19,0,16,12,47
12/10/2014,28,0,22,38,88
12/11/2014,15,0,23,26,64
12/12/2014,14,0,29,19,62
12/13/2014,23,0,26,12,61
12/14/2014,23,0,30,16,69
12/15/2014,20,0,24,14,58
12/16/2014,23,0,31,21,75
12/17/2014,30,0,22,17,69
12/18/2014,23,0,13,23,59
12/19/2014,12,0,24,9,45
12/20/2014,21,0,22,19,62
12/21/2014,29,0,14,25,68
12/22/2014,26,0,18,18,62
12/23/2014,16,0,26,28,70
12/24/2014,20,0,24,26,70
12/25/2014,21,0,26,10,57
12/26/2014,20,0,28,20,68
12/27/2014,25,0,23,20,68
12/28/2014,29,0,14,16,59
12/29/2014,32,0,19,18,69
12/30/2014,30,0,20,18,68
12/31/2014,32,0,16,20,68
1/1/2015,24,0,18,18,60
1/2/2015,25,0,27,26,78
1/3/2015,24,0,11,23,58
1/4/2015,13,0,20,20,53
1/5/2015,30,0,16,22,68
1/6/2015,31,0,19,24,74
1/7/2015,22,0,28,15,65
1/8/2015,28,0,16,36,80
1/9/2015,26,0,23,19,68
1/10/2015,19,0,15,17,51
1/11/2015,28,0,20,22,70
1/12/2015,19,0,16,25,60
1/13/2015,29,0,23,18,70
1/14/2015,26,0,21,15,62
1/15/2015,26,0,24,18,68
1/16/2015,13,0,12,22,47
1/17/2015,27,0,23,18,68
1/18/2015,29,0,24,22,75
1/19/2015,21,0,13,20,54
1/20/2015,30,0,19,15,64
1/21/2015,28,0,17,26,71
1/22/2015,24,0,31,21,76
1/23/2015,23,0,14,29,66
1/24/2015,19,0,23,27,69
1/25/2015,13,0,21,21,55
1/26/2015,19,0,22,16,57
1/27/2015,18,0,23,28,69
1/28/2015,22,0,18,17,57
1/29/2015,30,0,15,16,61
1/30/2015,17,0,16,15,48
1/31/2015,21,0,20,26,67
2/1/2015,24,0,22,15,61
2/2/2015,21,0,18,31,70
2/3/2015,29,0,20,12,61
2/4/2015,27,0,15,19,61
2/5/2015,19,0,25,31,75
2/6/2015,22,0,23,22,67
2/7/2015,22,0,25,10,57
2/8/2015,29,0,27,28,84
2/9/2015,20,0,31,17,68
2/10/2015,21,0,27,28,76
2/11/2015,22,0,29,14,65
2/12/2015,30,0,25,29,84
2/13/2015,24,0,20,5,49
2/14/2015,22,0,17,29,68
2/15/2015,23,0,18,17,58
2/16/2015,20,0,18,32,70
2/17/2015,13,0,19,29,61
2/18/2015,23,0,16,9,48
2/19/2015,27,0,19,6,52
2/20/2015,18,0,29,31,78
2/21/2015,16,0,27,25,68
2/22/2015,24,0,28,21,73
2/23/2015,13,0,21,11,45
2/24/2015,25,0,26,22,73
2/25/2015,22,0,25,25,72
2/26/2015,31,0,16,21,68
2/27/2015,20,0,17,17,54
2/28/2015,19,0,18,25,62
3/1/2015,28,0,17,29,74
3/2/2015,19,0,15,23,57
3/3/2015,20,0,20,19,59
3/4/2015,20,0,18,27,65
3/5/2015,25,0,20,10,55
3/6/2015,23,0,21,25,69
3/7/2015,20,0,26,34,80
3/8/2015,21,0,19,22,62
3/9/2015,28,0,15,16,59
3/10/2015,22,0,25,20,67
3/11/2015,17,0,25,20,62
3/12/2015,26,0,23,27,76
3/13/2015,29,0,16,14,59
3/14/2015,17,0,19,32,68
3/15/2015,31,0,28,23,82
3/16/2015,30,0,21,28,79
3/17/2015,22,0,18,23,63
3/18/2015,24,0,14,17,55
3/19/2015,29,0,23,10,62
3/20/2015,15,0,33,18,66
3/21/2015,25,0,15,20,60
3/22/2015,17,0,19,18,54
3/23/2015,15,0,14,11,40
3/24/2015,24,0,17,17,58
3/25/2015,26,0,22,26,74
3/26/2015,29,0,17,21,67
3/27/2015,31,0,22,20,73
3/28/2015,18,0,17,5,40
3/29/2015,23,0,19,15,57
3/30/2015,13,0,17,19,49
3/31/2015,20,0,13,13,46
4/1/2015,23,0,27,33,83
4/2/2015,27,0,8,23,58
4/3/2015,22,0,24,23,69
4/4/2015,26,0,19,9,54
4/5/2015,29,0,16,13,58
4/6/2015,14,0,18,20,52
4/7/2015,22,0,25,17,64
4/8/2015,15,0,21,19,55
4/9/2015,19,0,21,23,63
4/10/2015,28,0,15,25,68
4/11/2015,17,0,12,18,47
4/12/2015,21,0,22,18,61
4/13/2015,17,0,24,19,60
4/14/2015,26,0,15,22,63
4/15/2015,28,0,19,31,78
4/16/2015,26,0,22,22,70
4/17/2015,31,0,13,22,66
4/18/2015,17,0,20,12,49
4/19/2015,33,0,25,21,79
4/20/2015,17,0,17,26,60
4/21/2015,21,0,21,26,68
4/22/2015,19,0,29,23,71
4/23/2015,32,0,22,19,73
4/24/2015,24,0,11,30,65
4/25/2015,23,0,22,15,60
4/26/2015,25,0,24,1,50
4/27/2015,23,0,18,11,52
4/28/2015,29,0,22,17,68
4/29/2015,26,0,19,4,49
4/30/2015,20,0,28,8,56
5/1/2015,29,0,19,15,63
5/2/2015,27,0,20,23,70
5/3/2015,33,0,18,28,79
5/4/2015,24,0,20,29,73
5/5/2015,19,0,9,18,46
5/6/2015,18,0,21,19,58
5/7/2015,19,0,19,14,52
5/8/2015,24,0,30,25,79
5/9/2015,26,0,20,28,74
5/10/2015,23,0,19,21,63
5/11/2015,31,0,12,25,68
5/12/2015,21,0,22,16,59
5/13/2015,27,0,23,33,83
5/14/2015,18,0,24,29,71
5/15/2015,32,0,26,31,89
5/16/2015,30,0,16,9,55
5/17/2015,15,0,18,15,48
5/18/2015,28,0,13,13,54
5/19/2015,18,0,15,21,54
5/20/2015,28,0,23,25,76
5/21/2015,30,0,22,13,65
5/22/2015,21,0,12,14,47
5/23/2015,22,0,22,13,57
5/24/2015,16,0,22,19,57
5/25/2015,18,0,17,23,58
5/26/2015,17,0,13,11,41
5/27/2015,23,0,14,29,66
5/28/2015,29,0,28,28,85
5/29/2015,21,0,20,10,51
5/30/2015,31,0,11,21,63
5/31/2015,21,0,26,19,66
6/1/2015,19,0,25,23,67
6/2/2015,32,0,14,28,74
6/3/2015,19,0,22,26,67
6/4/2015,28,0,23,26,77
6/5/2015,23,0,14,21,58
6/6/2015,22,0,21,19,62
6/7/2015,13,0,18,15,46
6/8/2015,22,0,26,22,70
6/9/2015,28,0,24,24,76
6/10/2015,33,0,24,20,77
6/11/2015,26,0,18,25,69
6/12/2015,15,0,24,21,60
6/13/2015,27,0,18,22,67
6/14/2015,26,0,16,19,61
6/15/2015,33,0,17,21,71
6/16/2015,26,0,22,28,76
6/17/2015,14,0,18,32,64
6/18/2015,20,0,17,22,59
6/19/2015,19,0,25,5,49
6/20/2015,15,0,17,10,42
6/21/2015,16,0,23,28,67
6/22/2015,20,0,27,16,63
6/23/2015,17,0,25,30,72
6/24/2015,31,0,22,17,70
6/25/2015,28,0,18,33,79
6/26/2015,15,0,13,14,42
6/27/2015,27,0,29,25,81
6/28/2015,29,0,26,20,75
6/29/2015,25,0,15,20,60
6/30/2015,19,0,16,33,68
7/1/2015,17,0,14,24,55
7/2/2015,22,0,14,19,55
7/3/2015,22,0,18,13,53
7/4/2015,23,0,20,24,67
7/5/2015,26,0,19,13,58
7/6/2015,29,0,16,29,74
7/7/2015,20,0,30,13,63
7/8/2015,17,0,28,25,70
7/9/2015,23,0,11,30,64
7/10/2015,21,0,19,26,66
7/11/2015,29,0,24,18,71
7/12/2015,18,0,23,22,63
7/13/2015,31,0,15,29,75
7/14/2015,24,0,19,35,78
7/15/2015,17,0,28,10,55
7/16/2015,33,0,12,12,57
7/17/2015,29,0,11,32,72
7/18/2015,27,0,13,25,65
7/19/2015,24,0,26,24,74
7/20/2015,27,0,27,11,65
7/21/2015,30,0,15,22,67
7/22/2015,15,0,29,17,61
7/23/2015,23,0,14,24,61
7/24/2015,25,0,13,9,47
7/25/2015,21,0,21,21,63
7/26/2015,16,0,6,17,39
7/27/2015,22,0,16,19,57
7/28/2015,26,0,14,26,66
7/29/2015,24,0,21,10,55
7/30/2015,18,0,18,13,49
7/31/2015,26,0,18,28,72
8/1/2015,15,0,21,3,39
8/2/2015,29,0,13,21,63
8/3/2015,28,0,22,16,66
8/4/2015,33,0,14,19,66
8/5/2015,24,0,26,12,62
8/6/2015,13,0,13,23,49
8/7/2015,16,0,27,8,51
8/8/2015,22,0,14,29,65
8/9/2015,22,0,18,8,48
8/10/2015,23,0,33,9,65
8/11/2015,19,0,18,23,60
8/12/2015,16,0,29,23,68
8/13/2015,29,0,16,15,60
8/14/2015,22,0,23,23,68
8/15/2015,26,0,28,15,69
8/16/2015,23,0,25,24,72
8/17/2015,30,0,10,29,69
8/18/2015,23,0,18,24,65
8/19/2015,27,0,21,15,63
8/20/2015,24,0,28,17,69
8/21/2015,26,0,23,21,70
8/22/2015,16,0,26,11,53
8/23/2015,24,0,19,31,74
8/24/2015,23,0,16,23,62
8/25/2015,30,0,19,38,87
8/26/2015,20,0,18,18,56
8/27/2015,23,0,12,21,56
8/28/2015,17,0,25,13,55
8/29/2015,20,0,24,21,65
8/30/2015,22,0,13,22,57
8/31/2015,19,0,11,21,51
9/1/2015,14,0,24,31,69
9/2/2015,13,0,26,32,71
9/3/2015,21,0,24,29,74
9/4/2015,11,0,22,31,64
9/5/2015,21,0,11,20,52
9/6/2015,17,0,18,19,54
9/7/2015,20,0,22,3,45
9/8/2015,18,0,14,27,59
9/9/2015,19,0,25,16,60
9/10/2015,35,0,30,9,74
9/11/2015,26,0,13,16,55
9/12/2015,13,0,24,24,61
9/13/2015,26,0,12,14,52
9/14/2015,24,0,18,25,67
9/15/2015,18,0,15,27,60
9/16/2015,21,0,29,26,76
9/17/2015,21,0,26,16,63
9/18/2015,20,0,21,26,67
9/19/2015,26,0,29,6,61
9/20/2015,19,0,11,9,39
9/21/2015,24,0,20,18,62
9/22/2015,20,0,34,4,58
9/23/2015,16,0,24,23,63
9/24/2015,21,0,25,16,62
9/25/2015,20,0,31,21,72
9/26/2015,32,0,32,15,79
9/27/2015,21,0,19,33,73
9/28/2015,24,0,20,21,65
9/29/2015,14,0,23,16,53
9/30/2015,16,0,23,36,75
10/1/2015,23,0,28,25,76
10/2/2015,23,0,21,12,56
10/3/2015,26,0,27,38,91
10/4/2015,24,0,14,29,67
10/5/2015,23,0,17,21,61
10/6/2015,19,0,24,25,68
10/7/2015,24,0,28,21,73
10/8/2015,18,0,17,18,53
10/9/2015,17,0,25,21,63
10/10/2015,29,0,29,21,79
10/11/2015,23,0,18,25,66
10/12/2015,21,0,20,15,56
10/13/2015,17,0,19,26,62
10/14/2015,19,0,25,12,56
10/15/2015,21,0,17,25,63
10/16/2015,26,0,19,18,63
10/17/2015,25,0,27,26,78
10/18/2015,14,0,20,25,59
10/19/2015,29,0,21,24,74
10/20/2015,23,0,24,17,64
10/21/2015,26,0,18,29,73
10/22/2015,30,0,16,13,59
10/23/2015,32,0,23,22,77
10/24/2015,26,0,16,14,56
10/25/2015,23,0,13,13,49
10/26/2015,16,0,25,9,50
10/27/2015,13,0,6,15,34
10/28/2015,13,0,28,17,58
10/29/2015,23,0,12,14,49
10/30/2015,23,0,23,30,76
10/31/2015,19,0,16,18,53
11/1/2015,30,0,32,27,89
11/2/2015,35,0,21,21,77
11/3/2015,20,0,22,3,45
11/4/2015,24,0,13,24,61
11/5/2015,29,0,8,12,49
11/6/2015,25,0,25,21,71
11/7/2015,21,0,25,20,66
11/8/2015,27,0,24,15,66
11/9/2015,21,0,13,26,60
11/10/2015,25,0,22,19,66
11/11/2015,21,0,15,16,52
11/12/2015,18,0,14,18,50
11/13/2015,19,0,25,5,49
11/14/2015,20,0,13,26,59
11/15/2015,27,0,19,24,70
11/16/2015,24,0,10,24,58
11/17/2015,24,0,14,15,53
11/18/2015,26,0,16,22,64
11/19/2015,20,0,16,15,51
11/20/2015,23,0,23,16,62
11/21/2015,19,0,19,22,60
11/22/2015,26,0,8,18,52
11/23/2015,25,0,12,22,59
11/24/2015,25,0,29,27,81
11/25/2015,21,0,25,25,71
11/26/2015,15,0,23,19,57
11/27/2015,29,0,29,9,67
11/28/2015,24,0,22,23,69
11/29/2015,25,0,12,7,44
11/30/2015,21,0,25,27,73
12/1/2015,23,0,16,13,52
12/2/2015,30,0,19,15,64
12/3/2015,27,0,25,31,83
12/4/2015,25,0,15,15,55
12/5/2015,14,0,26,20,60
12/6/2015,21,0,22,4,47
12/7/2015,23,0,17,26,66
12/8/2015,20,0,20,30,70
12/9/2015,25,0,13,17,55
12/10/2015,13,0,31,11,55
12/11/2015,26,0,17,34,77
12/12/2015,13,0,17,9,39
12/13/2015,32,0,16,15,63
12/14/2015,27,0,29,26,82
12/15/2015,32,0,27,16,75
12/16/2015,19,0,11,18,48
12/17/2015,29,0,28,29,86
12/18/2015,29,0,26,26,81
12/19/2015,21,0,20,15,56
12/20/2015,29,0,19,28,76
12/21/2015,16,0,11,15,42
12/22/2015,22,0,17,19,58
12/23/2015,16,0,24,18,58
12/24/2015,16,0,26,7,49
12/25/2015,17,0,13,18,48
12/26/2015,25,0,15,18,58
12/27/2015,14,0,25,26,65
12/28/2015,19,0,22,26,67
12/29/2015,22,0,21,11,54
12/30/2015,31,0,20,31,82
12/31/2015,19,0,16,15,50
1/1/2016,25,0,17,22,64
1/2/2016,20,0,12,32,64
1/3/2016,26,0,17,31,74
1/4/2016,26,0,24,14,64
1/5/2016,21,0,21,21,63
1/6/2016,18,0,22,24,64
1/7/2016,31,0,20,19,70
1/8/2016,26,0,12,10,48
1/9/2016,13,0,13,20,46
1/10/2016,29,0,16,17,62
1/11/2016,30,0,18,27,75
1/12/2016,26,0,22,19,67
1/13/2016,16,0,18,31,65
1/14/2016,25,0,18,18,61
1/15/2016,24,0,16,22,62
1/16/2016,26,0,17,17,60
1/17/2016,27,0,12,27,66
1/18/2016,21,0,16,18,55
1/19/2016,15,0,26,28,69
1/20/2016,25,0,11,26,62
1/21/2016,22,0,13,20,55
1/22/2016,30,0,33,24,87
1/23/2016,30,0,15,14,59
1/24/2016,21,0,29,17,67
1/25/2016,19,0,23,18,60
1/26/2016,29,0,9,20,58
1/27/2016,32,0,14,19,65
1/28/2016,28,0,27,31,86
1/29/2016,20,0,17,22,59
1/30/2016,21,0,19,33,73
1/31/2016,31,0,25,19,75
2/1/2016,21,0,25,27,73
2/2/2016,23,0,19,28,70
2/3/2016,18,0,18,23,59
2/4/2016,16,0,24,5,45
2/5/2016,29,0,13,12,54
2/6/2016,22,0,15,2,39
2/7/2016,33,0,19,16,68
2/8/2016,14,0,16,15,45
2/9/2016,24,0,19,18,61
2/10/2016,23,0,24,30,77
2/11/2016,27,0,22,16,65
2/12/2016,17,0,16,20,53
2/13/2016,26,0,29,28,83
2/14/2016,30,0,10,18,58
2/15/2016,33,0,20,20,73
2/16/2016,28,0,15,19,62
2/17/2016,14,0,27,25,66
2/18/2016,22,0,14,27,63
2/19/2016,28,0,27,27,82
2/20/2016,24,0,28,30,82
2/21/2016,22,0,19,29,70
2/22/2016,30,0,17,31,78
2/23/2016,21,0,22,12,55
2/24/2016,10,0,21,26,57
2/25/2016,33,0,17,32,82
2/26/2016,24,0,15,15,54
2/27/2016,30,0,12,23,65
2/28/2016,24,0,20,11,55
2/29/2016,23,0,21,18,62
3/1/2016,18,0,14,29,61
3/2/2016,26,0,18,24,68
3/3/2016,28,0,23,19,70
3/4/2016,24,0,15,18,57
3/5/2016,30,0,22,15,67
3/6/2016,34,0,20,15,69
3/7/2016,21,0,18,15,54
3/8/2016,20,0,28,28,76
3/9/2016,34,0,19,23,76
3/10/2016,16,0,22,15,53
3/11/2016,20,0,26,22,68
3/12/2016,22,0,23,17,62
3/13/2016,27,0,22,12,61
3/14/2016,18,0,18,17,53
3/15/2016,23,0,11,24,58
3/16/2016,23,0,24,10,57
3/17/2016,15,0,27,21,63
3/18/2016,29,0,19,10,58
3/19/2016,28,0,11,14,53
3/20/2016,29,0,24,24,77
3/21/2016,28,0,21,23,72
3/22/2016,30,0,24,27,81
3/23/2016,18,0,17,19,54
3/24/2016,22,0,20,20,62
3/25/2016,16,0,14,29,59
3/26/2016,18,0,27,14,59
3/27/2016,20,0,17,33,70
3/28/2016,21,0,23,14,58
3/29/2016,20,0,23,25,68
3/30/2016,17,0,18,35,70
3/31/2016,16,0,21,23,60
4/1/2016,20,0,17,12,49
4/2/2016,24,0,12,15,51
4/3/2016,21,0,26,23,70
4/4/2016,29,0,10,20,59
4/5/2016,31,0,18,16,65
4/6/2016,16,0,15,24,55
4/7/2016,18,0,20,19,57
4/8/2016,25,0,21,21,67
4/9/2016,22,0,24,28,74
4/10/2016,24,0,31,7,62
4/11/2016,32,0,21,17,70
4/12/2016,21,0,21,20,62
4/13/2016,26,0,19,37,82
4/14/2016,21,0,25,11,57
4/15/2016,12,0,14,28,54
4/16/2016,14,0,17,36,67
4/17/2016,19,0,19,22,60
4/18/2016,24,0,25,6,55
4/19/2016,25,0,13,27,65
4/20/2016,23,0,26,18,67
4/21/2016,25,0,15,21,61
4/22/2016,20,0,17,20,57
4/23/2016,21,0,19,17,57
4/24/2016,26,0,14,19,59
4/25/2016,31,0,20,24,75
4/26/2016,20,0,23,15,58
4/27/2016,24,0,15,25,64
4/28/2016,30,0,12,14,56
4/29/2016,25,0,27,11,63
4/30/2016,22,0,17,12,51
5/1/2016,31,0,27,22,80
5/2/2016,22,0,9,25,56
5/3/2016,23,0,17,21,61
5/4/2016,28,0,15,29,72
5/5/2016,19,0,25,25,69
5/6/2016,22,0,11,33,66
5/7/2016,27,0,12,28,67
5/8/2016,23,0,17,25,65
5/9/2016,28,0,15,18,61
5/10/2016,25,0,11,22,58
5/11/2016,23,0,27,29,79
5/12/2016,23,0,28,20,71
5/13/2016,24,0,18,26,68
5/14/2016,14,0,26,32,72
5/15/2016,23,0,15,26,64
5/16/2016,13,0,12,20,45
5/17/2016,25,0,19,10,54
5/18/2016,21,0,22,13,56
5/19/2016,17,0,25,21,63
5/20/2016,19,0,20,24,63
5/21/2016,19,0,17,15,51
5/22/2016,21,0,22,24,67
5/23/2016,19,0,19,20,58
5/24/2016,25,0,25,26,76
5/25/2016,21,0,15,18,54
5/26/2016,21,0,11,29,61
5/27/2016,25,0,13,21,59
5/28/2016,18,0,27,24,69
5/29/2016,27,0,23,33,83
5/30/2016,19,0,29,24,72
5/31/2016,27,0,13,29,69
6/1/2016,24,0,17,29,70
6/2/2016,32,0,20,22,74
6/3/2016,19,0,25,13,57
6/4/2016,22,0,13,28,63
6/5/2016,32,0,19,10,61
6/6/2016,21,0,12,27,60
6/7/2016,19,0,21,31,71
6/8/2016,19,0,20,6,45
6/9/2016,14,0,22,32,68
6/10/2016,31,0,14,24,69
6/11/2016,25,0,23,28,76
6/12/2016,12,0,17,14,43
6/13/2016,27,0,21,21,69
6/14/2016,29,0,26,9,64
6/15/2016,24,0,14,18,56
6/16/2016,11,0,16,10,37
6/17/2016,19,0,23,15,57
6/18/2016,19,0,21,11,51
6/19/2016,17,0,25,28,70
6/20/2016,14,0,12,21,47
6/21/2016,24,0,27,25,76
6/22/2016,29,0,25,15,69
6/23/2016,21,0,28,32,81
6/24/2016,25,0,25,21,71
6/25/2016,18,0,25,9,52
6/26/2016,27,0,18,28,73
6/27/2016,26,0,27,18,71
6/28/2016,26,0,23,22,71
6/29/2016,23,0,12,11,46
6/30/2016,24,0,19,1,44
7/1/2016,22,0,24,17,63
7/2/2016,23,0,11,21,55
7/3/2016,30,0,19,20,69
7/4/2016,21,0,16,21,58
7/5/2016,21,0,18,18,57
7/6/2016,27,0,21,21,69
7/7/2016,26,0,27,17,70
7/8/2016,19,0,24,18,61
7/9/2016,18,0,13,21,52
7/10/2016,32,0,23,12,67
7/11/2016,29,0,21,15,65
7/12/2016,33,0,29,9,71
7/13/2016,15,0,29,25,69
7/14/2016,19,0,16,6,41
7/15/2016,24,0,25,19,68
7/16/2016,20,0,19,16,55
7/17/2016,23,0,16,22,61
7/18/2016,25,0,16,18,59
7/19/2016,21,0,28,22,71
7/20/2016,28,0,24,33,85
7/21/2016,34,0,28,25,87
7/22/2016,21,0,32,23,76
7/23/2016,28,0,22,16,66
7/24/2016,30,0,12,21,63
7/25/2016,30,0,8,22,60
7/26/2016,18,0,24,28,70
7/27/2016,32,0,22,19,73
7/28/2016,35,0,24,31,90
7/29/2016,20,0,16,10,46
7/30/2016,33,0,28,20,81
7/31/2016,29,0,25,28,82
8/1/2016,23,0,22,24,69
8/2/2016,25,0,21,33,79
8/3/2016,21,0,27,23,71
8/4/2016,18,0,20,31,69
8/5/2016,25,0,20,15,60
8/6/2016,32,0,31,21,84
8/7/2016,18,0,17,33,68
8/8/2016,22,0,19,20,61
8/9/2016,26,0,18,11,55
8/10/2016,22,0,28,20,70
8/11/2016,17,0,13,27,57
8/12/2016,23,0,16,8,47
8/13/2016,22,0,24,21,67
8/14/2016,18,0,14,17,49
8/15/2016,25,0,19,11,55
8/16/2016,15,0,18,40,73
8/17/2016,22,0,17,23,62
8/18/2016,14,0,18,24,56
8/19/2016,21,0,22,19,62
8/20/2016,19,0,16,6,41
8/21/2016,24,0,23,10,57
8/22/2016,25,0,25,13,63
8/23/2016,28,0,25,21,74
8/24/2016,24,0,15,20,59
8/25/2016,27,0,22,18,67
8/26/2016,27,0,19,15,61
8/27/2016,28,0,25,33,86
8/28/2016,20,0,32,25,77
8/29/2016,26,0,10,27,63
8/30/2016,25,0,8,7,40
8/31/2016,32,0,18,17,67
9/1/2016,28,0,32,26,86
9/2/2016,18,0,19,10,47
9/3/2016,20,0,29,11,60
9/4/2016,28,0,18,29,75
9/5/2016,28,0,22,20,70
9/6/2016,20,0,12,30,62
9/7/2016,26,0,15,20,61
9/8/2016,14,0,14,26,54
9/9/2016,20,0,17,20,57
9/10/2016,16,0,28,14,58
9/11/2016,25,0,16,17,58
9/12/2016,31,0,20,17,68
9/13/2016,25,0,21,10,56
9/14/2016,35,0,14,27,76
9/15/2016,22,0,21,16,59
9/16/2016,18,0,21,6,45
9/17/2016,29,0,20,21,70
9/18/2016,20,0,27,30,77
9/19/2016,21,0,13,11,45
9/20/2016,26,0,14,17,57
9/21/2016,30,0,16,16,62
9/22/2016,21,0,19,24,64
9/23/2016,31,0,22,21,74
9/24/2016,22,0,28,10,60
9/25/2016,26,0,15,20,61
9/26/2016,19,0,25,20,64
9/27/2016,27,0,25,20,72
9/28/2016,26,0,27,12,65
9/29/2016,29,0,24,21,74
9/30/2016,22,0,10,33,65
10/1/2016,29,0,24,22,75
10/2/2016,26,0,20,18,64
10/3/2016,22,0,12,17,51
10/4/2016,28,0,16,28,72
10/5/2016,27,0,17,12,56
10/6/2016,27,0,22,32,81
10/7/2016,20,0,26,22,68
10/8/2016,23,0,14,13,50
10/9/2016,17,0,19,17,53
10/10/2016,23,0,31,18,72
10/11/2016,27,0,22,24,73
10/12/2016,22,0,13,22,57
10/13/2016,17,0,12,17,46
10/14/2016,31,0,16,12,59
10/15/2016,19,0,16,31,66
10/16/2016,19,0,25,15,59
10/17/2016,33,0,28,22,83
10/18/2016,21,0,26,24,71
10/19/2016,23,0,18,16,57
10/20/2016,25,0,16,25,66
10/21/2016,26,0,20,19,65
10/22/2016,22,0,26,22,70
10/23/2016,25,0,26,30,81
10/24/2016,27,0,19,11,57
10/25/2016,13,0,25,25,63
10/26/2016,20,0,14,26,60
10/27/2016,21,0,21,18,60
10/28/2016,23,0,20,23,66
10/29/2016,26,0,13,19,58
10/30/2016,25,0,18,16,59
10/31/2016,26,0,28,16,70
11/1/2016,12,0,18,13,43
11/2/2016,28,0,20,16,64
11/3/2016,15,0,21,6,42
11/4/2016,17,0,20,12,49
11/5/2016,26,0,14,23,63
11/6/2016,30,0,30,31,91
11/7/2016,28,0,23,26,77
11/8/2016,21,0,26,8,55
11/9/2016,28,0,25,26,79
11/10/2016,24,0,25,13,62
11/11/2016,16,0,22,29,67
11/12/2016,18,0,25,25,68
11/13/2016,22,0,22,18,62
11/14/2016,24,0,22,28,74
11/15/2016,17,0,13,16,46
11/16/2016,26,0,20,15,61
11/17/2016,21,0,20,15,56
11/18/2016,34,0,30,13,77
11/19/2016,21,0,25,32,78
11/20/2016,25,0,23,10,58
11/21/2016,22,0,18,14,54
11/22/2016,26,0,19,20,65
11/23/2016,23,0,13,16,52
11/24/2016,19,0,18,20,57
11/25/2016,25,0,19,22,66
11/26/2016,18,0,11,24,53
11/27/2016,22,0,16,18,56
11/28/2016,23,0,30,24,77
11/29/2016,21,0,21,23,65
11/30/2016,28,0,13,19,60
12/1/2016,23,0,20,19,62
12/2/2016,25,0,23,17,65
12/3/2016,22,0,22,16,60
12/4/2016,23,0,23,24,70
12/5/2016,23,0,9,25,57
12/6/2016,22,0,25,15,62
12/7/2016,13,0,24,13,50
12/8/2016,29,0,19,18,66
12/9/2016,26,0,26,14,66
12/10/2016,23,0,15,26,64
12/11/2016,23,0,18,13,54
12/12/2016,25,0,9,5,39
12/13/2016,22,0,28,19,69
12/14/2016,19,0,30,18,67
12/15/2016,27,0,24,13,64
12/16/2016,27,0,25,18,70
12/17/2016,16,0,19,12,47
12/18/2016,29,0,16,23,68
12/19/2016,26,0,25,28,79
12/20/2016,21,0,27,15,63
12/21/2016,22,0,13,25,60
12/22/2016,22,0,25,16,63
12/23/2016,20,0,13,21,54
12/24/2016,30,0,28,10,68
12/25/2016,22,0,16,21,59
12/26/2016,18,0,20,27,65
12/27/2016,18,0,28,25,71
12/28/2016,18,0,10,18,46
12/29/2016,25,0,23,17,65
12/30/2016,21,0,13,30,64
12/31/2016,29,0,17,9,55
1/1/2017,21,0,19,12,52
1/2/2017,21,0,18,24,63
1/3/2017,14,0,24,28,66
1/4/2017,19,0,26,23,68
1/5/2017,24,0,23,18,65
1/6/2017,19,0,15,22,56
1/7/2017,25,0,21,15,61
1/8/2017,20,0,20,15,55
1/9/2017,24,0,19,28,71
1/10/2017,17,0,27,25,69
1/11/2017,30,0,17,15,62
1/12/2017,29,0,26,32,87
1/13/2017,28,0,16,32,76
1/14/2017,19,0,13,17,49
1/15/2017,23,0,20,23,66
1/16/2017,13,0,16,25,54
1/17/2017,12,0,21,22,55
1/18/2017,20,0,23,26,69
1/19/2017,27,0,26,19,72
1/20/2017,19,0,15,17,51
1/21/2017,23,0,13,9,45
1/22/2017,21,0,26,24,71
1/23/2017,20,0,22,21,63
1/24/2017,24,0,24,16,64
1/25/2017,17,0,21,12,50
1/26/2017,32,0,23,22,77
1/27/2017,23,0,24,23,70
1/28/2017,28,0,11,25,64
1/29/2017,26,0,8,23,57
1/30/2017,24,0,26,14,64
1/31/2017,29,0,17,23,69
2/1/2017,20,0,27,31,78
2/2/2017,17,0,18,8,43
2/3/2017,29,0,31,22,82
2/4/2017,22,0,13,26,61
2/5/2017,17,0,21,23,61
2/6/2017,36,0,26,10,72
2/7/2017,26,0,22,30,78
2/8/2017,31,0,16,26,73
2/9/2017,29,0,25,31,85
2/10/2017,16,0,21,29,66
2/11/2017,25,0,19,33,77
2/12/2017,30,0,22,13,65
2/13/2017,23,0,14,24,61
2/14/2017,25,0,20,14,59
2/15/2017,20,0,14,18,52
2/16/2017,27,0,19,11,57
2/17/2017,14,0,17,20,51
2/18/2017,20,0,15,17,52
2/19/2017,27,0,17,23,67
2/20/2017,24,0,22,23,69
2/21/2017,23,0,12,14,49
2/22/2017,25,0,21,11,57
2/23/2017,21,0,23,31,75
2/24/2017,27,0,25,16,68
2/25/2017,22,0,14,16,52
2/26/2017,26,0,21,17,64
2/27/2017,20,0,16,36,72
2/28/2017,24,0,13,31,68
3/1/2017,24,0,22,15,61
3/2/2017,20,0,22,21,63
3/3/2017,27,0,28,17,72
3/4/2017,16,0,27,27,70
3/5/2017,23,0,29,25,77
3/6/2017,24,0,19,19,62
3/7/2017,14,0,10,28,52
3/8/2017,28,0,19,29,76
3/9/2017,24,0,24,21,69
3/10/2017,24,0,17,36,77
3/11/2017,17,0,22,18,57
3/12/2017,16,0,28,17,61
3/13/2017,17,0,20,26,63
3/14/2017,20,0,19,19,58
3/15/2017,23,0,20,12,55
3/16/2017,25,0,30,15,70
3/17/2017,22,0,29,14,65
3/18/2017,18,0,25,30,73
3/19/2017,21,0,8,26,55
3/20/2017,21,0,16,30,67
3/21/2017,19,0,27,19,65
3/22/2017,14,0,32,21,67
3/23/2017,23,0,26,16,65
3/24/2017,26,0,26,7,59
3/25/2017,11,0,12,10,33
3/26/2017,23,0,22,13,58
3/27/2017,17,0,23,9,49
3/28/2017,28,0,25,13,66
3/29/2017,32,0,22,9,63
3/30/2017,18,0,15,15,48
3/31/2017,20,0,26,19,65
4/1/2017,24,0,24,32,80
4/2/2017,28,0,12,31,71
4/3/2017,14,0,23,19,56
4/4/2017,28,0,25,28,81
4/5/2017,26,0,26,5,57
4/6/2017,21,0,26,19,66
4/7/2017,21,0,27,18,66
4/8/2017,30,0,12,21,63
4/9/2017,23,0,24,22,69
4/10/2017,17,0,29,23,69
4/11/2017,30,0,15,29,74
4/12/2017,23,0,21,25,69
4/13/2017,32,0,31,26,89
4/14/2017,22,0,21,14,57
4/15/2017,31,0,18,33,82
4/16/2017,29,0,11,14,54
4/17/2017,21,0,29,9,59
4/18/2017,16,0,22,32,70
4/19/2017,31,0,11,24,66
4/20/2017,29,0,18,10,57
4/21/2017,23,0,15,26,64
4/22/2017,30,0,25,31,86
4/23/2017,25,0,30,40,95
4/24/2017,21,0,12,28,61
4/25/2017,23,0,10,13,46
4/26/2017,23,0,20,20,63
4/27/2017,19,0,21,15,55
4/28/2017,17,0,21,14,52
4/29/2017,30,0,28,15,73
4/30/2017,26,0,17,20,63
5/1/2017,28,0,29,29,86
5/2/2017,20,0,10,28,58
5/3/2017,27,0,34,15,76
5/4/2017,17,0,26,26,69
5/5/2017,28,0,7,17,52
5/6/2017,21,0,14,31,66
5/7/2017,23,0,18,22,63
5/8/2017,20,0,20,23,63
5/9/2017,21,0,31,24,76
5/10/2017,33,0,24,18,75
5/11/2017,29,0,23,20,72
5/12/2017,31,0,18,24,73
5/13/2017,27,0,26,19,72
5/14/2017,29,0,18,22,69
5/15/2017,33,0,23,29,85
5/16/2017,24,0,31,16,71
5/17/2017,24,0,27,13,64
5/18/2017,24,0,21,18,63
5/19/2017,20,0,26,29,75
5/20/2017,20,0,25,22,67
5/21/2017,26,0,17,31,74
5/22/2017,18,0,24,25,67
5/23/2017,14,0,19,12,45
5/24/2017,22,0,23,9,54
5/25/2017,25,0,31,19,75
5/26/2017,31,0,14,20,65
5/27/2017,28,0,19,21,68
5/28/2017,22,0,12,11,45
5/29/2017,26,0,30,7,63
5/30/2017,17,0,28,17,62
5/31/2017,28,0,13,25,66
6/1/2017,27,0,11,25,63
6/2/2017,22,0,20,28,70
6/3/2017,15,0,17,28,60
6/4/2017,26,0,19,24,69
6/5/2017,21,0,16,21,58
6/6/2017,22,0,16,28,66
6/7/2017,16,0,15,21,52
6/8/2017,26,0,15,16,57
6/9/2017,23,0,18,21,62
6/10/2017,29,0,9,14,52
6/11/2017,15,0,26,21,62
6/12/2017,23,0,27,12,62
6/13/2017,24,0,17,33,74
6/14/2017,22,0,25,17,64
6/15/2017,28,0,21,36,85
6/16/2017,24,0,24,7,55
6/17/2017,18,0,22,17,57
6/18/2017,17,0,17,30,64
6/19/2017,21,0,16,13,50
6/20/2017,26,0,18,34,78
6/21/2017,27,0,15,24,66
6/22/2017,14,0,24,34,72
6/23/2017,21,0,13,25,59
6/24/2017,27,0,20,32,79
6/25/2017,30,0,17,24,71
6/26/2017,22,0,18,20,60
6/27/2017,23,0,20,16,59
6/28/2017,18,0,14,16,48
6/29/2017,27,0,21,25,73
6/30/2017,22,0,20,2,44
7/1/2017,19,0,21,13,53
7/2/2017,20,0,12,11,43
7/3/2017,19,0,20,27,66
7/4/2017,24,0,15,7,46
7/5/2017,24,0,16,17,57
7/6/2017,20,0,15,9,44
7/7/2017,20,0,17,34,71
7/8/2017,19,0,16,20,55
7/9/2017,24,0,17,15,56
7/10/2017,21,0,21,28,70
7/11/2017,28,0,15,28,71
7/12/2017,27,0,28,9,64
7/13/2017,31,0,17,18,66
7/14/2017,21,0,20,34,75
7/15/2017,18,0,30,24,72
7/16/2017,23,0,20,11,54
7/17/2017,24,0,27,27,78
7/18/2017,30,0,22,19,71
7/19/2017,28,0,12,12,52
7/20/2017,21,0,24,24,69
7/21/2017,18,0,19,27,64
7/22/2017,22,0,19,29,70
7/23/2017,29,0,26,32,87
7/24/2017,15,0,24,19,58
7/25/2017,23,0,27,15,65
7/26/2017,23,0,19,22,64
7/27/2017,18,0,22,21,61
7/28/2017,30,0,16,36,82
7/29/2017,31,0,14,11,56
7/30/2017,27,0,22,15,64
7/31/2017,17,0,25,15,57
8/1/2017,25,0,23,23,71
8/2/2017,23,0,10,33,66
8/3/2017,20,0,25,17,62
8/4/2017,20,0,24,7,51
8/5/2017,22,0,12,29,63
8/6/2017,28,0,13,16,57
8/7/2017,18,0,26,26,70
8/8/2017,29,0,20,14,63
8/9/2017,15,0,11,26,52
8/10/2017,28,0,27,28,83
8/11/2017,21,0,18,13,52
8/12/2017,32,0,25,23,80
8/13/2017,28,0,23,29,80
8/14/2017,15,0,14,10,39
8/15/2017,27,0,15,31,73
8/16/2017,33,0,14,23,70
8/17/2017,27,0,17,18,62
8/18/2017,30,0,21,14,65
8/19/2017,20,0,15,7,42
8/20/2017,20,0,21,13,54
8/21/2017,19,0,15,24,58
8/22/2017,29,0,26,25,80
8/23/2017,29,0,24,17,70
8/24/2017,31,0,22,16,69
8/25/2017,27,0,30,29,86
8/26/2017,19,0,31,24,74
8/27/2017,18,0,25,11,54
8/28/2017,26,0,19,27,72
8/29/2017,24,0,24,17,65
8/30/2017,23,0,8,36,67
8/31/2017,26,0,26,16,68
9/1/2017,19,0,20,27,66
9/2/2017,30,0,26,19,75
9/3/2017,30,0,9,27,66
9/4/2017,23,0,20,24,67
9/5/2017,28,0,15,14,57
9/6/2017,31,0,18,24,73
9/7/2017,30,0,18,14,62
9/8/2017,28,0,27,28,83
9/9/2017,29,0,20,15,64
9/10/2017,23,0,16,21,60
9/11/2017,19,0,25,17,61
9/12/2017,22,0,26,19,67
9/13/2017,19,0,15,24,58
9/14/2017,21,0,20,19,60
9/15/2017,27,0,20,19,66
9/16/2017,17,0,32,18,67
9/17/2017,23,0,16,26,65
9/18/2017,24,0,18,18,60
9/19/2017,25,0,21,19,65
9/20/2017,30,0,24,14,68
9/21/2017,23,0,14,24,61
9/22/2017,15,0,16,32,63
9/23/2017,19,0,25,27,71
9/24/2017,25,0,18,18,61
9/25/2017,20,0,14,3,37
9/26/2017,25,0,17,27,69
9/27/2017,21,0,25,27,73
9/28/2017,24,0,29,13,66
9/29/2017,25,0,15,30,70
9/30/2017,21,0,17,31,69
10/1/2017,27,0,29,26,82
10/2/2017,19,0,14,7,40
10/3/2017,21,0,24,28,73
10/4/2017,21,0,13,17,51
10/5/2017,30,0,20,12,62
10/6/2017,33,0,21,10,64
10/7/2017,25,0,25,10,60
10/8/2017,30,0,13,18,61
10/9/2017,25,0,25,35,85
10/10/2017,23,0,17,23,63
10/11/2017,20,0,29,28,77
10/12/2017,26,0,20,22,68
10/13/2017,14,0,10,29,53
10/14/2017,26,0,24,26,76
10/15/2017,18,0,23,5,46
10/16/2017,16,0,20,17,53
10/17/2017,20,0,24,27,71
10/18/2017,11,0,20,19,50
10/19/2017,31,0,19,15,65
10/20/2017,20,0,32,30,82
10/21/2017,25,0,18,22,65
10/22/2017,23,0,10,17,50
10/23/2017,30,0,27,23,80
10/24/2017,23,0,26,26,75
10/25/2017,30,0,21,25,76
10/26/2017,17,0,24,26,67
10/27/2017,18,0,25,8,51
10/28/2017,26,0,16,30,72
10/29/2017,16,0,14,29,59
10/30/2017,27,0,13,21,61
10/31/2017,25,0,22,29,76
11/1/2017,28,0,15,7,50
11/2/2017,23,0,27,7,57
11/3/2017,19,0,20,21,60
11/4/2017,22,0,19,25,66
11/5/2017,23,0,18,25,66
11/6/2017,21,0,20,20,61
11/7/2017,32,0,21,14,67
11/8/2017,21,0,15,16,52
11/9/2017,25,0,16,23,64
11/10/2017,29,0,22,17,68
11/11/2017,19,0,24,31,74
11/12/2017,21,0,21,23,65
11/13/2017,24,0,20,31,75
11/14/2017,27,0,16,5,48
11/15/2017,21,0,20,27,68
11/16/2017,15,0,25,11,51
11/17/2017,23,0,21,19,63
11/18/2017,20,0,14,10,44
11/19/2017,18,0,26,25,69
11/20/2017,23,0,17,20,60
11/21/2017,24,0,30,24,78
11/22/2017,28,0,18,20,66
11/23/2017,23,0,21,7,51
11/24/2017,12,0,15,21,48
11/25/2017,21,0,15,2,38
11/26/2017,14,0,11,25,50
11/27/2017,21,0,13,26,60
11/28/2017,27,0,32,19,78
11/29/2017,20,0,25,15,60
11/30/2017,23,0,22,6,51
12/1/2017,19,0,17,19,55
12/2/2017,21,0,21,14,56
12/3/2017,23,0,13,19,55
12/4/2017,31,0,19,16,66
12/5/2017,19,0,20,17,56
12/6/2017,19,0,11,16,46
12/7/2017,17,0,24,9,50
12/8/2017,19,0,15,14,48
12/9/2017,22,0,23,28,73
12/10/2017,27,0,27,13,67
12/11/2017,25,0,22,14,61
12/12/2017,24,0,17,25,66
12/13/2017,20,0,29,18,67
12/14/2017,19,0,33,23,75
12/15/2017,23,0,23,28,74
12/16/2017,26,0,18,19,63
12/17/2017,15,0,16,4,35
12/18/2017,26,0,24,10,60
12/19/2017,23,0,15,8,46
12/20/2017,30,0,19,33,82
12/21/2017,33,0,10,23,66
12/22/2017,19,0,13,30,62
12/23/2017,22,0,28,28,78
12/24/2017,15,0,29,28,72
12/25/2017,24,0,16,9,49
12/26/2017,31,0,23,16,70
12/27/2017,25,0,24,14,63
12/28/2017,20,0,30,23,73
12/29/2017,17,0,23,13,53
12/30/2017,22,0,16,17,55
12/31/2017,24,0,19,24,67
1/1/2018,29,0,17,36,82
1/2/2018,28,0,27,20,75
1/3/2018,23,0,13,6,42
1/4/2018,21,0,20,17,58
1/5/2018,22,0,27,10,59
1/6/2018,14,0,21,19,54
1/7/2018,22,0,22,12,56
1/8/2018,19,0,19,15,53
1/9/2018,24,0,22,33,79
1/10/2018,30,0,15,13,58
1/11/2018,21,0,22,14,57
1/12/2018,19,0,12,19,50
1/13/2018,22,0,20,7,49
1/14/2018,26,0,16,14,56
1/15/2018,27,0,25,6,58
1/16/2018,32,0,28,21,81
1/17/2018,23,0,17,9,49
1/18/2018,21,0,28,16,65
1/19/2018,24,0,25,19,68
1/20/2018,27,0,25,12,64
1/21/2018,31,0,16,22,69
1/22/2018,27,0,25,19,71
1/23/2018,20,0,15,27,62
1/24/2018,25,0,15,23,63
1/25/2018,18,0,15,16,49
1/26/2018,24,0,22,25,71
1/27/2018,13,0,24,20,57
1/28/2018,20,0,7,29,56
1/29/2018,18,0,18,18,54
1/30/2018,30,0,16,31,77
1/31/2018,16,0,19,23,58
2/1/2018,19,0,26,34,79
2/2/2018,19,0,11,5,35
2/3/2018,29,0,12,32,73
2/4/2018,24,0,18,17,59
2/5/2018,27,0,25,24,76
2/6/2018,21,0,26,26,73
2/7/2018,23,0,12,22,57
2/8/2018,19,0,23,26,68
2/9/2018,17,0,19,21,57
2/10/2018,20,0,17,24,61
2/11/2018,30,0,10,2,42
2/12/2018,26,0,26,15,67
2/13/2018,31,0,17,20,68
2/14/2018,27,0,22,25,74
2/15/2018,34,0,17,24,75
2/16/2018,30,0,21,12,63
2/17/2018,20,0,24,20,64
2/18/2018,21,0,17,29,67
2/19/2018,25,0,23,25,73
2/20/2018,23,0,12,11,46
2/21/2018,24,0,11,29,64
2/22/2018,14,0,8,17,39
2/23/2018,23,0,24,24,71
2/24/2018,24,0,16,16,56
2/25/2018,25,0,21,10,56
2/26/2018,23,0,14,6,43
2/27/2018,10,0,18,17,45
2/28/2018,16,0,23,13,52
3/1/2018,18,0,18,15,51
3/2/2018,20,0,12,24,56
3/3/2018,15,0,32,21,68
3/4/2018,26,0,23,18,67
3/5/2018,22,0,18,17,57
3/6/2018,30,0,18,27,75
3/7/2018,26,0,25,5,56
3/8/2018,25,0,17,17,59
3/9/2018,21,0,18,17,56
3/10/2018,22,0,20,23,65
3/11/2018,25,0,21,20,66
3/12/2018,16,0,13,26,55
3/13/2018,22,0,20,31,73
3/14/2018,13,0,21,27,61
3/15/2018,24,0,28,33,85
3/16/2018,24,0,24,13,61
3/17/2018,27,0,26,20,73
3/18/2018,26,0,10,17,53
3/19/2018,23,0,32,23,78
3/20/2018,18,0,18,19,55
3/21/2018,31,0,13,21,65
3/22/2018,15,0,13,25,53
3/23/2018,20,0,11,16,47
3/24/2018,27,0,21,26,74
3/25/2018,29,0,22,31,82
3/26/2018,25,0,17,16,58
3/27/2018,23,0,15,30,68
3/28/2018,26,0,18,17,61
3/29/2018,24,0,16,15,55
3/30/2018,21,0,22,22,65
3/31/2018,20,0,24,12,56
4/1/2018,25,0,29,22,76
4/2/2018,15,0,18,26,59
4/3/2018,26,0,16,27,69
4/4/2018,27,0,12,33,72
4/5/2018,23,0,16,30,69
4/6/2018,22,0,15,28,65
4/7/2018,28,0,22,15,65
4/8/2018,22,0,30,30,82
4/9/2018,32,0,23,15,70
4/10/2018,24,0,28,13,65
4/11/2018,23,0,15,25,63
4/12/2018,20,0,19,32,71
4/13/2018,26,0,27,16,69
4/14/2018,21,0,22,17,60
4/15/2018,28,0,30,18,76
4/16/2018,14,0,7,16,37
4/17/2018,21,0,18,18,57
4/18/2018,31,0,27,28,86
4/19/2018,14,0,23,30,67
4/20/2018,26,0,25,23,74
4/21/2018,15,0,24,17,56
4/22/2018,26,0,25,10,61
4/23/2018,23,0,23,26,72
4/24/2018,33,0,22,22,77
4/25/2018,22,0,18,12,52
4/26/2018,19,0,28,34,81
4/27/2018,19,0,20,22,61
4/28/2018,20,0,19,21,60
4/29/2018,17,0,29,30,76
4/30/2018,19,0,18,16,53
5/1/2018,26,0,20,18,64
5/2/2018,19,0,23,28,70
5/3/2018,26,0,26,15,67
5/4/2018,24,0,16,32,72
5/5/2018,22,0,17,27,66
5/6/2018,23,0,23,15,61
5/7/2018,19,0,31,6,56
5/8/2018,21,0,12,30,63
5/9/2018,21,0,18,23,62
5/10/2018,27,0,27,23,77
5/11/2018,27,0,21,24,72
5/12/2018,10,0,18,18,46
5/13/2018,24,0,21,31,76
5/14/2018,31,0,30,18,79
5/15/2018,20,0,19,19,58
5/16/2018,13,0,27,30,70
5/17/2018,28,0,23,21,72
5/18/2018,25,0,19,12,56
5/19/2018,27,0,25,10,62
5/20/2018,22,0,22,21,65
5/21/2018,31,0,30,19,80
5/22/2018,21,0,26,23,70
5/23/2018,16,0,14,23,53
5/24/2018,17,0,19,21,57
5/25/2018,25,0,16,31,72
5/26/2018,28,0,17,29,74
5/27/2018,22,0,11,27,60
5/28/2018,21,0,27,8,56
5/29/2018,23,0,24,18,65
5/30/2018,28,0,12,16,56
5/31/2018,20,0,21,21,62
6/1/2018,21,0,22,26,69
6/2/2018,21,0,16,26,63
6/3/2018,25,0,25,23,73
6/4/2018,19,0,18,19,56
6/5/2018,25,0,15,18,58
6/6/2018,25,0,20,9,54
6/7/2018,20,0,12,17,49
6/8/2018,31,0,22,25,78
6/9/2018,18,0,15,29,62
6/10/2018,20,0,13,34,67
6/11/2018,21,0,19,35,75
6/12/2018,20,0,14,15,49
6/13/2018,28,0,26,25,79
6/14/2018,27,0,23,16,66
6/15/2018,24,0,21,24,69
6/16/2018,22,0,21,9,52
6/17/2018,18,0,11,31,60
6/18/2018,30,0,18,21,69
6/19/2018,16,0,21,30,67
6/20/2018,30,0,23,20,73
6/21/2018,21,0,21,19,61
6/22/2018,33,0,25,27,85
6/23/2018,11,0,28,35,74
6/24/2018,28,0,18,15,61
6/25/2018,22,0,22,13,57
6/26/2018,29,0,27,26,82
6/27/2018,20,0,18,21,59
6/28/2018,11,0,18,20,49
6/29/2018,29,0,28,31,88
6/30/2018,14,0,12,19,45
7/1/2018,22,0,24,8,54
7/2/2018,20,0,19,22,61
7/3/2018,29,0,27,22,78
7/4/2018,31,0,23,20,74
7/5/2018,29,0,14,20,63
7/6/2018,18,0,17,19,54
7/7/2018,22,0,20,13,55
7/8/2018,25,0,25,19,69
7/9/2018,26,0,25,13,64
7/10/2018,17,0,22,29,68
7/11/2018,25,0,14,18,57
7/12/2018,16,0,21,26,63
7/13/2018,18,0,30,15,63
7/14/2018,25,0,24,28,77
7/15/2018,27,0,26,16,69
7/16/2018,23,0,13,24,60
7/17/2018,27,0,17,20,64
7/18/2018,19,0,18,13,50
7/19/2018,18,0,22,20,60
7/20/2018,24,0,20,31,75
7/21/2018,19,0,15,23,57
7/22/2018,18,0,10,36,64
7/23/2018,19,0,13,22,54
7/24/2018,27,0,24,34,85
7/25/2018,30,0,13,13,56
7/26/2018,20,0,24,20,64
7/27/2018,25,0,22,29,76
7/28/2018,22,0,24,7,53
7/29/2018,26,0,16,12,54
7/30/2018,18,0,29,30,77
7/31/2018,17,0,20,9,46
8/1/2018,17,0,9,22,48
8/2/2018,15,0,14,12,41
8/3/2018,17,0,19,6,42
8/4/2018,27,0,21,19,67
8/5/2018,27,0,21,9,57
8/6/2018,19,0,22,10,51
8/7/2018,20,0,13,28,61
8/8/2018,20,0,18,24,62
8/9/2018,27,0,23,14,64
8/10/2018,29,0,29,10,68
8/11/2018,30,0,20,31,81
8/12/2018,25,0,29,10,64
8/13/2018,17,0,23,6,46
8/14/2018,27,0,20,22,69
8/15/2018,32,0,27,13,72
8/16/2018,25,0,31,12,68
8/17/2018,18,0,14,34,66
8/18/2018,20,0,26,29,75
8/19/2018,25,0,7,11,43
8/20/2018,25,0,26,32,83
8/21/2018,25,0,8,22,55
8/22/2018,16,0,17,4,37
8/23/2018,27,0,10,24,61
8/24/2018,24,0,20,3,47
8/25/2018,21,0,28,29,78
8/26/2018,24,0,21,15,60
8/27/2018,31,0,17,15,63
8/28/2018,18,0,16,16,50
8/29/2018,22,0,20,17,59
8/30/2018,25,0,24,30,79
8/31/2018,16,0,13,26,55
9/1/2018,33,0,16,18,67
9/2/2018,21,0,27,10,58
9/3/2018,30,0,18,16,64
9/4/2018,21,0,24,18,63
9/5/2018,23,0,14,23,60
9/6/2018,21,0,18,23,62
9/7/2018,21,0,21,29,71
9/8/2018,19,0,25,9,53
9/9/2018,30,0,21,21,72
9/10/2018,18,0,23,19,60
9/11/2018,18,0,18,29,65
9/12/2018,16,0,20,24,60
9/13/2018,19,0,14,9,42
9/14/2018,31,0,14,25,70
9/15/2018,22,0,23,30,75
9/16/2018,26,0,13,14,53
9/17/2018,19,0,21,32,72
9/18/2018,23,0,13,10,46
9/19/2018,16,0,28,25,69
9/20/2018,22,0,20,17,59
9/21/2018,20,0,18,19,57
9/22/2018,16,0,15,15,46
9/23/2018,30,0,16,30,76
9/24/2018,24,0,26,33,83
9/25/2018,14,0,19,29,62
9/26/2018,15,0,24,10,49
9/27/2018,21,0,19,11,51
9/28/2018,28,0,12,17,57
9/29/2018,26,0,20,17,63
9/30/2018,21,0,22,28,71
10/1/2018,15,0,20,12,47
10/2/2018,26,0,16,7,49
10/3/2018,30,0,23,17,70
10/4/2018,25,0,18,20,63
10/5/2018,19,0,25,21,65
10/6/2018,27,0,16,14,57
10/7/2018,26,0,27,15,68
10/8/2018,25,0,22,23,70
10/9/2018,22,0,20,16,58
10/10/2018,26,0,18,14,58
10/11/2018,19,0,15,19,53
10/12/2018,33,0,18,20,71
10/13/2018,19,0,20,21,60
10/14/2018,35,0,15,21,71
10/15/2018,23,0,25,13,61
10/16/2018,15,0,11,16,42
10/17/2018,21,0,29,29,79
10/18/2018,24,0,15,20,59
10/19/2018,22,0,21,14,57
10/20/2018,20,0,20,17,57
10/21/2018,18,0,21,11,50
10/22/2018,26,0,20,19,65
10/23/2018,25,0,19,22,66
10/24/2018,14,0,26,33,73
10/25/2018,15,0,23,12,50
10/26/2018,25,0,25,21,71
10/27/2018,27,0,19,17,63
10/28/2018,19,0,26,25,70
10/29/2018,30,0,26,19,75
10/30/2018,27,0,13,28,68
10/31/2018,20,0,31,9,60
11/1/2018,29,0,16,25,70
11/2/2018,25,0,28,13,66
11/3/2018,18,0,22,27,67
11/4/2018,22,0,23,13,58
11/5/2018,22,0,17,12,51
11/6/2018,28,0,24,24,76
11/7/2018,25,0,18,5,48
11/8/2018,21,0,16,28,65
11/9/2018,23,0,16,21,60
11/10/2018,22,0,26,27,75
11/11/2018,28,0,14,33,75
11/12/2018,20,0,12,26,58
11/13/2018,16,0,17,17,50
11/14/2018,21,0,18,17,56
11/15/2018,25,0,22,29,76
11/16/2018,26,0,8,34,68
11/17/2018,25,0,18,10,53
11/18/2018,15,0,12,21,48
11/19/2018,18,0,26,24,68
11/20/2018,15,0,14,22,51
11/21/2018,26,0,21,15,62
11/22/2018,23,0,24,16,63
11/23/2018,28,0,7,23,58
11/24/2018,16,0,12,22,50
11/25/2018,21,0,27,26,74
11/26/2018,29,0,19,23,71
11/27/2018,15,0,26,23,64
11/28/2018,28,0,21,33,82
11/29/2018,23,0,10,19,52
11/30/2018,13,0,19,18,50
12/1/2018,24,0,10,26,60
12/2/2018,21,0,22,17,60
12/3/2018,26,0,18,21,65
12/4/2018,26,0,18,29,73
12/5/2018,20,0,22,16,58
12/6/2018,19,0,23,25,67
12/7/2018,32,0,18,16,66
12/8/2018,18,0,25,7,50
12/9/2018,26,0,27,26,79
12/10/2018,32,0,30,31,93
12/11/2018,19,0,20,25,64
12/12/2018,26,0,15,22,63
12/13/2018,29,0,17,30,76
12/14/2018,29,0,18,37,84
12/15/2018,32,0,23,17,72
12/16/2018,23,0,23,31,77
12/17/2018,28,0,19,25,72
12/18/2018,20,0,20,26,66
12/19/2018,23,0,27,23,73
12/20/2018,12,0,16,10,38
12/21/2018,15,0,10,19,44
12/22/2018,22,0,19,12,53
12/23/2018,25,0,28,15,68
12/24/2018,31,0,15,23,69
12/25/2018,23,0,12,17,52
12/26/2018,24,0,21,10,55
12/27/2018,27,0,24,23,74
12/28/2018,13,0,17,33,63
12/29/2018,13,0,13,25,51
12/30/2018,23,0,20,16,59
12/31/2018,17,0,21,19,57
1/1/2019,26,0,24,19,69
1/2/2019,29,0,24,21,74
1/3/2019,23,0,17,15,55
1/4/2019,20,0,18,11,49
1/5/2019,19,0,11,20,50
1/6/2019,24,0,20,19,63
1/7/2019,11,0,27,12,50
1/8/2019,22,0,25,6,53
1/9/2019,28,0,28,16,72
1/10/2019,17,0,18,15,50
1/11/2019,16,0,22,8,46
1/12/2019,22,0,14,29,65
1/13/2019,15,0,21,8,44
1/14/2019,28,0,21,19,68
1/15/2019,25,0,20,28,73
1/16/2019,28,0,21,12,61
1/17/2019,13,0,29,10,52
1/18/2019,25,0,16,3,44
1/19/2019,30,0,13,22,65
1/20/2019,26,0,20,22,68
1/21/2019,24,0,27,26,77
1/22/2019,28,0,21,16,65
1/23/2019,23,0,10,20,53
1/24/2019,31,0,21,16,68
1/25/2019,18,0,26,16,60
1/26/2019,25,0,25,10,60
1/27/2019,15,0,24,28,67
1/28/2019,16,0,21,16,53
1/29/2019,27,0,33,25,85
1/30/2019,25,0,15,16,56
1/31/2019,17,0,24,13,54
2/1/2019,26,0,27,16,69
2/2/2019,28,0,23,13,64
2/3/2019,27,0,26,17,70
2/4/2019,21,0,21,21,63
2/5/2019,26,0,17,24,67
2/6/2019,24,0,15,18,57
2/7/2019,23,0,26,15,64
2/8/2019,25,0,30,25,80
2/9/2019,20,0,21,36,77
2/10/2019,31,0,28,9,68
2/11/2019,29,0,13,31,73
2/12/2019,25,0,27,16,68
2/13/2019,28,0,18,21,67
2/14/2019,20,0,14,21,55
2/15/2019,21,0,19,29,69
2/16/2019,31,0,23,24,78
2/17/2019,20,0,31,13,64
2/18/2019,25,0,27,14,66
2/19/2019,23,0,17,21,61
2/20/2019,20,0,19,14,53
2/21/2019,25,0,17,26,68
2/22/2019,24,0,22,11,57
2/23/2019,20,0,19,22,61
2/24/2019,22,0,17,15,54
2/25/2019,27,0,25,14,66
2/26/2019,30,0,32,16,78
2/27/2019,25,0,15,15,55
2/28/2019,23,0,26,14,63
3/1/2019,22,0,16,14,52
3/2/2019,20,0,12,38,70
3/3/2019,18,0,30,15,63
3/4/2019,12,0,23,30,65
3/5/2019,20,0,20,32,72
3/6/2019,23,0,23,6,52
3/7/2019,30,0,20,21,71
3/8/2019,18,0,16,18,52
3/9/2019,28,0,18,6,52
3/10/2019,12,0,22,8,42
3/11/2019,21,0,12,32,65
3/12/2019,17,0,19,26,62
3/13/2019,23,0,26,26,75
3/14/2019,17,0,21,26,64
3/15/2019,18,0,13,23,54
3/16/2019,20,0,17,25,62
3/17/2019,15,0,23,18,56
3/18/2019,18,0,26,20,64
3/19/2019,20,0,18,26,64
3/20/2019,28,0,30,11,69
3/21/2019,18,0,25,22,65
3/22/2019,25,0,14,11,50
3/23/2019,16,0,29,6,51
3/24/2019,31,0,30,23,84
3/25/2019,17,0,22,15,54
3/26/2019,24,0,22,11,57
3/27/2019,21,0,25,20,66
3/28/2019,27,0,19,26,72
3/29/2019,16,0,25,18,59
3/30/2019,31,0,22,22,75
3/31/2019,18,0,22,35,75
4/1/2019,16,0,23,12,51
4/2/2019,24,0,25,13,62
4/3/2019,27,0,24,15,66
4/4/2019,15,0,16,22,53
4/5/2019,27,0,17,14,58
4/6/2019,17,0,18,15,50
4/7/2019,27,0,18,6,51
4/8/2019,17,0,20,10,47
4/9/2019,19,0,17,1,37
4/10/2019,18,0,22,20,60
4/11/2019,17,0,18,30,65
4/12/2019,19,0,30,37,86
4/13/2019,20,0,13,12,45
4/14/2019,17,0,23,26,66
4/15/2019,19,0,24,29,72
4/16/2019,17,0,8,2,27
4/17/2019,17,0,19,23,59
4/18/2019,17,0,26,16,59
4/19/2019,28,0,17,24,69
4/20/2019,18,0,20,24,62
4/21/2019,32,0,19,27,78
4/22/2019,22,0,17,28,67
4/23/2019,26,0,31,11,68
4/24/2019,30,0,23,30,83
4/25/2019,23,0,15,22,60
4/26/2019,26,0,28,14,68
4/27/2019,28,0,23,7,58
4/28/2019,13,0,21,20,54
4/29/2019,13,0,19,35,67
4/30/2019,20,0,7,16,43
5/1/2019,28,0,16,20,64
5/2/2019,15,0,26,29,70
5/3/2019,29,0,21,21,71
5/4/2019,29,0,25,16,70
5/5/2019,24,0,26,15,65
5/6/2019,23,0,22,24,69
5/7/2019,26,0,18,16,60
5/8/2019,22,0,21,24,67
5/9/2019,24,0,23,19,66
5/10/2019,24,0,20,23,67
5/11/2019,24,0,24,16,64
5/12/2019,18,0,25,26,69
5/13/2019,16,0,24,26,66
5/14/2019,24,0,21,24,69
5/15/2019,26,0,26,22,74
5/16/2019,18,0,24,25,67
5/17/2019,17,0,22,8,47
5/18/2019,28,0,17,21,66
5/19/2019,27,0,25,10,62
5/20/2019,13,0,10,16,39
5/21/2019,27,0,25,9,61
5/22/2019,23,0,15,25,63
5/23/2019,26,0,22,5,53
5/24/2019,23,0,24,13,60
5/25/2019,29,0,22,28,79
5/26/2019,24,0,11,26,61
5/27/2019,21,0,26,16,63
5/28/2019,21,0,19,14,54
5/29/2019,23,0,19,31,73
5/30/2019,20,0,22,23,65
5/31/2019,19,0,29,17,65
6/1/2019,18,0,15,30,63
6/2/2019,32,0,23,17,72
6/3/2019,21,0,27,13,61
6/4/2019,27,0,26,21,74
6/5/2019,17,0,13,24,54
6/6/2019,25,0,19,8,52
6/7/2019,24,0,27,13,64
6/8/2019,21,0,26,18,65
6/9/2019,19,0,22,17,58
6/10/2019,24,0,15,14,53
6/11/2019,25,0,22,18,65
6/12/2019,28,0,21,12,61
6/13/2019,14,0,13,27,54
6/14/2019,23,0,25,7,55
6/15/2019,26,0,14,12,52
6/16/2019,20,0,11,24,55
6/17/2019,33,0,21,4,58
6/18/2019,29,0,30,10,69
6/19/2019,26,0,22,13,61
6/20/2019,12,0,17,23,52
6/21/2019,29,0,31,18,78
6/22/2019,18,0,30,20,68
6/23/2019,24,0,26,26,76
6/24/2019,19,0,13,4,36
6/25/2019,27,0,23,24,74
6/26/2019,30,0,26,17,73
6/27/2019,22,0,18,19,59
6/28/2019,25,0,20,27,72
6/29/2019,22,0,24,12,58
6/30/2019,26,0,24,15,65
7/1/2019,18,0,16,18,52
7/2/2019,16,0,17,31,64
7/3/2019,22,0,31,20,73
7/4/2019,22,0,18,35,75
7/5/2019,24,0,8,21,53
7/6/2019,19,0,13,17,49
7/7/2019,26,0,13,19,58
7/8/2019,19,0,20,29,68
7/9/2019,27,0,15,31,73
7/10/2019,15,0,21,22,58
7/11/2019,27,0,24,25,76
7/12/2019,25,0,23,21,69
7/13/2019,21,0,21,17,59
7/14/2019,20,0,26,34,80
7/15/2019,25,0,14,23,62
7/16/2019,30,0,19,16,65
7/17/2019,21,0,26,29,76
7/18/2019,33,0,25,26,84
7/19/2019,25,0,27,24,76
7/20/2019,21,0,15,22,58
7/21/2019,12,0,19,14,45
7/22/2019,22,0,25,19,66
7/23/2019,16,0,19,15,50
7/24/2019,14,0,20,14,48
7/25/2019,12,0,24,14,50
7/26/2019,29,0,15,20,64
7/27/2019,22,0,17,14,53
7/28/2019,29,0,18,20,67
7/29/2019,19,0,24,20,63
7/30/2019,22,0,27,17,66
7/31/2019,15,0,23,21,59
8/1/2019,23,0,19,8,50
8/2/2019,30,0,24,24,78
8/3/2019,23,0,17,8,48
8/4/2019,29,0,18,36,83
8/5/2019,15,0,12,9,36
8/6/2019,17,0,21,19,57
8/7/2019,19,0,26,20,65
8/8/2019,31,0,20,31,82
8/9/2019,20,0,14,27,61
8/10/2019,15,0,18,19,52
8/11/2019,29,0,22,15,66
8/12/2019,19,0,29,11,59
8/13/2019,16,0,16,31,63
8/14/2019,26,0,26,36,88
8/15/2019,25,0,27,14,66
8/16/2019,15,0,18,16,49
8/17/2019,31,0,21,19,71
8/18/2019,17,0,30,18,65
8/19/2019,28,0,21,14,63
8/20/2019,24,0,28,15,67
8/21/2019,21,0,21,10,52
8/22/2019,29,0,11,9,49
8/23/2019,26,0,8,24,58
8/24/2019,22,0,19,27,68
8/25/2019,23,0,25,23,71
8/26/2019,20,0,20,9,49
8/27/2019,18,0,12,19,49
8/28/2019,24,0,21,27,72
8/29/2019,23,0,22,12,57
8/30/2019,26,0,14,24,64
8/31/2019,26,0,20,18,64
9/1/2019,30,0,17,12,59
9/2/2019,26,0,16,27,69
9/3/2019,21,0,13,25,59
9/4/2019,20,0,9,10,39
9/5/2019,27,0,13,4,44
9/6/2019,18,0,25,20,63
9/7/2019,28,0,27,22,77
9/8/2019,23,0,10,24,57
9/9/2019,25,0,22,12,59
9/10/2019,32,0,24,28,84
9/11/2019,27,0,28,14,69
9/12/2019,22,0,27,22,71
9/13/2019,28,0,18,12,58
9/14/2019,32,0,30,16,78
9/15/2019,24,0,20,19,63
9/16/2019,20,0,28,23,71
9/17/2019,14,0,29,33,76
9/18/2019,22,0,18,17,57
9/19/2019,15,0,12,19,46
9/20/2019,21,0,25,23,69
9/21/2019,21,0,20,11,52
9/22/2019,19,0,18,16,53
9/23/2019,25,0,29,16,70
9/24/2019,17,0,20,27,64
9/25/2019,17,0,12,9,38
9/26/2019,20,0,16,10,46
9/27/2019,18,0,18,14,50
9/28/2019,19,0,20,25,64
9/29/2019,21,0,28,13,62
9/30/2019,21,0,19,22,62
10/1/2019,30,0,32,16,78
10/2/2019,23,0,21,13,57
10/3/2019,25,0,10,19,54
10/4/2019,19,0,15,13,47
10/5/2019,24,0,20,22,66
10/6/2019,24,0,20,14,58
10/7/2019,24,0,16,28,68
10/8/2019,24,0,15,21,60
10/9/2019,31,0,16,30,77
10/10/2019,21,0,18,16,55
10/11/2019,12,0,22,24,58
10/12/2019,18,0,28,22,68
10/13/2019,20,0,19,10,49
10/14/2019,29,0,23,20,72
10/15/2019,27,0,16,30,73
10/16/2019,31,0,19,18,68
10/17/2019,34,0,16,24,74
10/18/2019,29,0,16,14,59
10/19/2019,29,0,27,31,87
10/20/2019,27,0,15,19,61
10/21/2019,21,0,22,23,66
10/22/2019,20,0,24,25,69
10/23/2019,29,0,30,23,82
10/24/2019,15,0,12,12,39
10/25/2019,20,0,21,15,56
10/26/2019,17,0,16,31,64
10/27/2019,23,0,23,25,71
10/28/2019,18,0,11,18,47
10/29/2019,20,0,18,27,65
10/30/2019,15,0,16,32,63
10/31/2019,19,0,23,25,67
11/1/2019,19,0,21,7,47
11/2/2019,15,0,19,34,68
11/3/2019,20,0,24,17,61
11/4/2019,21,0,25,7,53
11/5/2019,22,0,19,15,56
11/6/2019,13,0,15,20,48
11/7/2019,23,0,32,30,85
11/8/2019,18,0,30,20,68
11/9/2019,29,0,13,17,59
11/10/2019,34,0,15,23,72
11/11/2019,23,0,17,33,73
11/12/2019,20,0,15,28,63
11/13/2019,23,0,17,26,66
11/14/2019,19,0,30,10,59
11/15/2019,21,0,14,22,57
11/16/2019,15,0,21,12,48
11/17/2019,19,0,16,21,56
11/18/2019,25,0,24,25,74
11/19/2019,19,0,18,9,46
11/20/2019,14,0,24,20,58
11/21/2019,19,0,21,10,50
11/22/2019,33,0,20,17,70
11/23/2019,23,0,27,19,69
11/24/2019,25,0,9,20,54
11/25/2019,23,0,26,19,68
11/26/2019,27,0,20,11,58
11/27/2019,21,0,21,10,52
11/28/2019,29,0,8,15,52
11/29/2019,25,0,18,15,58
11/30/2019,13,0,26,25,64
12/1/2019,25,0,13,30,68
12/2/2019,26,0,15,21,62
12/3/2019,24,0,14,13,51
12/4/2019,28,0,25,36,89
12/5/2019,23,0,27,32,82
12/6/2019,20,0,15,6,41
12/7/2019,26,0,22,16,64
12/8/2019,29,0,21,17,67
12/9/2019,27,0,16,11,54
12/10/2019,23,0,11,10,44
12/11/2019,29,0,25,16,70
12/12/2019,17,0,18,35,70
12/13/2019,22,0,18,10,50
12/14/2019,20,0,26,20,66
12/15/2019,21,0,24,22,67
12/16/2019,20,0,30,22,72
12/17/2019,15,0,28,12,55
12/18/2019,25,0,22,31,78
12/19/2019,26,0,28,13,67
12/20/2019,25,0,25,17,67
12/21/2019,22,0,20,16,58
12/22/2019,26,0,11,5,42
12/23/2019,30,0,16,19,65
12/24/2019,26,0,23,21,70
12/25/2019,20,0,27,28,75
12/26/2019,22,0,32,18,72
12/27/2019,18,0,19,27,64
12/28/2019,16,0,21,14,51
12/29/2019,21,0,21,14,56
12/30/2019,27,0,23,33,83
12/31/2019,30,0,27,31,88
1/1/2020,18,0,18,8,44
1/2/2020,24,0,11,32,67
1/3/2020,22,0,27,27,76
1/4/2020,14,0,26,23,63
1/5/2020,16,0,13,13,42
1/6/2020,32,0,19,26,77
1/7/2020,29,0,24,36,89
1/8/2020,19,0,22,10,51
1/9/2020,25,0,23,15,63
1/10/2020,30,0,27,20,77
1/11/2020,25,0,26,18,69
1/12/2020,23,0,19,15,57
1/13/2020,17,0,21,26,64
1/14/2020,28,0,30,17,75
1/15/2020,17,0,26,16,59
1/16/2020,23,0,20,27,70
1/17/2020,23,0,21,23,67
1/18/2020,21,0,15,25,61
1/19/2020,17,0,18,17,52
1/20/2020,22,0,20,12,54
1/21/2020,23,0,12,12,47
1/22/2020,18,0,22,32,72
1/23/2020,31,0,28,12,71
1/24/2020,25,0,14,16,55
1/25/2020,19,0,18,23,60
1/26/2020,24,0,11,10,45
1/27/2020,16,0,16,18,50
1/28/2020,15,0,21,31,67
1/29/2020,14,0,14,23,51
1/30/2020,26,0,29,18,73
1/31/2020,26,0,26,28,80
2/1/2020,30,0,27,11,68
2/2/2020,21,0,13,21,55
2/3/2020,21,0,13,20,54
2/4/2020,25,0,24,28,77
2/5/2020,31,0,23,25,79
2/6/2020,22,0,26,13,61
2/7/2020,23,0,27,21,71
2/8/2020,17,0,16,30,63
2/9/2020,21,0,19,31,71
2/10/2020,22,0,16,33,71
2/11/2020,21,0,15,14,50
2/12/2020,35,0,27,14,76
2/13/2020,19,0,27,18,64
2/14/2020,25,0,19,22,66
2/15/2020,28,0,15,20,63
2/16/2020,16,0,26,12,54
2/17/2020,31,0,20,22,73
2/18/2020,27,0,23,26,76
2/19/2020,17,0,14,29,60
2/20/2020,30,0,14,18,62
2/21/2020,24,0,16,33,73
2/22/2020,29,0,10,26,65
2/23/2020,24,0,19,24,67
2/24/2020,18,0,11,25,54
2/25/2020,25,0,15,27,67
2/26/2020,30,0,16,35,81
2/27/2020,29,0,19,24,72
2/28/2020,15,0,22,24,61
2/29/2020,24,0,12,28,64
3/1/2020,22,25,21,12,80
3/2/2020,20,27,21,26,94
3/3/2020,29,19,11,35,94
3/4/2020,22,24,22,23,91
3/5/2020,23,13,18,16,70
3/6/2020,17,12,25,17,71
3/7/2020,15,10,19,8,52
3/8/2020,22,21,34,16,93
3/9/2020,19,24,24,28,95
3/10/2020,27,9,19,13,68
3/11/2020,20,26,12,26,84
3/12/2020,19,14,24,37,94
3/13/2020,22,13,20,15,70
3/14/2020,15,30,22,22,89
3/15/2020,20,17,27,7,71
3/16/2020,13,19,19,27,78
3/17/2020,16,18,27,16,77
3/18/2020,27,10,24,33,94
3/19/2020,18,17,11,15,61
3/20/2020,27,23,17,23,90
3/21/2020,21,19,10,22,72
3/22/2020,30,12,25,19,86
3/23/2020,27,13,19,32,91
3/24/2020,28,18,23,28,97
3/25/2020,24,13,18,19,74
3/26/2020,21,8,25,25,79
3/27/2020,22,18,15,21,76
3/28/2020,22,17,27,16,82
3/29/2020,27,21,21,18,87
3/30/2020,25,4,15,19,63
3/31/2020,22,21,17,22,82
4/1/2020,15,47,23,30,115
4/2/2020,25,42,14,18,99
4/3/2020,24,42,20,34,120
4/4/2020,30,38,16,9,93
4/5/2020,32,38,25,24,119
4/6/2020,21,45,26,16,108
4/7/2020,19,35,9,20,83
4/8/2020,15,45,30,21,111
4/9/2020,15,47,20,33,115
4/10/2020,18,41,22,23,104
4/11/2020,21,46,23,20,110
4/12/2020,21,33,23,9,86
4/13/2020,34,44,28,16,122
4/14/2020,24,46,17,23,110
4/15/2020,28,48,31,19,126
4/16/2020,21,45,21,7,94
4/17/2020,24,39,14,10,87
4/18/2020,28,34,31,16,109
4/19/2020,14,36,23,25,98
4/20/2020,19,54,22,24,119
4/21/2020,17,30,16,21,84
4/22/2020,24,48,26,12,110
4/23/2020,25,39,14,20,98
4/24/2020,19,41,8,33,101
4/25/2020,20,44,30,22,116
4/26/2020,17,31,17,14,79
4/27/2020,20,47,14,16,97
4/28/2020,25,50,15,27,117
4/29/2020,26,41,14,14,95
4/30/2020,21,43,26,20,110
5/1/2020,25,71,22,14,132
5/2/2020,31,80,14,23,148
5/3/2020,27,90,22,30,169
5/4/2020,26,85,32,23,166
5/5/2020,15,49,28,10,102
5/6/2020,16,67,16,20,119
5/7/2020,19,71,22,26,138
5/8/2020,21,91,19,13,144
5/9/2020,29,75,21,33,158
5/10/2020,27,72,12,29,140
5/11/2020,12,68,19,19,118
5/12/2020,25,83,16,17,141
5/13/2020,23,76,22,11,132
5/14/2020,23,68,13,31,135
5/15/2020,21,76,21,21,139
5/16/2020,23,86,13,21,143
5/17/2020,23,71,18,29,141
5/18/2020,20,79,28,24,151
5/19/2020,29,57,22,32,140
5/20/2020,24,88,22,10,144
5/21/2020,25,70,19,21,135
5/22/2020,24,95,23,22,164
5/23/2020,17,78,13,32,140
5/24/2020,25,101,31,12,169
5/25/2020,25,57,15,17,114
5/26/2020,23,82,13,19,137
5/27/2020,12,78,18,11,119
5/28/2020,24,64,23,33,144
5/29/2020,23,72,20,21,136
5/30/2020,14,72,26,31,143
5/31/2020,25,64,15,14,118
6/1/2020,20,110,13,29,172
6/2/2020,30,109,28,30,197
6/3/2020,22,120,17,19,178
6/4/2020,32,119,19,18,188
6/5/2020,23,99,13,30,165
6/6/2020,15,141,19,15,190
6/7/2020,29,122,7,4,162
6/8/2020,16,115,17,32,180
6/9/2020,25,119,25,22,191
6/10/2020,18,87,24,24,153
6/11/2020,20,154,17,1,192
6/12/2020,15,140,30,15,200
6/13/2020,21,125,15,26,187
6/14/2020,27,140,14,10,191
6/15/2020,17,122,19,8,166
6/16/2020,19,121,15,25,180
6/17/2020,21,134,16,20,191
6/18/2020,22,136,16,25,199
6/19/2020,34,106,28,12,180
6/20/2020,26,115,28,25,194
6/21/2020,20,99,29,28,176
6/22/2020,27,129,25,22,203
6/23/2020,16,87,7,28,138
6/24/2020,24,138,21,9,192
6/25/2020,14,135,29,26,204
6/26/2020,28,94,9,35,166
6/27/2020,20,111,20,16,167
6/28/2020,16,131,28,2,177
6/29/2020,25,131,18,28,202
6/30/2020,24,120,23,11,178
7/1/2020,22,163,25,25,235
7/2/2020,23,176,33,8,240
7/3/2020,30,190,26,19,265
7/4/2020,27,179,23,14,243
7/5/2020,26,167,11,10,214
7/6/2020,28,155,17,26,226
7/7/2020,25,158,12,30,225
7/8/2020,14,152,17,34,217
7/9/2020,24,183,24,22,253
7/10/2020,27,143,24,18,212
7/11/2020,27,169,19,32,247
7/12/2020,31,161,15,11,218
7/13/2020,15,189,20,21,245
7/14/2020,25,157,18,20,220
7/15/2020,29,161,23,27,240
7/16/2020,19,155,23,14,211
7/17/2020,29,192,24,14,259
7/18/2020,29,167,33,20,249
7/19/2020,26,171,25,9,231
7/20/2020,22,153,20,6,201
7/21/2020,15,130,22,35,202
7/22/2020,20,156,24,21,221
7/23/2020,25,161,14,25,225
7/24/2020,27,172,15,26,240
7/25/2020,24,169,26,16,235
7/26/2020,28,185,16,23,252
7/27/2020,26,176,18,19,239
7/28/2020,26,185,14,19,244
7/29/2020,15,166,19,34,234
7/30/2020,18,178,10,16,222
7/31/2020,21,167,25,16,229
8/1/2020,16,179,23,29,247
8/2/2020,30,195,14,28,267
8/3/2020,12,180,17,29,238
8/4/2020,28,192,24,22,266
8/5/2020,20,169,29,5,223
8/6/2020,20,169,24,26,239
8/7/2020,20,170,11,21,222
8/8/2020,23,136,19,11,189
8/9/2020,23,159,20,27,229
8/10/2020,30,168,19,33,250
8/11/2020,28,158,19,16,221
8/12/2020,32,171,14,29,246
8/13/2020,25,163,21,9,218
8/14/2020,26,175,16,20,237
8/15/2020,19,183,16,13,231
8/16/2020,29,175,14,34,252
8/17/2020,19,181,12,10,222
8/18/2020,19,137,19,12,187
8/19/2020,23,150,26,27,226
8/20/2020,28,181,14,28,251
8/21/2020,18,176,21,15,230
8/22/2020,22,151,14,28,215
8/23/2020,23,169,30,22,244
8/24/2020,21,176,20,23,240
8/25/2020,30,150,19,23,222
8/26/2020,21,174,9,15,219
8/27/2020,24,181,26,13,244
8/28/2020,31,165,9,16,221
8/29/2020,23,193,11,23,250
8/30/2020,29,172,19,21,241
8/31/2020,31,179,20,27,257
9/1/2020,21,350,17,12,400
9/2/2020,21,390,24,16,451
9/3/2020,26,285,19,24,354
9/4/2020,14,424,27,18,483
9/5/2020,19,267,22,18,326
9/6/2020,23,430,32,20,505
9/7/2020,27,324,15,14,380
9/8/2020,30,410,22,22,484
9/9/2020,26,324,14,19,383
9/10/2020,20,354,27,13,414
9/11/2020,30,353,30,29,442
9/12/2020,15,435,19,16,485
9/13/2020,26,376,18,19,439
9/14/2020,20,410,27,27,484
9/15/2020,28,386,19,16,449
9/16/2020,27,290,16,21,354
9/17/2020,16,287,11,18,332
9/18/2020,22,307,21,24,374
9/19/2020,18,436,14,16,484
9/20/2020,20,436,29,20,505
9/21/2020,20,394,10,22,446
9/22/2020,19,304,27,28,378
9/23/2020,19,325,25,19,388
9/24/2020,22,272,16,25,335
9/25/2020,21,453,27,24,525
9/26/2020,27,438,12,17,494
9/27/2020,22,395,14,18,449
9/28/2020,32,420,31,19,502
9/29/2020,30,341,17,25,413
9/30/2020,19,338,23,18,398
10/1/2020,22,316,19,20,377
10/2/2020,20,393,24,7,444
10/3/2020,34,341,25,21,421
10/4/2020,11,345,13,15,384
10/5/2020,10,426,18,25,479
10/6/2020,15,321,8,23,367
10/7/2020,20,340,27,30,417
10/8/2020,18,317,19,17,371
10/9/2020,22,395,13,20,450
10/10/2020,30,314,21,18,383
10/11/2020,28,310,24,19,381
10/12/2020,27,459,21,32,539
10/13/2020,29,388,17,28,462
10/14/2020,22,352,24,30,428
10/15/2020,28,412,21,31,492
10/16/2020,23,392,8,8,431
10/17/2020,26,430,12,24,492
10/18/2020,15,267,27,22,331
10/19/2020,19,292,24,16,351
10/20/2020,25,228,22,22,297
10/21/2020,24,327,24,12,387
10/22/2020,24,380,30,14,448
10/23/2020,18,374,15,19,426
10/24/2020,26,352,23,19,420
10/25/2020,31,353,22,19,425
10/26/2020,32,430,20,20,502
10/27/2020,14,377,19,12,422
10/28/2020,25,410,16,23,474
10/29/2020,30,449,31,17,527
10/30/2020,21,301,20,14,356
10/31/2020,20,386,23,12,441
11/1/2020,28,324,14,27,393
11/2/2020,24,516,24,15,579
11/3/2020,29,375,21,9,434
11/4/2020,27,464,24,16,531
11/5/2020,29,396,17,22,464
11/6/2020,33,427,13,27,500
11/7/2020,21,476,18,24,539
11/8/2020,28,475,25,26,554
11/9/2020,28,493,29,19,569
11/10/2020,24,431,11,13,479
11/11/2020,20,496,24,23,563
11/12/2020,26,512,21,30,589
11/13/2020,25,478,24,17,544
11/14/2020,29,335,28,10,402
11/15/2020,20,472,22,16,530
11/16/2020,14,530,28,26,598
11/17/2020,26,517,19,25,587
11/18/2020,24,422,28,15,489
11/19/2020,31,426,13,35,505
11/20/2020,24,460,17,12,513
11/21/2020,16,451,21,19,507
11/22/2020,21,482,17,31,551
11/23/2020,15,449,17,27,508
11/24/2020,15,429,25,24,493
11/25/2020,25,510,16,24,575
11/26/2020,22,452,13,20,507
11/27/2020,26,528,22,8,584
11/28/2020,20,366,20,25,431
11/29/2020,25,430,22,29,506
11/30/2020,24,446,22,26,518
12/1/2020,24,382,15,14,435
12/2/2020,28,374,24,21,447
12/3/2020,21,399,18,10,448
12/4/2020,24,450,19,15,508
12/5/2020,20,455,19,26,520
12/6/2020,23,473,23,21,540
12/7/2020,24,423,18,26,491
12/8/2020,18,473,18,18,527
12/9/2020,20,385,31,12,448
12/10/2020,30,521,24,19,594
12/11/2020,26,357,17,13,413
12/12/2020,21,519,26,29,595
12/13/2020,26,474,16,25,541
12/14/2020,29,475,25,2,531
12/15/2020,23,416,15,6,460
12/16/2020,27,455,22,23,527
12/17/2020,29,394,22,30,475
12/18/2020,19,430,25,10,484
12/19/2020,25,455,11,23,514
12/20/2020,30,477,17,25,549
12/21/2020,24,462,24,19,529
12/22/2020,21,504,23,15,563
12/23/2020,30,370,29,23,452
12/24/2020,18,502,18,10,548
12/25/2020,26,438,13,35,512
12/26/2020,25,351,28,27,431
12/27/2020,30,483,17,9,539
12/28/2020,19,364,20,21,424
12/29/2020,21,469,29,29,548
12/30/2020,26,434,22,17,499
12/31/2020,31,403,22,22,478
1/1/2021,16,443,17,21,497
1/2/2021,22,430,19,28,499
1/3/2021,22,460,15,23,520
1/4/2021,23,504,19,10,556
1/5/2021,25,532,24,25,606
1/6/2021,26,433,19,22,500
1/7/2021,26,451,13,20,510
1/8/2021,22,521,16,12,571
1/9/2021,17,399,11,23,450
1/10/2021,30,454,18,16,518
1/11/2021,27,404,25,16,472
1/12/2021,23,530,9,20,582
1/13/2021,22,479,16,34,551
1/14/2021,24,489,27,21,561
1/15/2021,27,516,24,20,587
1/16/2021,26,523,21,18,588
1/17/2021,21,442,21,22,506
1/18/2021,18,357,23,11,409
1/19/2021,18,482,29,21,550
1/20/2021,27,437,26,18,508
1/21/2021,26,440,24,15,505
1/22/2021,29,499,12,25,565
1/23/2021,21,488,20,20,549
1/24/2021,17,502,23,8,550
1/25/2021,22,516,14,32,584
1/26/2021,19,585,25,25,654
1/27/2021,20,484,24,21,549
1/28/2021,17,462,8,17,504
1/29/2021,27,553,21,20,621
1/30/2021,16,581,12,29,638
1/31/2021,26,459,18,19,522
2/1/2021,15,538,19,20,592
2/2/2021,23,558,21,22,624
2/3/2021,23,464,16,7,510
2/4/2021,27,408,26,9,470
2/5/2021,21,441,24,31,517
2/6/2021,20,480,9,28,537
2/7/2021,23,410,18,22,473
2/8/2021,20,464,26,24,534
2/9/2021,24,404,23,9,460
2/10/2021,29,506,22,12,569
2/11/2021,21,485,12,9,527
2/12/2021,35,417,30,15,497
2/13/2021,17,392,28,9,446
2/14/2021,24,542,27,16,609
2/15/2021,25,479,25,21,550
2/16/2021,22,465,29,24,540
2/17/2021,17,494,21,23,555
2/18/2021,16,411,20,21,468
2/19/2021,25,516,25,9,575
2/20/2021,22,489,15,22,548
2/21/2021,30,456,18,21,525
2/22/2021,17,523,18,11,569
2/23/2021,25,554,20,25,624
2/24/2021,31,495,24,11,561
2/25/2021,23,433,20,23,499
2/26/2021,20,400,24,34,478
2/27/2021,26,512,25,25,588
2/28/2021,24,446,11,21,502
3/1/2021,26,414,26,26,492
3/2/2021,32,416,29,32,509
3/3/2021,14,465,19,23,521
3/4/2021,20,592,15,13,640
3/5/2021,21,437,18,26,502
3/6/2021,24,508,25,11,568
3/7/2021,20,494,30,20,564
3/8/2021,23,421,9,23,476
3/9/2021,21,436,17,11,485
3/10/2021,30,487,17,24,558
3/11/2021,23,403,27,14,467
3/12/2021,22,455,28,29,534
3/13/2021,17,571,22,33,643
3/14/2021,25,421,22,37,505
3/15/2021,19,464,18,30,531
3/16/2021,24,497,23,14,558
3/17/2021,18,452,24,18,512
3/18/2021,25,443,19,14,501
3/19/2021,22,574,12,25,633
3/20/2021,25,448,21,11,505
3/21/2021,22,484,24,14,544
3/22/2021,29,537,28,15,609
3/23/2021,16,401,13,34,464
3/24/2021,21,460,21,27,529
3/25/2021,18,437,24,27,506
3/26/2021,24,550,13,26,613
3/27/2021,19,454,25,4,502
3/28/2021,24,472,20,20,536
3/29/2021,22,487,31,27,567
3/30/2021,23,551,22,28,624
3/31/2021,28,462,21,28,539
4/1/2021,22,509,19,29,579
4/2/2021,24,391,22,1,438
4/3/2021,20,490,18,16,544
4/4/2021,24,369,15,6,414
4/5/2021,13,491,22,12,538
4/6/2021,11,485,29,12,537
4/7/2021,23,434,18,16,491
4/8/2021,18,434,14,19,485
4/9/2021,22,558,22,9,611
4/10/2021,18,460,16,12,506
4/11/2021,29,444,23,20,516
4/12/2021,30,511,17,26,584
4/13/2021,20,522,19,18,579
4/14/2021,29,585,23,5,642
4/15/2021,22,498,15,14,549
4/16/2021,25,430,24,12,491
4/17/2021,27,531,24,23,605
4/18/2021,26,565,11,11,613
4/19/2021,24,463,24,18,529
4/20/2021,20,532,16,9,577
4/21/2021,20,474,14,11,519
4/22/2021,28,514,21,25,588
4/23/2021,26,470,26,26,548
4/24/2021,24,510,27,24,585
4/25/2021,25,517,10,19,571
4/26/2021,15,471,17,25,528
4/27/2021,22,468,22,14,526
4/28/2021,32,468,25,12,537
4/29/2021,21,386,15,23,445
4/30/2021,31,437,22,14,504
5/1/2021,14,539,32,21,606
5/2/2021,28,512,24,31,595
5/3/2021,29,409,10,31,479
5/4/2021,27,577,18,18,640
5/5/2021,12,558,26,20,616
5/6/2021,19,410,19,23,471
5/7/2021,22,511,26,31,590
5/8/2021,19,417,17,19,472
5/9/2021,24,496,15,22,557
5/10/2021,19,556,20,19,614
5/11/2021,22,570,23,22,637
5/12/2021,28,467,20,24,539
5/13/2021,23,400,13,26,462
5/14/2021,20,555,26,27,628
5/15/2021,22,410,24,4,460
5/16/2021,19,402,23,20,464
5/17/2021,27,463,15,17,522
5/18/2021,26,542,22,15,605
5/19/2021,17,501,27,17,562
5/20/2021,26,481,18,14,539
5/21/2021,24,514,25,21,584
5/22/2021,27,473,20,13,533
5/23/2021,27,477,23,14,541
5/24/2021,21,479,18,26,544
5/25/2021,20,589,31,15,655
5/26/2021,13,514,25,26,578
5/27/2021,32,457,20,31,540
5/28/2021,34,548,21,19,622
5/29/2021,16,454,20,21,511
5/30/2021,18,524,8,26,576
5/31/2021,25,431,20,8,484
6/1/2021,23,401,20,14,458
6/2/2021,22,407,21,15,465
6/3/2021,17,434,14,13,478
6/4/2021,26,454,19,17,516
6/5/2021,27,377,12,24,440
6/6/2021,25,437,13,28,503
6/7/2021,23,435,29,28,515
6/8/2021,21,471,25,12,529
6/9/2021,31,454,19,16,520
6/10/2021,25,479,20,22,546
6/11/2021,23,488,11,17,539
6/12/2021,34,479,16,11,540
6/13/2021,24,520,16,10,570
6/14/2021,20,381,21,15,437
6/15/2021,19,483,14,20,536
6/16/2021,23,504,20,23,570
6/17/2021,20,552,18,19,609
6/18/2021,20,484,21,16,541
6/19/2021,15,515,24,36,590
6/20/2021,23,455,22,30,530
6/21/2021,28,522,18,10,578
6/22/2021,18,477,22,11,528
6/23/2021,29,378,18,21,446
6/24/2021,12,399,22,16,449
6/25/2021,22,482,17,10,531
6/26/2021,30,535,28,22,615
6/27/2021,24,428,10,13,475
6/28/2021,24,394,29,20,467
6/29/2021,24,427,25,24,500
6/30/2021,26,533,25,12,596
7/1/2021,22,474,23,24,543
7/2/2021,28,412,23,15,478
7/3/2021,17,424,21,19,481
7/4/2021,24,542,21,11,598
7/5/2021,28,578,20,26,652
7/6/2021,20,388,26,32,466
7/7/2021,19,470,16,21,526
7/8/2021,27,462,16,36,541
7/9/2021,26,403,20,38,487
7/10/2021,35,381,24,7,447
7/11/2021,26,413,30,21,490
7/12/2021,25,507,12,15,559
7/13/2021,18,523,17,21,579
7/14/2021,28,514,30,35,607
7/15/2021,19,459,23,22,523
7/16/2021,16,488,24,6,534
7/17/2021,29,481,27,19,556
7/18/2021,14,538,19,34,605
7/19/2021,15,523,21,27,586
7/20/2021,25,391,22,37,475
7/21/2021,18,456,28,23,525
7/22/2021,18,478,26,22,544
7/23/2021,22,410,14,21,467
7/24/2021,23,521,28,15,587
7/25/2021,25,455,22,24,526
7/26/2021,24,564,22,29,639
7/27/2021,19,527,16,30,592
7/28/2021,25,563,17,12,617
7/29/2021,22,456,26,32,536
7/30/2021,24,470,13,24,531
7/31/2021,32,376,25,18,451
8/1/2021,24,547,11,24,606
8/2/2021,23,447,26,22,518
8/3/2021,32,541,12,12,597
8/4/2021,12,564,17,23,616
8/5/2021,27,501,17,29,574
8/6/2021,28,578,17,27,650
8/7/2021,28,497,15,26,566
8/8/2021,31,553,23,17,624
8/9/2021,20,409,31,31,491
8/10/2021,21,474,19,23,537
8/11/2021,17,473,18,32,540
8/12/2021,23,413,25,17,478
8/13/2021,19,385,25,23,452
8/14/2021,19,504,19,6,548
8/15/2021,17,425,13,25,480
8/16/2021,21,568,25,22,636
8/17/2021,24,408,18,14,464
8/18/2021,21,497,28,18,564
8/19/2021,12,516,12,20,560
8/20/2021,20,406,15,17,458
8/21/2021,18,572,21,11,622
8/22/2021,19,454,23,26,522
8/23/2021,20,485,14,32,551
8/24/2021,24,420,23,26,493
8/25/2021,17,390,23,29,459
8/26/2021,14,443,20,33,510
8/27/2021,12,549,20,18,599
8/28/2021,30,548,21,9,608
8/29/2021,22,482,14,21,539
8/30/2021,26,528,25,26,605
8/31/2021,23,470,17,14,524
9/1/2021,14,377,13,22,426
9/2/2021,28,390,21,18,457
9/3/2021,25,551,20,24,620
9/4/2021,23,573,20,18,634
9/5/2021,26,470,13,11,520
9/6/2021,15,428,13,13,469
9/7/2021,16,379,20,16,431
9/8/2021,24,464,27,24,539
9/9/2021,27,562,23,23,635
9/10/2021,16,445,13,6,480
9/11/2021,17,513,23,17,570
9/12/2021,12,370,28,17,427
9/13/2021,22,436,21,21,500
9/14/2021,23,455,28,15,521
9/15/2021,22,418,25,22,487
9/16/2021,20,472,13,25,530
9/17/2021,27,418,16,19,480
9/18/2021,24,547,29,16,616
9/19/2021,21,447,27,9,504
9/20/2021,32,596,16,14,658
9/21/2021,28,465,9,22,524
9/22/2021,22,445,16,11,494
9/23/2021,20,531,21,13,585
9/24/2021,27,446,22,7,502
9/25/2021,12,535,21,14,582
9/26/2021,20,546,19,7,592
9/27/2021,27,463,18,24,532
9/28/2021,21,430,27,18,496
9/29/2021,28,480,21,30,559
9/30/2021,21,482,22,21,546
10/1/2021,23,411,10,26,470
10/2/2021,18,402,20,25,465
10/3/2021,21,457,23,14,515
10/4/2021,29,561,23,15,628
10/5/2021,30,444,21,17,512
10/6/2021,15,531,11,11,568
10/7/2021,22,568,23,12,625
10/8/2021,20,541,20,14,595
10/9/2021,24,475,22,33,554
10/10/2021,26,453,26,13,518
10/11/2021,18,422,25,35,500
10/12/2021,24,593,14,15,646
10/13/2021,27,408,14,21,470
10/14/2021,20,451,10,15,496
10/15/2021,24,540,19,11,594
10/16/2021,26,457,26,17,526
10/17/2021,15,480,16,29,540
10/18/2021,14,500,24,22,560
10/19/2021,21,554,21,10,606
10/20/2021,25,547,31,11,614
10/21/2021,16,425,19,27,487
10/22/2021,24,464,29,20,537
10/23/2021,20,419,9,29,477
10/24/2021,30,508,17,20,575
10/25/2021,18,482,15,15,530
10/26/2021,17,463,21,24,525
10/27/2021,23,507,26,13,569
10/28/2021,28,557,17,13,615
10/29/2021,26,411,29,19,485
10/30/2021,22,408,12,19,461
10/31/2021,33,536,20,29,618
11/1/2021,31,490,15,18,554
11/2/2021,29,572,17,21,639
11/3/2021,20,512,19,14,565
11/4/2021,23,469,17,18,527
11/5/2021,20,494,22,22,558
11/6/2021,29,491,16,14,550
11/7/2021,31,513,9,10,563
11/8/2021,30,475,24,10,539
11/9/2021,33,485,25,35,578
11/10/2021,16,481,19,15,531
11/11/2021,18,461,18,33,530
11/12/2021,28,489,31,16,564
11/13/2021,19,446,18,13,496
11/14/2021,19,511,19,34,583
11/15/2021,21,424,20,6,471
11/16/2021,19,438,24,16,497
11/17/2021,26,512,18,31,587
11/18/2021,23,527,14,35,599
11/19/2021,11,490,20,27,548
11/20/2021,16,454,31,18,519
11/21/2021,21,462,11,23,517
11/22/2021,21,439,22,26,508
11/23/2021,25,451,17,8,501
11/24/2021,26,404,27,7,464
11/25/2021,27,391,20,14,452
11/26/2021,12,491,21,27,551
11/27/2021,26,577,23,7,633
11/28/2021,24,446,10,14,494
11/29/2021,12,529,25,31,597
11/30/2021,19,466,18,16,519
12/1/2021,27,445,18,29,519
12/2/2021,24,528,17,27,596
12/3/2021,27,530,18,22,597
12/4/2021,12,509,21,15,557
12/5/2021,24,482,19,13,538
12/6/2021,24,456,25,30,535
12/7/2021,17,607,13,16,653
12/8/2021,21,458,31,27,537
12/9/2021,22,447,26,35,530
12/10/2021,19,448,16,14,497
12/11/2021,19,471,24,34,548
12/12/2021,23,511,17,35,586
12/13/2021,21,483,21,24,549
12/14/2021,28,497,17,19,561
12/15/2021,20,514,10,15,559
12/16/2021,19,560,23,13,615
12/17/2021,21,586,12,24,643
12/18/2021,24,530,23,21,598
12/19/2021,22,540,10,8,580
12/20/2021,26,513,14,23,576
12/21/2021,18,447,10,10,485
12/22/2021,32,475,16,10,533
12/23/2021,23,358,21,27,429
12/24/2021,28,422,19,37,506
12/25/2021,22,544,20,28,614
12/26/2021,21,439,26,37,523
12/27/2021,15,358,14,18,405
12/28/2021,26,416,24,21,487
12/29/2021,27,463,19,23,532
12/30/2021,22,407,16,14,459
12/31/2021,13,548,18,23,602
1/1/2022,22,420,17,20,479
1/2/2022,19,483,20,32,554
1/3/2022,21,518,17,22,578
1/4/2022,24,577,17,22,640
1/5/2022,27,543,13,12,595
1/6/2022,22,417,25,6,470
1/7/2022,17,571,20,25,633
1/8/2022,22,618,26,21,687
1/9/2022,25,416,24,14,479
1/10/2022,19,440,27,21,507
1/11/2022,27,540,26,15,608
1/12/2022,23,559,19,28,629
1/13/2022,30,458,23,16,527
1/14/2022,24,484,21,32,561
1/15/2022,20,494,20,7,541
1/16/2022,14,546,20,16,596
1/17/2022,20,487,24,6,537
1/18/2022,21,483,14,4,522
1/19/2022,16,528,17,26,587
1/20/2022,18,454,20,14,506
1/21/2022,19,584,31,22,656
1/22/2022,18,445,27,20,510
1/23/2022,31,497,21,31,580
1/24/2022,23,542,21,17,603
1/25/2022,16,461,27,10,514
1/26/2022,20,469,17,30,536
1/27/2022,31,489,19,16,555
1/28/2022,15,473,11,17,516
1/29/2022,28,430,22,18,498
1/30/2022,20,443,18,20,501
1/31/2022,12,469,20,14,515
2/1/2022,25,479,14,17,535
2/2/2022,20,549,11,29,609
2/3/2022,16,572,26,12,626
2/4/2022,19,541,21,30,611
2/5/2022,13,348,18,27,406
2/6/2022,23,464,15,24,526
2/7/2022,17,536,26,15,594
2/8/2022,18,569,16,18,621
2/9/2022,28,449,15,7,499
2/10/2022,23,443,20,17,503
2/11/2022,20,534,22,14,590
2/12/2022,29,443,22,13,507
2/13/2022,25,408,28,18,479
2/14/2022,21,491,20,25,557
2/15/2022,22,450,26,18,516
2/16/2022,28,453,23,30,534
2/17/2022,24,478,21,20,543
2/18/2022,20,499,25,11,555
2/19/2022,20,474,15,24,533
2/20/2022,18,518,23,15,574
2/21/2022,13,517,20,26,576
2/22/2022,18,495,14,6,533
2/23/2022,20,517,22,20,579
2/24/2022,31,437,28,12,508
2/25/2022,23,397,23,10,453
2/26/2022,25,444,16,7,492
2/27/2022,21,374,20,26,441
2/28/2022,30,557,24,22,633
3/1/2022,31,477,25,16,549
3/2/2022,25,480,17,24,546
3/3/2022,32,531,12,19,594
3/4/2022,20,381,23,22,446
3/5/2022,22,502,24,25,573
3/6/2022,20,501,12,8,541
3/7/2022,14,534,25,10,583
3/8/2022,19,473,27,15,534
3/9/2022,31,486,18,10,545
3/10/2022,21,524,15,25,585
3/11/2022,27,542,14,17,600
3/12/2022,20,476,23,18,537
3/13/2022,19,521,25,34,599
3/14/2022,25,506,25,21,577
3/15/2022,17,490,24,19,550
3/16/2022,17,468,24,16,525
3/17/2022,22,487,24,24,557
3/18/2022,18,508,21,17,564
3/19/2022,28,540,21,11,600
3/20/2022,26,526,15,8,575
3/21/2022,19,542,16,16,593
3/22/2022,28,475,17,31,551
3/23/2022,25,432,21,16,494
3/24/2022,25,466,14,14,519
3/25/2022,24,512,19,14,569
3/26/2022,22,425,24,23,494
3/27/2022,15,483,22,15,535
3/28/2022,30,501,21,8,560
3/29/2022,22,506,26,31,585
3/30/2022,20,490,18,15,543
3/31/2022,26,392,11,20,449
4/1/2022,29,415,23,19,486
4/2/2022,25,489,30,14,558
4/3/2022,16,534,17,10,577
4/4/2022,18,414,22,9,463
4/5/2022,27,487,27,23,564
4/6/2022,18,498,20,11,547
4/7/2022,23,571,24,17,635
4/8/2022,27,503,14,13,557
4/9/2022,23,487,13,23,546
4/10/2022,29,507,31,14,581
4/11/2022,19,561,18,11,609
4/12/2022,16,486,12,13,527
4/13/2022,22,409,23,12,466
4/14/2022,24,577,27,17,645
4/15/2022,14,541,28,13,596
4/16/2022,18,451,24,30,523
4/17/2022,31,535,28,12,606
4/18/2022,18,476,23,15,532
4/19/2022,31,385,21,10,447
4/20/2022,29,529,17,17,592
4/21/2022,14,468,16,17,515
4/22/2022,16,498,20,30,564
4/23/2022,27,504,20,15,566
4/24/2022,15,427,14,29,485
4/25/2022,27,453,17,31,528
4/26/2022,32,442,21,7,502
4/27/2022,32,548,10,20,610
4/28/2022,16,597,25,15,653
4/29/2022,20,574,25,11,630
4/30/2022,19,498,22,27,566
5/1/2022,27,385,18,17,447
5/2/2022,29,521,29,32,611
5/3/2022,21,523,17,22,583
5/4/2022,26,471,22,16,535
5/5/2022,25,571,23,20,639
5/6/2022,26,512,23,22,583
5/7/2022,18,500,20,26,564
5/8/2022,29,483,14,28,554
5/9/2022,14,544,26,19,603
5/10/2022,21,382,17,19,439
5/11/2022,27,444,28,15,514
5/12/2022,29,487,22,18,556
5/13/2022,18,454,22,23,517
5/14/2022,22,486,23,25,556
5/15/2022,23,498,8,25,554
5/16/2022,19,459,23,18,519
5/17/2022,19,483,22,26,550
5/18/2022,31,394,20,35,480
5/19/2022,25,469,20,18,532
5/20/2022,25,553,22,18,618
5/21/2022,29,507,25,25,586
5/22/2022,25,432,14,27,498
5/23/2022,20,392,23,18,453
5/24/2022,25,517,10,10,562
5/25/2022,20,442,21,16,499
5/26/2022,24,526,25,12,587
5/27/2022,17,481,21,15,534
5/28/2022,26,485,13,19,543
5/29/2022,27,547,21,19,614
5/30/2022,19,573,28,22,642
5/31/2022,22,401,13,27,463
6/1/2022,23,474,28,26,551
6/2/2022,21,445,25,31,522
6/3/2022,20,503,16,38,577
6/4/2022,18,608,21,29,676
6/5/2022,26,552,28,17,623
6/6/2022,19,534,12,20,585
6/7/2022,27,512,15,22,576
6/8/2022,19,530,22,18,589
6/9/2022,23,548,18,11,600
6/10/2022,12,393,16,24,445
6/11/2022,29,594,18,14,655
6/12/2022,22,476,12,20,530
6/13/2022,26,473,27,27,553
6/14/2022,25,419,12,20,476
6/15/2022,21,545,14,14,594
6/16/2022,31,436,21,23,511
6/17/2022,23,513,27,34,597
6/18/2022,30,493,19,18,560
6/19/2022,23,427,21,18,489
6/20/2022,29,448,21,21,519
6/21/2022,24,498,13,6,541
6/22/2022,26,410,20,20,476
6/23/2022,22,461,27,14,524
6/24/2022,25,568,24,18,635
6/25/2022,17,432,22,19,490
6/26/2022,18,417,29,23,487
6/27/2022,21,553,24,6,604
6/28/2022,18,554,15,30,617
6/29/2022,21,490,20,23,554
6/30/2022,23,504,26,22,575
7/1/2022,16,519,18,18,571
7/2/2022,22,475,29,35,561
7/3/2022,28,506,24,19,577
7/4/2022,18,549,21,20,608
7/5/2022,19,510,19,26,574
7/6/2022,25,448,16,20,509
7/7/2022,30,334,22,5,391
7/8/2022,23,546,27,33,629
7/9/2022,20,512,17,14,563
7/10/2022,25,537,23,36,621
7/11/2022,18,500,17,20,555
7/12/2022,24,546,22,7,599
7/13/2022,26,476,25,16,543
7/14/2022,33,480,21,21,555
7/15/2022,27,506,27,9,569
7/16/2022,27,492,25,13,557
7/17/2022,21,523,16,20,580
7/18/2022,27,481,23,21,552
7/19/2022,20,468,24,18,530
7/20/2022,18,414,18,18,468
7/21/2022,22,399,22,10,453
7/22/2022,15,402,20,28,465
7/23/2022,26,493,25,22,566
7/24/2022,24,422,10,31,487
7/25/2022,15,472,18,26,531
7/26/2022,30,525,29,24,608
7/27/2022,18,571,24,33,646
7/28/2022,21,405,19,22,467
7/29/2022,16,355,17,34,422
7/30/2022,26,501,24,22,573
7/31/2022,27,444,27,24,522
8/1/2022,22,463,21,13,519
8/2/2022,27,473,17,16,533
8/3/2022,26,482,23,8,539
8/4/2022,22,559,20,12,613
8/5/2022,20,503,14,16,553
8/6/2022,28,483,17,33,561
8/7/2022,28,439,19,19,505
8/8/2022,27,505,15,14,561
8/9/2022,19,495,15,8,537
8/10/2022,27,544,11,19,601
8/11/2022,17,388,21,26,452
8/12/2022,33,555,18,11,617
8/13/2022,19,444,22,22,507
8/14/2022,20,528,17,23,588
8/15/2022,20,411,27,23,481
8/16/2022,26,511,20,25,582
8/17/2022,25,523,14,28,590
8/18/2022,27,420,24,7,478
8/19/2022,18,488,25,26,557
8/20/2022,24,574,19,28,645
8/21/2022,19,432,16,26,493
8/22/2022,19,433,24,29,505
8/23/2022,27,495,27,29,578
8/24/2022,27,530,20,11,588
8/25/2022,20,396,20,17,453
8/26/2022,29,484,20,18,551
8/27/2022,16,523,18,11,568
8/28/2022,14,398,17,13,442
8/29/2022,22,497,13,7,539
8/30/2022,20,442,25,29,516
8/31/2022,21,417,14,16,468
9/1/2022,26,570,18,21,635
9/2/2022,22,491,17,32,562
9/3/2022,26,452,22,26,526
9/4/2022,15,553,19,14,601
9/5/2022,31,461,34,17,543
9/6/2022,23,393,20,26,462
9/7/2022,15,420,21,16,472
9/8/2022,22,497,19,23,561
9/9/2022,17,500,24,11,552
9/10/2022,28,531,24,30,613
9/11/2022,19,384,29,30,462
9/12/2022,22,542,16,24,604
9/13/2022,22,515,22,35,594
9/14/2022,25,405,25,30,485
9/15/2022,32,525,23,36,616
9/16/2022,16,500,12,29,557
9/17/2022,29,488,13,16,546
9/18/2022,19,498,25,19,561
9/19/2022,26,519,15,24,584
9/20/2022,34,553,19,16,622
9/21/2022,25,487,16,36,564
9/22/2022,17,410,26,21,474
9/23/2022,21,473,19,16,529
9/24/2022,25,515,23,23,586
9/25/2022,21,454,18,9,502
9/26/2022,17,484,16,10,527
9/27/2022,17,543,14,11,585
9/28/2022,23,546,22,23,614
9/29/2022,14,479,16,20,529
9/30/2022,25,407,21,32,485
10/1/2022,13,494,10,30,547
10/2/2022,12,495,29,25,561
10/3/2022,28,456,31,29,544
10/4/2022,28,502,23,13,566
10/5/2022,28,541,14,11,594
10/6/2022,20,502,16,19,557
10/7/2022,24,502,13,22,561
10/8/2022,23,442,22,20,507
10/9/2022,23,438,29,14,504
10/10/2022,30,526,16,27,599
10/11/2022,16,503,14,11,544
10/12/2022,18,529,23,29,599
10/13/2022,22,494,26,8,550
10/14/2022,20,561,16,23,620
10/15/2022,25,446,20,20,511
10/16/2022,23,462,23,8,516
10/17/2022,15,471,19,17,522
10/18/2022,30,535,18,22,605
10/19/2022,18,491,23,24,556
10/20/2022,23,431,12,24,490
10/21/2022,27,482,15,15,539
10/22/2022,14,439,18,13,484
10/23/2022,25,540,15,27,607
10/24/2022,22,537,28,19,606
10/25/2022,25,575,15,29,644
10/26/2022,20,472,23,11,526
10/27/2022,22,476,20,25,543
10/28/2022,32,465,12,22,531
10/29/2022,28,387,15,18,448
10/30/2022,18,532,29,12,591
10/31/2022,22,427,24,5,478
11/1/2022,25,422,15,17,479
11/2/2022,20,436,30,28,514
11/3/2022,33,474,14,14,535
11/4/2022,23,538,27,22,610
11/5/2022,15,514,23,20,572
11/6/2022,23,558,26,13,620
11/7/2022,23,476,25,20,544
11/8/2022,22,501,25,16,564
11/9/2022,27,529,17,30,603
11/10/2022,18,432,25,22,497
11/11/2022,19,422,17,26,484
11/12/2022,24,438,13,31,506
11/13/2022,24,461,17,6,508
11/14/2022,19,511,23,12,565
11/15/2022,20,408,12,29,469
11/16/2022,23,476,27,9,535
11/17/2022,24,487,14,16,541
11/18/2022,15,461,16,18,510
11/19/2022,17,430,22,22,491
11/20/2022,26,564,18,20,628
11/21/2022,24,514,23,16,577
11/22/2022,26,487,16,25,554
11/23/2022,20,543,16,21,600
11/24/2022,27,493,17,33,570
11/25/2022,25,504,28,13,570
11/26/2022,20,456,17,30,523
11/27/2022,18,453,14,28,513
11/28/2022,22,520,25,26,593
11/29/2022,19,408,29,16,472
11/30/2022,18,536,13,10,577
12/1/2022,24,553,20,15,612
12/2/2022,24,405,25,29,483
12/3/2022,32,491,26,23,572
12/4/2022,16,431,22,13,482
12/5/2022,17,404,27,26,474
12/6/2022,29,482,20,22,553
12/7/2022,20,554,22,15,611
12/8/2022,24,498,21,16,559
12/9/2022,27,466,18,21,532
12/10/2022,27,409,25,12,473
12/11/2022,23,515,18,25,581
12/12/2022,20,544,17,21,602
12/13/2022,29,478,27,30,564
12/14/2022,24,471,26,20,541
12/15/2022,18,470,25,23,536
12/16/2022,17,376,29,34,456
12/17/2022,17,473,20,21,531
12/18/2022,22,398,18,10,448
12/19/2022,22,457,21,22,522
12/20/2022,22,497,18,30,567
12/21/2022,28,421,14,27,490
12/22/2022,23,522,25,26,596
12/23/2022,31,480,22,20,553
12/24/2022,13,479,24,28,544
12/25/2022,33,357,22,18,430
12/26/2022,22,487,25,9,543
12/27/2022,28,544,22,13,607
12/28/2022,29,511,16,12,568
12/29/2022,34,439,27,32,532
12/30/2022,28,477,15,27,547
12/31/2022,16,482,19,14,531
